time,job_id,num_gpu,submit_time,start_time,end_time,ddl,executed_time,JCT,pending_time,preempt,promote,best_effort_job
2267268,5dc7d9cd-c300-9a4f-c3cd-dc2cc0935548,16,2266647,2266647,2267268,2267101,621,621,0,0,0,0
2372469,ec42aa41-3a0d-71f3-62dc-31b28dfb54c4,16,2371685,2371685,2372469,2372544,784,784,0,0,0,0
2778111,4feb9f90-7722-d636-5cec-0cd5dcf8732c,2,2709847,2709847,2778111,2791437,68264,68264,0,0,0,0
2848498,16f47da1-6f4b-44e1-606d-973523805283,2,2843551,2843551,2848498,2847986,4947,4947,0,0,0,0
2867428,17cffaa9-ce76-40ac-e823-d93c9ec81278,4,2860271,2860271,2867428,2870468,7157,7157,0,0,0,0
2871515,b07ae24a-07a0-2647-f75b-8eeebd4092fd,1,2870901,2870901,2871515,2871294,614,614,0,0,0,0
2871615,419ac257-118f-b4ce-b7e2-2859a33756d3,1,2870999,2870999,2871615,2871376,616,616,0,0,0,0
2871737,23936030-227e-1ff1-e098-5e40d55499ac,2,2866732,2866732,2871737,2870496,5005,5005,0,0,0,0
2871757,a174c001-6e0c-2b41-9f3a-0f19a2009a53,1,2871137,2871137,2871757,2871726,620,620,0,0,0,0
2872163,fb532966-58dd-3090-bdaf-b48d42da99dd,1,2871435,2871435,2872163,2871934,728,728,0,0,0,0
2872302,6dfbc59f-c885-b1ad-2322-76c177cb3512,1,2871547,2871575,2872302,2872131,727,755,28,0,0,0
2880841,1b541619-13c3-0554-a227-0ffa2f0c2286,1,2880221,2880221,2880841,2880713,620,620,0,0,0,0
2880859,5e269964-9d62-bbb4-b42e-fd435e44e732,1,2880125,2880125,2880859,2880599,734,734,0,0,0,0
2880971,c6acf730-5794-01b0-c944-2d00c954cd09,1,2880359,2880359,2880971,2881187,612,612,0,0,0,0
2881169,0230e8c1-63c0-e713-402d-718c3dd826ae,1,2880558,2880558,2881169,2880992,611,611,0,0,0,0
2930643,0007b657-6398-1e39-b1e3-0455de9903f2,1,2929760,2929760,2930643,2930521,883,883,0,0,0,0
2930713,4a995cf7-a04d-5a55-5b45-35ba3055b451,1,2929829,2929829,2930713,2930632,884,884,0,0,0,0
2930893,07424da7-a724-8db2-a033-8ac873022542,1,2929981,2930009,2930893,2930585,884,912,28,0,0,0
2931252,4243a771-44ca-64e6-5578-d4626593a352,1,2929661,2929661,2931252,2931236,1591,1591,0,0,0,0
2931435,68fb76c8-3f86-918f-4557-778fb4dbfb7e,1,2930725,2930726,2931435,2931243,709,710,1,0,0,0
2931484,ec5eb28e-e74c-1d28-b007-57e61ff98458,1,2929870,2929889,2931484,2930802,1595,1614,19,0,0,0
2931536,7ffbc363-0760-af38-16a0-5cba45fb7713,1,2929944,2929949,2931536,2931747,1587,1592,5,0,0,0
2931658,d9952cf6-1321-2980-d640-18e8957a4c08,1,2930890,2930890,2931658,2931390,768,768,0,0,0,0
2931898,4cb28120-030b-ede5-1f1e-c2f3bd89f89e,1,2930606,2930606,2931898,2931825,1292,1292,0,0,0,0
2932078,1839ea1a-e707-8bb9-a205-1cd9bf7077ea,1,2931254,2931312,2932078,2931947,766,824,58,0,0,0
2932237,af465cf1-d13f-7f7c-8d86-9dcde1534cac,1,2930920,2930950,2932237,2931836,1287,1317,30,0,0,0
2932356,280ecd01-a695-9758-1135-29c84e5a0234,1,2931066,2931066,2932356,2932713,1290,1290,0,0,0,0
2933181,626424fd-1da2-f1b4-af00-114dfd93938a,1,2932479,2932479,2933181,2932924,702,702,0,0,0,0
2933543,f7af8ee1-ca56-478a-4ea6-7cd9597d3f33,1,2932831,2932831,2933543,2933492,712,712,0,0,0,0
2933668,c4effd72-d379-0096-0748-5f16fc72d38f,1,2932959,2932959,2933668,2933342,709,709,0,0,0,0
2933910,10d0ea8b-fe14-f518-2f12-4dd329aab8f9,1,2932675,2932675,2933910,2933440,1235,1235,0,0,0,0
2934123,34a7da87-bf16-fbac-7c94-68ba6ca30cf7,1,2932834,2932891,2934123,2933807,1232,1289,57,0,0,0
2934252,512157f5-090f-4968-1448-d063eb28b9f2,1,2932971,2933019,2934252,2933840,1233,1281,48,0,0,0
2945598,6bcb4943-aee5-fd79-4f74-8712273f0a66,1,2943672,2943672,2945598,2946546,1926,1926,0,0,0,0
2949963,3a95e2f8-e547-639a-2d0e-5b81db2da6d0,1,2947977,2947977,2949963,2949545,1986,1986,0,0,0,0
2951652,32c30e9b-4a61-0db7-1d9c-308f17d08a83,1,2949207,2949207,2951652,2950516,2445,2445,0,0,0,0
2953182,1b5be752-108d-3aef-fc56-c8352fe52c89,1,2952452,2952452,2953182,2953365,730,730,0,0,0,0
2953401,9dc06e88-4fa9-43c6-4797-a9143071b72d,1,2952667,2952667,2953401,2953439,734,734,0,0,0,0
2953455,3479e387-6a08-3438-01a0-90b885359e44,1,2952697,2952727,2953455,2953557,728,758,30,0,0,0
2953817,4fdcca6e-c0ef-8883-d976-8c7b52a5295b,1,2952540,2952540,2953817,2954001,1277,1277,0,0,0,0
2953878,0c6dea88-803a-6c02-d10e-111ede1809f8,1,2952567,2952600,2953878,2954162,1278,1311,33,0,0,0
2954059,38984397-b5ce-e815-1089-1894a4a1e6d3,1,2952784,2952787,2954059,2953692,1272,1275,3,0,0,0
2954989,fec766d6-6d57-2693-bfa6-b49daea1231c,1,2953004,2953004,2954989,2954542,1985,1985,0,0,0,0
2961119,2fd6dee5-f666-8b9c-1e59-b4363848ebf2,1,2960369,2960399,2961119,2961302,720,750,30,0,0,0
2961254,147f9179-4353-26ee-31f7-10fab27df9eb,1,2960526,2960526,2961254,2961442,728,728,0,0,0,0
2961428,1fe13e8d-4c39-fdf0-0c6f-6620d9f561df,1,2960664,2960706,2961428,2961567,722,764,42,0,0,0
2961613,746f6673-67ab-d0b8-b1c6-652fc25a38e2,1,2960339,2960339,2961613,2962203,1274,1274,0,0,0,0
2961675,6adb8297-bcdc-0aca-84d6-dbd72aea11cf,1,2960753,2960766,2961675,2961650,909,922,13,0,0,0
2961851,93487d24-16d6-9dcf-c138-387d00dc7ef5,1,2960925,2960946,2961851,2962190,905,926,21,0,0,0
2961853,09e6efdc-fa41-a971-7fe5-d7c166f4ad3c,1,2960553,2960586,2961853,2962078,1267,1300,33,0,0,0
2961909,b082a299-6a19-0d69-c8d8-b767f5576962,1,2960985,2961006,2961909,2961671,903,924,21,0,0,0
2961917,92dffcd8-b80a-8abf-12cc-2a997d796b8f,1,2960642,2960646,2961917,2961332,1271,1275,4,0,0,0
2962466,fc0c0e0f-6c4f-7e13-1348-87f78dd68584,1,2960788,2960826,2962466,2962783,1640,1678,38,0,0,0
2962529,b734faba-f014-7ac5-cf68-ced735d2d5af,1,2960870,2960886,2962529,2962457,1643,1659,16,0,0,0
2962712,8cc8a6f2-65e7-73d5-73ea-057500433f84,1,2961034,2961066,2962712,2963342,1646,1678,32,0,0,0
2966355,6a0cd1ce-706e-b7fe-6643-980b333eb9ed,1,2963628,2963628,2966355,2967144,2727,2727,0,0,0,0
3067965,c0a16918-8eb7-80a4-47f2-af7932331357,2,3036804,3036804,3067965,3083373,31161,31161,0,0,0,0
3068396,6a8dd368-ec50-c755-23f6-e1c075b0711f,2,3037844,3037844,3068396,3056266,30552,30552,0,0,0,0
3070868,d33fd4d8-5f7e-e3f4-fc3b-a314d1deca43,2,3037920,3037964,3070868,3073424,32904,32948,44,0,0,0
3076276,6050ca35-be49-7603-284b-73a57fe62445,2,3037864,3037904,3076276,3072503,38372,38412,40,0,0,0
3095429,2f696151-2a2e-4bb9-d32c-c0d6a69d3d4d,2,3037882,3037904,3095429,3123483,57525,57547,22,0,0,0
3114082,7c7fe19a-7b74-9abf-d4b2-0aa4cb118dd6,2,3037901,3037904,3114082,3079773,76178,76181,3,0,0,0
3605161,a8ad9ce6-f8c0-52f1-390d-dc39f552004a,4,3551625,3551625,3605161,3596078,53536,53536,0,0,0,0
3994931,c5e3e804-b22d-1bd2-b79a-d9f4ed8e6a72,4,3903027,3903027,3994931,4040064,91904,91904,0,0,0,0
3998486,b523c2d9-d2a0-9310-31e8-ccafcc51659d,4,3902758,3902758,3998486,4007242,95728,95728,0,0,0,0
4031890,55a8770f-d418-99dd-ed58-84b80417d8ba,2,3999336,3999336,4031890,4037281,32554,32554,0,0,0,0
4036484,ff7d82dc-856d-a236-53cf-9420acb0562c,2,3999460,3999460,4036484,4038297,37024,37024,0,0,0,0
4042638,dc5f7386-8f43-421b-2829-dde82bdd0490,2,3999367,3999396,4042638,4061386,43242,43271,29,0,0,0
4124479,f4a6a5ea-1d90-58b5-595c-23eb676ab7e8,2,4097710,4097710,4124479,4120677,26769,26769,0,0,0,0
4130856,c458daa4-ded9-7bdf-e101-9aaa3f9fd3c8,2,4097742,4097770,4130856,4125930,33086,33114,28,0,0,0
4131988,959def22-cecd-ccfe-c1e0-7edb68ea7d85,2,4097880,4097890,4131988,4134863,34098,34108,10,0,0,0
4146596,f7f1fc95-0d74-afb8-8ba8-0198b1227f31,2,4097810,4097830,4146596,4154336,48766,48786,20,0,0,0
4148914,7302b7c0-b01a-1d09-f5eb-9d9bd6d6714c,2,4097777,4097830,4148914,4128167,51084,51137,53,0,0,0
4162863,08a55982-b146-2f08-c044-9ed326fb49c2,2,4097848,4097890,4162863,4183251,64973,65015,42,0,0,0
4167108,1346c0e9-3a2e-b392-cc87-a2626c9ac7cb,1,4161835,4161835,4167108,4164530,5273,5273,0,0,0,0
4168725,e6406ce0-ce10-55aa-f454-050817013237,1,4161528,4161528,4168725,4165858,7197,7197,0,0,0,0
4179066,8b635a8e-a135-9414-1b02-ced91e3eac7e,2,4170003,4170003,4179066,4179775,9063,9063,0,0,0,0
4179197,88bc642e-4467-de35-868a-925780fd5736,2,4170141,4170141,4179197,4182014,9056,9056,0,0,0,0
4184916,d147d0c5-8889-e8b7-530d-e285f9b58d2d,2,4177182,4177182,4184916,4185339,7734,7734,0,0,0,0
4185134,83d64a26-0212-c661-5f76-da55313d68ed,2,4177264,4177264,4185134,4182875,7870,7870,0,0,0,0
4239664,8e386597-f4ca-c216-3541-055ad6b06e1a,1,4238975,4238975,4239664,4239879,689,689,0,0,0,0
4242084,a4cb389e-81be-65e5-f828-e09603938663,1,4241360,4241360,4242084,4242267,724,724,0,0,0,0
4246579,cb94ec05-5b6f-4185-3548-70deceee4b84,1,4245625,4245625,4246579,4246964,954,954,0,0,0,0
4323198,dd4e55d1-7bf8-626b-e3cf-73baf80d2952,1,4322025,4322025,4323198,4323343,1173,1173,0,0,0,0
4332374,608cc964-6dfa-30fe-737c-0a136a8282be,1,4331109,4331161,4332374,4332098,1213,1265,52,0,0,0
4332421,84413369-95b7-f342-e563-4cdae8fc778a,1,4331252,4331252,4332421,4332041,1169,1169,0,0,0,0
4332566,e1bcccfb-5fb2-3cfc-48e1-69aa2344e266,1,4331317,4331372,4332566,4332149,1194,1249,55,0,0,0
4332597,a850bf8f-677d-aa96-0e50-bb8374658c04,1,4331285,4331312,4332597,4332125,1285,1312,27,0,0,0
4332714,a5e5b9b8-67be-4c09-0bdf-d374c59dda2b,1,4331548,4331552,4332714,4332544,1162,1166,4,0,0,0
4332715,ca0e0ca0-f14e-5989-34d8-9c91e668cb63,1,4331041,4331041,4332715,4332366,1674,1674,0,0,0,0
4332722,299a9929-8715-477b-72f0-a9195f761f78,1,4331477,4331492,4332722,4332860,1230,1245,15,0,0,0
4332773,b4aab942-f4b9-76a4-7263-5b3aef7db2ad,1,4331582,4331612,4332773,4332440,1161,1191,30,0,0,0
4332830,b75dfaf3-bdbd-d9ed-d5cf-517cdca6f219,1,4331653,4331672,4332830,4333300,1158,1177,19,0,0,0
4332863,a9ebe11d-0f37-5ff9-7cdb-fef07b29c99d,1,4331618,4331672,4332863,4332224,1191,1245,54,0,0,0
4332957,36c86486-68cf-2cb4-389d-7f6112617334,1,4331411,4331432,4332957,4333134,1525,1546,21,0,0,0
4332970,c79666d3-9fd3-ec23-c2c9-e6e4649e5ce0,1,4331073,4331101,4332970,4332576,1869,1897,28,0,0,0
4332993,0a526ecc-6974-c418-c28e-5f9d721cd61e,1,4331444,4331492,4332993,4332338,1501,1549,48,0,0,0
4333059,7be3ff6c-f8ad-7b92-569e-53eca84dce1b,1,4331510,4331552,4333059,4333586,1507,1549,42,0,0,0
4333209,e30b2dbe-8bad-ceef-3d66-1b7076fe8b7b,1,4332000,4332000,4333209,4333042,1209,1209,0,0,0,0
4333279,7db426a6-d572-13a4-7566-f4d063e007af,1,4332068,4332120,4333279,4332770,1159,1211,52,0,0,0
4333335,43cfeb8b-83e2-b250-36ea-651bd37b92dd,1,4332100,4332120,4333335,4333830,1215,1235,20,0,0,0
4333358,43a29ca1-c175-a136-54c2-506a6d3ff7b9,1,4332036,4332060,4333358,4333721,1298,1322,24,0,0,0
4333417,21a143dc-d12d-b47a-8047-39df3d07a255,1,4332171,4332180,4333417,4333841,1237,1246,9,0,0,0
4333422,59d0569c-7f96-f031-9586-21602a16f910,1,4332241,4332300,4333422,4333827,1122,1181,59,0,0,0
4333590,459bb4e0-0568-9120-f8b2-7455ccd7131d,1,4332205,4332240,4333590,4334028,1350,1385,35,0,0,0
4333597,aa503383-40b4-6b65-51b9-7ed68ab5bd59,1,4332133,4332180,4333597,4333320,1417,1464,47,0,0,0
4334405,44a62932-5df4-6bc4-912d-588ba0f9adcd,4,4333672,4333710,4334405,4334113,695,733,38,0,0,0
4359713,052a2bb2-354c-3e04-ce79-c71ba0775dda,1,4351651,4351651,4359713,4359636,8062,8062,0,0,0,0
4360984,7725520d-9421-80ef-afae-c8e2a0061c21,1,4351536,4351536,4360984,4363460,9448,9448,0,0,0,0
4361092,b8f23968-b2e8-998b-bc24-0b36681fd305,1,4353143,4353143,4361092,4358072,7949,7949,0,0,0,0
4361313,ba95ea29-4ea0-cfd7-e2bc-15e0607b04af,1,4352906,4352906,4361313,4363587,8407,8407,0,0,0,0
4363202,ec0d6ce7-a797-615d-436f-e0ec7ae77576,1,4351768,4351768,4363202,4368692,11434,11434,0,0,0,0
4364807,dfe3a52e-5371-7097-da64-b982a89ec6a9,1,4353026,4353026,4364807,4360867,11781,11781,0,0,0,0
4406288,fe070bed-4a5e-b022-6476-dcdd663edb89,1,4352576,4352576,4406288,4396681,53712,53712,0,0,0,0
4408749,4ecf04d2-e89c-4459-cf55-43d5284c82a0,1,4351419,4351419,4408749,4405432,57330,57330,0,0,0,0
4411954,8043248e-0f3f-40e0-27d0-29886a7dd056,1,4351182,4351182,4411954,4391980,60772,60772,0,0,0,0
4415546,dc6f9180-b3fa-9c61-3ee9-b3bab557f93b,1,4400837,4400837,4415546,4421181,14709,14709,0,0,0,0
4416164,fe7a79cd-b582-5f87-b8e8-ec6de8387e62,1,4352697,4352697,4416164,4418015,63467,63467,0,0,0,0
4418552,5d0b4a50-862d-73f4-5fbc-0c0fe154e935,1,4351297,4351297,4418552,4434484,67255,67255,0,0,0,0
4419184,27fb8007-aadd-b689-1d19-f3d05488ebbe,1,4352443,4352443,4419184,4419007,66741,66741,0,0,0,0
4436951,2d5beabf-8ae7-2cac-4a0a-6a7537b1e758,1,4424076,4424076,4436951,4438200,12875,12875,0,0,0,0
4498802,8aec3551-4054-3c4f-4160-d6d68d1c431e,1,4487950,4487950,4498802,4496521,10852,10852,0,0,0,0
4498888,268f367b-28b8-fa6d-2088-b112bc2369b2,1,4488070,4488070,4498888,4496746,10818,10818,0,0,0,0
4499513,54b5d44c-3a87-147c-c24f-c1f2697f0b8c,1,4488191,4488191,4499513,4500821,11322,11322,0,0,0,0
4508399,59b37c82-cca5-8bba-4914-5bd4c0bf52e9,1,4500385,4500385,4508399,4506224,8014,8014,0,0,0,0
4512817,a15623b3-2265-df6b-6dbf-28020068274d,1,4500509,4500509,4512817,4514123,12308,12308,0,0,0,0
4514952,007314ab-57d8-71f1-e5c0-52b5b4398194,1,4500269,4500269,4514952,4515697,14683,14683,0,0,0,0
4541281,b974f705-229d-fcef-f0c6-e6856edad199,1,4487604,4487604,4541281,4561119,53677,53677,0,0,0,0
4542714,b7eb565d-a286-ce8a-7ef6-592d7634e1a7,4,4455621,4455621,4542714,4525588,87093,87093,0,0,0,0
4544798,482a08e5-8485-96ce-6653-0c936206e297,1,4487832,4487832,4544798,4536108,56966,56966,0,0,0,0
4548667,fc6f2a7f-e77a-bfaa-95b2-cf8423b2ed2e,4,4455661,4455681,4548667,4563675,92986,93006,20,0,0,0
4554689,6ba2191c-d543-5942-aba1-3d66a730d9fa,1,4487718,4487718,4554689,4572681,66971,66971,0,0,0,0
4567376,4b07ef39-d7ab-45a8-620e-4eb29942156f,1,4500154,4500154,4567376,4551460,67222,67222,0,0,0,0
4567385,2aed263b-901e-70e1-246f-fe1b7503d1ac,1,4499917,4499917,4567385,4544176,67468,67468,0,0,0,0
4567971,a0ea3655-8fc9-e9e9-218a-919e8b4909c1,1,4500035,4500035,4567971,4599463,67936,67936,0,0,0,0
4582554,db7ecc7e-56af-4da2-e105-aa22914021ea,1,4574548,4574548,4582554,4580612,8006,8006,0,0,0,0
4584368,62136e35-8e7f-a5f4-207b-5547889b2094,1,4574431,4574431,4584368,4586981,9937,9937,0,0,0,0
4586532,a56e4d32-8d86-e784-6008-3f62266a6eca,1,4574742,4574742,4586532,4581917,11790,11790,0,0,0,0
4593090,00b38a0b-5a8f-3ee9-5473-d7714ec31b39,4,4455325,4455325,4593090,4544567,137765,137765,0,0,0,0
4627819,6129eb2a-f8a2-8486-c40a-e155c1d624be,1,4574055,4574055,4627819,4614280,53764,53764,0,0,0,0
4627979,86cf1255-cc68-1c66-604a-69b6146e59bb,1,4574302,4574302,4627979,4602873,53677,53677,0,0,0,0
4628023,edf862f6-796c-25ae-6603-e9a1a47fe4fb,1,4574184,4574184,4628023,4625156,53839,53839,0,0,0,0
4647752,ceccc07f-2a14-456d-97b8-fb05e8907ec9,4,4455641,4455681,4647752,4701324,192071,192111,40,0,0,0
4653931,c70849f8-8238-e058-7355-93cd3ecd4745,4,4529925,4529925,4653931,4706537,124006,124006,0,0,0,0
4669840,b40f6c81-ceec-821e-881b-d59031c64c39,4,4458282,4458282,4669840,4577222,211558,211558,0,0,0,0
4709344,4792a8bb-e31f-2c28-88d1-3c19542514c1,1,4655494,4655494,4709344,4719135,53850,53850,0,0,0,0
4709620,907352ee-4eb5-6f1a-74bf-8a652cb931bf,1,4655613,4655613,4709620,4683043,54007,54007,0,0,0,0
4722651,d3b33e82-b468-ea93-0d94-fd4ad0157617,1,4655733,4655733,4722651,4699279,66918,66918,0,0,0,0
4723897,db7fc5b5-5542-8719-04b1-56ef0c5e9938,1,4655854,4655854,4723897,4704430,68043,68043,0,0,0,0
4723967,aa6f6930-7f59-04da-8409-1391f7880153,1,4656092,4656092,4723967,4720978,67875,67875,0,0,0,0
4732335,a62e4cd8-8f9c-5779-79eb-4a13a158270d,1,4655973,4655973,4732335,4709506,76362,76362,0,0,0,0
4741752,e2186e28-4044-0a95-c7df-5da7827239e6,1,4687786,4687786,4741752,4764927,53966,53966,0,0,0,0
4754329,d48daf6d-4cc2-2465-2c6a-0fe55ed0eb15,1,4687502,4687502,4754329,4765173,66827,66827,0,0,0,0
4754657,8332cbbf-f4f2-8fb1-1edc-98dc190100cd,1,4687665,4687665,4754657,4771151,66992,66992,0,0,0,0
4756044,458786db-199f-71ce-5295-adf3c60a8acf,1,4687938,4687938,4756044,4743282,68106,68106,0,0,0,0
4756241,19db347a-5949-317d-f8b0-92d7ed42ed48,1,4688177,4688177,4756241,4770471,68064,68064,0,0,0,0
4760411,538effb3-c383-593e-5b95-a54f28c93890,1,4688056,4688056,4760411,4758297,72355,72355,0,0,0,0
4767807,c9a55c3f-e6ff-94ab-3a5a-8cb5e0302758,1,4755035,4755035,4767807,4770391,12772,12772,0,0,0,0
4769560,8ce73828-7a63-917e-1469-cfdbead46475,1,4757662,4757662,4769560,4765515,11898,11898,0,0,0,0
4770263,5b109a2e-3909-3be5-9ece-be8b986acfa9,1,4757847,4757902,4770263,4768093,12361,12416,55,0,0,0
4770515,03b5c887-00e7-7534-ec95-0f7823758092,1,4757694,4757722,4770515,4768490,12793,12821,28,0,0,0
4771112,bb6422e2-1d34-e06c-81ce-4558c8470df9,1,4757755,4757782,4771112,4766015,13330,13357,27,0,0,0
4771156,6ed87028-76a2-ff02-634a-e33fd1f0a992,1,4757787,4757842,4771156,4775812,13314,13369,55,0,0,0
4771259,2b598412-b563-4cef-6890-02c95d42e4d8,1,4757725,4757782,4771259,4769262,13477,13534,57,0,0,0
4771538,15d84e9b-003e-c05d-85a4-ab81f85cc63f,1,4757817,4757842,4771538,4767025,13696,13721,25,0,0,0
4794607,5936a93a-01af-4a2d-8b07-41cb503d1236,1,4775903,4775906,4794607,4795130,18701,18704,3,0,0,0
4794710,388b5988-de1d-2436-0722-28d21f26c34c,1,4776024,4776026,4794710,4803980,18684,18686,2,0,0,0
4794956,01e09a69-e2b1-fbb1-fbb0-1d3921d822ca,1,4775966,4775966,4794956,4793452,18990,18990,0,0,0,0
4795310,5b4d9268-ad5f-fca4-d24e-4e2a52381a07,1,4775786,4775786,4795310,4793622,19524,19524,0,0,0,0
4796052,3c7f8b52-4208-3fa0-eb78-4780b00454fb,1,4776223,4776228,4796052,4794001,19824,19829,5,0,0,0
4796469,649bd378-5c20-2b0a-658a-5a6eb9a005c2,1,4776164,4776168,4796469,4804046,20301,20305,4,0,0,0
4798478,68d87faf-18c8-bf84-dffd-dab03b23129b,1,4744370,4744370,4798478,4805531,54108,54108,0,0,0,0
4798575,db1fde5e-5eb9-d396-2953-76ab668de2a1,1,4744235,4744235,4798575,4806282,54340,54340,0,0,0,0
4805762,4c4fe422-da6f-73c1-db1c-bfb775f581e8,1,4751755,4751777,4805762,4824906,53985,54007,22,0,0,0
4805905,febb019a-096e-4afe-d345-b9f1793c36af,1,4751871,4751926,4805905,4799484,53979,54034,55,0,0,0
4808995,49657b5d-6a54-dead-8478-69ac7d14b167,1,4751988,4751988,4808995,4829069,57007,57007,0,0,0,0
4809426,fcd9cb7b-c05e-290b-1267-6b44c68b7316,1,4755651,4755671,4809426,4803492,53755,53775,20,0,0,0
4809648,bcdd8d48-14b0-eb8b-5615-0ea9db92d7f7,1,4755411,4755427,4809648,4807734,54221,54237,16,0,0,0
4812692,6167bedc-c43a-a8f6-1fba-6c137e184928,1,4744657,4744657,4812692,4836313,68035,68035,0,0,0,0
4812858,8d428732-ac33-609f-aacd-faf4ac9b7b81,1,4776108,4776108,4812858,4801707,36750,36750,0,0,0,0
4812867,0b35ed5e-9d27-6f21-82b2-701b05f4551c,1,4775844,4775846,4812867,4825940,37021,37023,2,0,0,0
4815131,ecc82c83-59f9-24e4-fed4-db9ba6afbf13,1,4744105,4744105,4815131,4829847,71026,71026,0,0,0,0
4820223,f63f412d-bcc6-3ef3-d0d5-dd4891c4e3dc,1,4752106,4752108,4820223,4829829,68115,68117,2,0,0,0
4820445,15bffacd-cc1a-03b1-7155-1f3772997b02,1,4752351,4752351,4820445,4790720,68094,68094,0,0,0,0
4821462,3f4cd021-7a85-4220-f69b-867b5f679939,1,4744796,4744796,4821462,4819677,76666,76666,0,0,0,0
4822460,c615c1ad-749a-a3f5-2b39-d5e0023ed7bc,1,4755532,4755551,4822460,4829945,66909,66928,19,0,0,0
4823972,f2234e78-b412-868b-56d3-d5048b606fac,1,4755811,4755811,4823972,4818481,68161,68161,0,0,0,0
4824229,656d4ac5-dd79-8931-8bbf-59e86a614de0,1,4755933,4755933,4824229,4821993,68296,68296,0,0,0,0
4824606,25c7573c-cc1f-5c7a-4e5e-1700d0a79577,1,4756050,4756104,4824606,4822163,68502,68556,54,0,0,0
4829661,0d5e6080-6e49-83d2-935b-4d115debc97e,1,4744508,4744508,4829661,4860647,85153,85153,0,0,0,0
4837054,e7b0a8c6-b20e-3a6d-6497-5769c2394ef6,1,4752232,4752232,4837054,4818219,84822,84822,0,0,0,0
4879793,e8db35af-e0fe-dfff-db6f-c05a37f5c9f8,1,4832502,4832502,4879793,4871336,47291,47291,0,0,0,0
4880367,c663afe5-bb13-7c2d-6345-a91a324fa1c2,1,4832386,4832386,4880367,4874900,47981,47981,0,0,0,0
4886744,a0d5f5a8-1f6a-f536-cd9f-5a8bb139e304,1,4832622,4832622,4886744,4898715,54122,54122,0,0,0,0
4901009,769d9a2d-d62a-a418-d15d-4c984434b32b,1,4832738,4832738,4901009,4906719,68271,68271,0,0,0,0
4901193,5a4af4d5-7301-edd9-9fa8-133302a6bcf9,1,4832856,4832856,4901193,4904953,68337,68337,0,0,0,0
4901222,2b8f8a7b-8871-decd-fa37-aafc4ff01aa8,1,4832976,4832976,4901222,4899636,68246,68246,0,0,0,0
4938557,b79c66a9-668d-aa7d-e5ec-a32a3983899a,4,4936716,4936716,4938557,4939071,1841,1841,0,0,0,0
4944631,ff33ddaa-c9b5-d7fb-ee26-ad7ccee2a3c1,4,4942146,4942146,4944631,4945009,2485,2485,0,0,0,0
4956906,e502cd22-2d69-2f4b-d85a-44ce4404b798,2,4904172,4904172,4956906,4949111,52734,52734,0,0,0,0
4958722,ea6300c6-3add-e81f-c548-6758c90a1764,2,4904796,4904832,4958722,4934827,53890,53926,36,0,0,0
4959995,d647e27d-c9f9-196b-3c92-a242aafc55d8,2,4904879,4904892,4959995,4954294,55103,55116,13,0,0,0
4961031,b37b6d90-f010-d498-51c1-46e0d146ad46,2,4904908,4904952,4961031,4963238,56079,56123,44,0,0,0
4961251,08ac6779-938b-2cf6-7171-f13badfae807,2,4904685,4904712,4961251,4988788,56539,56566,27,0,0,0
4962248,a3c9711c-e95b-a670-84de-dbdd24bb271a,2,4904850,4904892,4962248,4976178,57356,57398,42,0,0,0
4963710,29f3e4a4-4570-a4c8-c4e1-01464008c602,2,4904421,4904472,4963710,4974692,59238,59289,51,0,0,0
4964339,9ce4a933-fefa-0edc-2e52-0c85b10b6f14,2,4904740,4904772,4964339,4948361,59567,59599,32,0,0,0
4965806,769a6ad6-13c5-c9e7-2e76-f1eda8a14ff8,2,4904198,4904232,4965806,4938742,61574,61608,34,0,0,0
4968900,ac313207-813c-4044-ed11-fa5b268416b1,2,4904336,4904352,4968900,4955960,64548,64564,16,0,0,0
4968903,cc0685f3-d061-9982-36c6-653ca7cb6e0b,2,4904394,4904412,4968903,5000495,64491,64509,18,0,0,0
4970251,d9b87aa5-333c-c41a-2301-24fcf9c28ab6,2,4904364,4904412,4970251,4966844,65839,65887,48,0,0,0
4970318,2e581b7d-a403-47ea-22ff-775eced99bda,2,4904226,4904232,4970318,4997845,66086,66092,6,0,0,0
4970573,5e56344e-d93c-a04a-f95b-37d0590eda66,2,4904657,4904712,4970573,5002053,65861,65916,55,0,0,0
4971227,b803b89b-998c-522e-fbd5-1ab07043ee49,2,4904449,4904472,4971227,4992164,66755,66778,23,0,0,0
4972147,fbaf9dbc-6d8e-bf7d-6520-82704d7a3879,2,4904308,4904352,4972147,4967344,67795,67839,44,0,0,0
4972815,c97d9eb3-ae55-8edb-ee8f-608c8033f331,2,4904935,4904952,4972815,4988647,67863,67880,17,0,0,0
4974197,24c10c38-f555-9618-04be-9fe6815a475b,2,4904253,4904292,4974197,5000722,69905,69944,39,0,0,0
4974212,1df6c7d5-75d5-cbd7-2dca-6b05daa5d339,2,4904628,4904652,4974212,4976911,69560,69584,24,0,0,0
4975111,db61d706-0a5b-3955-0922-63749a321c2c,2,4904505,4904532,4975111,4949488,70579,70606,27,0,0,0
4975135,b27fbe1e-3e2f-d92b-ca3d-f1ec67cc7b22,2,4904533,4904592,4975135,4967213,70543,70602,59,0,0,0
4980638,1b720373-dbc2-8648-a44b-fb90b527d358,2,4904562,4904592,4980638,5007108,76046,76076,30,0,0,0
4980655,7fd72900-84e4-7970-bcb9-b5eff272a361,2,4904600,4904652,4980655,5004396,76003,76055,52,0,0,0
4998343,de8cacd8-b70c-712b-8772-74ae444f6b9c,1,4963249,4963273,4998343,5014815,35070,35094,24,0,0,0
5004834,425de4aa-569a-6fa0-0342-844cfea538dd,2,4904281,4904292,5004834,5043154,100542,100553,11,0,0,0
5006008,a01df13b-b2c3-96a8-2f3f-0f4d3cd30c74,1,4963718,4963770,5006008,4993363,42238,42290,52,0,0,0
5006602,ee0d9cd1-0fe7-ce56-1415-5b0644a29ac2,1,4963343,4963393,5006602,5016801,43209,43259,50,0,0,0
5008045,f04ba4a5-05ae-3564-b362-d933e9b421cb,1,4963380,4963393,5008045,5018003,44652,44665,13,0,0,0
5008752,42d8d88c-01ee-02e8-cb19-e67209fcda15,1,4963943,4963950,5008752,5027360,44802,44809,7,0,0,0
5009562,1a10eea5-183c-3a91-7486-66e36e60c632,1,4963217,4963273,5009562,5032365,46289,46345,56,0,0,0
5009621,19d2563b-6745-5a12-bff4-90680741ada1,1,4963911,4963950,5009621,5025243,45671,45710,39,0,0,0
5010046,65a9defd-4a79-0f10-1a3a-9e55756c7602,1,4963751,4963770,5010046,4999811,46276,46295,19,0,0,0
5012314,768b59cf-dd94-8ee9-74a6-2c78ce506c3b,1,4963153,4963153,5012314,5013049,49161,49161,0,0,0,0
5013223,4d6df394-6345-6435-2784-ed8769190646,1,4963185,4963213,5013223,5037780,50010,50038,28,0,0,0
5021407,f1a7a1e5-6d43-2895-feac-95760f102d04,1,4963313,4963333,5021407,5012504,58074,58094,20,0,0,0
5021717,7e330394-1864-2157-9e3c-9a141ca52b59,2,4973919,4973924,5021717,5032358,47793,47798,5,0,0,0
5021814,9a2b048c-bb2e-cc2d-c8e7-c9dddafda8b0,1,4963281,4963333,5021814,5011977,58481,58533,52,0,0,0
5028843,76043923-81a4-10ee-1654-28d312782b00,1,4963784,4963830,5028843,5032502,65013,65059,46,0,0,0
5028870,f3f869a2-b17f-da96-9731-3195b6f2df85,1,4963815,4963830,5028870,5049817,65040,65055,15,0,0,0
5029145,74d5b2d8-de8f-a835-f8de-58878e65c49b,1,4963847,4963890,5029145,5040600,65255,65298,43,0,0,0
5029599,eb8ee3cf-4bee-387c-56c7-2014df985d8f,1,4963878,4963890,5029599,5045604,65709,65721,12,0,0,0
5035068,bbc85bd1-5144-6a73-7aea-51705a2a9ffa,2,4973949,4973984,5035068,5055997,61084,61119,35,0,0,0
5041312,19f1cd02-186a-7b76-4c23-a832f9b15252,2,4973893,4973924,5041312,5039570,67388,67419,31,0,0,0
5044637,c9dbbf54-4ed5-ac95-3fd2-27a2cbfa9ffa,1,5034218,5034218,5044637,5043719,10419,10419,0,0,0,0
5045370,b18f8340-72e4-73d0-71e1-53aabb031c3c,1,5034345,5034398,5045370,5048897,10972,11025,53,0,0,0
5045609,6918e376-1777-0812-b51e-38d38a35da2f,1,5034379,5034398,5045609,5041031,11211,11230,19,0,0,0
5045622,effdaa95-1d1e-b5b1-04f3-bf0c664d94bf,1,5034410,5034458,5045622,5040933,11164,11212,48,0,0,0
5046309,1b31babd-7083-3311-4b04-94eaa383f5f0,1,5034442,5034458,5046309,5041651,11851,11867,16,0,0,0
5051649,2272e505-25f7-65c1-e4b4-a342b5f58b0c,1,5034251,5034278,5051649,5046643,17371,17398,27,0,0,0
5052063,2e650179-4328-b471-3faa-2f6c1703c64e,1,5034282,5034338,5052063,5049400,17725,17781,56,0,0,0
5052153,6e557153-54f8-99a6-ebd9-5bf4b0f88222,1,5034314,5034338,5052153,5048340,17815,17839,24,0,0,0
5057656,4aef9cab-0677-104c-c0f1-c791241ebe94,1,5051839,5051839,5057656,5060166,5817,5817,0,0,0,0
5057912,df7d2c88-5ff3-8515-3ea5-967be054396c,1,5051892,5051899,5057912,5060470,6013,6020,7,0,0,0
5057936,b2eb9348-67d7-f4e1-8d1a-10220e2c4752,1,5051777,5051777,5057936,5056183,6159,6159,0,0,0,0
5058020,5364575b-29ad-d798-2428-82234c01838f,1,5051956,5051959,5058020,5056067,6061,6064,3,0,0,0
5058186,4b27c723-2a07-5583-9366-86b1330c9f49,1,5051987,5052019,5058186,5059819,6167,6199,32,0,0,0
5058350,3b64ab6e-a594-63b3-9bfc-0beba1cc4bfe,1,5051923,5051959,5058350,5059302,6391,6427,36,0,0,0
5058551,de86c55b-423b-41ba-94ef-2e3274f6107d,1,5052020,5052079,5058551,5056792,6472,6531,59,0,0,0
5058734,1ef24425-45ff-45e4-f36e-400e4ba9f749,4,5048023,5048023,5058734,5061326,10711,10711,0,0,0,0
5061722,385387eb-870c-69f4-7b7f-7b0c9b42967c,2,4973864,4973864,5061722,5032731,87858,87858,0,0,0,0
5147274,827822bc-4cf5-72f5-3f1e-f01352929ea1,2,5104565,5104565,5147274,5135042,42709,42709,0,0,0,0
