time,job_id,num_gpu,submit_time,start_time,end_time,ddl,executed_time,JCT,pending_time,preempt,promote,best_effort_job
18059,479d5be0-d819-a033-800e-400e728fe07e,64,16566,16566,18059,20924,1493,1493,0,0,0,0
18608,4c693bbf-9253-5094-3f31-19e4abfd0310,64,16566,16566,18608,25084,2042,2042,0,0,0,0
19958,005d539a-d8e3-0d8a-28be-1eae4a4941c3,64,16567,16626,19958,25940,3332,3391,59,0,0,0
20924,59a72878-e5c4-ab9d-e813-68c36b50edeb,64,16566,16566,20924,21347,4358,4358,0,0,0,0
21122,4b7f63f0-4b60-7161-3e43-92c161092e82,64,19725,19784,21122,25504,1338,1397,59,0,0,0
21294,463de7cd-2624-91af-d072-8b7cdcf04af3,64,19724,19724,21294,25771,1570,1570,0,0,0,0
21905,d12f0e69-6d91-8a22-81c0-6d2aab0435f9,64,20580,20639,21905,22389,1266,1325,59,0,0,0
22153,f9d6d733-209c-7e52-d1c8-7cdc3a6a6a52,64,20579,20579,22112,25809,1533,1533,0,0,0,0
22246,5663c48d-fb04-72f6-0fd0-f828a2e06448,64,22093,22093,22246,22750,153,153,0,0,0,0
22614,db9927be-2c17-ab53-7b31-f3bdd1a77289,64,16567,16626,22614,22747,5988,6047,59,0,0,0
22688,59ed7c17-56b7-d953-86f5-af42fd4a3fdf,64,20580,21122,22688,26342,1566,2108,542,0,0,0
22888,f837987b-4596-951c-bf26-69d8b97ca3bd,64,19724,19724,22888,23205,3164,3164,0,0,0,0
23511,ccda772b-f3f9-c3fb-4651-59bba2ca75ad,64,19724,19724,23511,28381,3787,3787,0,0,0,0
23808,73d9b21f-74ea-cf05-82df-63e50e748ff2,64,20580,20639,23808,22774,3169,3228,59,0,0,0
24209,95a87e55-a97a-1690-bd30-435d0f1ecdb9,64,20580,20639,24209,23477,3570,3629,59,0,0,0
25475,43c9f21a-4cc6-b333-14c9-65c7ffa8e1ad,64,19724,19724,25475,29498,5751,5751,0,0,0,0
28568,f45dbbd1-e021-13f9-b04b-dd28ad20aba4,32,26894,26894,28568,30824,1674,1674,0,0,0,0
28628,bc260d61-e652-9fbe-4401-9da2485070d9,64,26894,26894,28620,29469,1726,1726,0,0,0,0
29735,453d7b05-3e0f-27b5-b49c-44d3d76b4582,64,26895,26954,29735,29757,2781,2840,59,0,0,0
31584,5a4dda5a-26c0-93c1-df1c-f3432044df0a,64,26894,26894,31584,30999,4690,4690,0,0,0,0
45846,b8872812-c832-b0c6-40ca-4676fe9d3d0f,64,39128,39128,45846,42513,6718,6718,0,0,0,0
79955,7bd63c59-d7ea-6d5d-1899-4a8bad5d5c2a,64,46177,46177,79955,108301,33778,33778,0,0,0,0
101626,6e4c2b13-04bc-5453-fcee-2f599ef4acfb,64,64148,64148,101626,86748,37478,37478,0,0,0,0
103738,d5c505eb-ca35-3dbb-d821-81e962c02472,64,102293,102293,103738,107228,1445,1445,0,0,0,0
103807,6dab734b-89de-689e-9188-0d4dd96f7b22,64,102296,102353,103807,106304,1454,1511,57,0,0,0
104571,90e58c66-10c4-0164-92e0-cec0bf440417,64,102880,102939,104571,107409,1632,1691,59,0,0,0
104936,4bfecb44-d78d-9826-f309-327e6e756922,64,102879,102879,104936,107270,2057,2057,0,0,0,0
106369,efa8972c-d4c4-be39-b6c1-11ada2e6f414,64,102880,102939,106369,105234,3430,3489,59,0,0,0
106442,80f5501a-6d61-d5b8-28d7-72777f3b8ac6,64,102880,102939,106442,105503,3503,3562,59,0,0,0
106904,b006640b-cc61-3570-4f45-cca466c0d8b6,64,102294,102353,106904,106058,4551,4610,59,0,0,0
108143,f4a51943-f84c-f06d-e905-5133f22bf842,64,102880,102939,108143,108965,5204,5263,59,0,0,0
130508,280ba7ec-bbf0-24d5-5ea0-34fbbdafbb79,64,115503,115503,130508,133492,15005,15005,0,0,0,0
161799,91471e8a-7ede-ad33-d1c0-53239be61d4c,64,161275,161275,161799,162717,524,524,0,0,0,0
163182,90e3c103-0d13-69d2-d33e-61d3112e3f6e,64,162187,162187,163182,163454,995,995,0,0,0,0
174394,a22eea25-6b79-ed8f-5481-2e50ef2ae1cc,64,64148,64148,174394,158316,110246,110246,0,0,0,0
188771,3aa0124d-798f-eb71-06be-735f364e4bbb,64,141897,141897,188771,236788,46874,46874,0,0,0,0
193973,ef5288c1-0c61-7fba-001e-02a138fb7764,64,104807,104807,193973,256608,89166,89166,0,0,0,0
208264,be48840a-9e1f-7fd7-fb05-569b9d36475c,64,141898,141957,208264,232646,66307,66366,59,0,0,0
215875,9b9017b7-b5a9-ae60-9cfc-867e44aed639,64,198389,198389,215875,235647,17486,17486,0,0,0,0
220442,b3a0ec14-d432-b7be-4b1e-295e62a61390,64,198264,198264,220442,223230,22178,22178,0,0,0,0
223873,d1f3d0a6-20f7-59f6-9df0-503b4f626e9a,64,204851,204878,223873,252266,18995,19022,27,0,0,0
228423,cffe9499-77d7-81ab-8259-de970673f2ef,64,204818,204818,228423,223733,23605,23605,0,0,0,0
231706,a60f6d4b-3ae5-02e4-a69b-da6aa7532a0a,64,199985,199985,231706,242048,31721,31721,0,0,0,0
241034,e5106ee7-7a7d-434f-a709-a048d8555cb1,64,204919,204938,241034,250779,36096,36115,19,0,0,0
248070,b1d97384-c419-8ca8-1a29-9aa721d80287,64,204897,204938,248070,247144,43132,43173,41,0,0,0
288131,ba0d9306-b401-f55a-a8dc-da693ab5d005,64,285848,285848,288131,291963,2283,2283,0,0,0,0
288191,b41fbb64-2ede-f019-9e67-e1a7399d1a8b,64,285848,285848,288167,294578,2319,2319,0,0,0,0
289350,4ed05f80-b898-137f-a916-f5ddbb637777,64,285849,285908,289350,289325,3442,3501,59,0,0,0
290783,4a72f034-eab6-f918-f3fc-6cf0cb18754a,64,285848,285848,290783,291645,4935,4935,0,0,0,0
297024,1c2084f4-3c94-fec2-ac88-5c29e62df24b,64,275106,275106,297024,312546,21918,21918,0,0,0,0
301071,4062a629-7393-68cf-468d-4293400910a8,64,275660,275660,301071,295077,25411,25411,0,0,0,0
319770,2ed7e3f7-0a46-9ab4-f833-f215a37cd69c,64,265981,265981,319770,323232,53789,53789,0,0,0,0
340484,defc986d-1ec7-1dea-1acd-debd2a05e4f1,64,50853,50853,340484,607846,289631,289631,0,0,0,0
355512,57987c78-1aac-6e19-10e4-f295c91c253b,32,339260,339260,355512,369115,16252,16252,0,0,0,0
377075,7e3450c8-94a0-e914-5d13-b930b086856c,64,372059,372059,377075,383439,5016,5016,0,0,0,0
377221,b6d09d3f-2c76-cda4-e829-96b32ba095a8,64,353854,353854,377221,395306,23367,23367,0,0,0,0
384676,153025d2-d879-b502-4793-a4c5eef3780d,64,383190,383249,384676,385405,1427,1486,59,0,0,0
387525,2405c33c-1072-ac5a-58c9-3ac694ff24c6,64,383190,383249,387525,385309,4276,4335,59,0,0,0
388075,195de8fc-7932-332d-d227-748e37def057,64,383189,383189,388075,388437,4886,4886,0,0,0,0
389236,08c07a40-df99-2ee9-5be7-37d7abe7d30d,64,383189,383189,389236,386868,6047,6047,0,0,0,0
399454,6c5a42ff-6a52-9fe7-3a9e-06d3f216f4fd,32,383291,383309,399454,401871,16145,16163,18,0,0,0
402980,fd781dd0-7ab8-0404-e910-7e52655c14ca,64,388460,388460,402980,412789,14520,14520,0,0,0,0
404592,eb9a0845-e7a3-5e54-986f-51f1940a9173,64,382569,382569,404592,396668,22023,22023,0,0,0,0
405235,9f9fac12-9058-edc6-3568-3da7564fedc4,64,387324,387324,405235,405797,17911,17911,0,0,0,0
405373,2fddcb84-f1b7-9a0a-6a26-2309db2f42ba,64,399811,399811,405373,407998,5562,5562,0,0,0,0
408554,4f5964ca-f47a-5c6b-9a7a-ae550ce9937e,32,386792,386792,408554,418574,21762,21762,0,0,0,0
417290,5e7d482c-ab62-57fb-a19f-a30bef832bbd,64,383234,383249,417290,426636,34041,34056,15,0,0,0
417350,ccc50157-4d1e-eca2-18ab-5f706c352765,64,375897,375897,417313,431597,41416,41416,0,0,0,0
418106,d7efc5d6-622c-f01a-a0c8-73380a1da7ac,64,390190,390190,418106,423124,27916,27916,0,0,0,0
451787,e72b4cd2-0a44-c0d0-7e37-32df45a79e6d,32,441987,442045,451787,458478,9742,9800,58,0,0,0
454245,b0acd856-2542-45a7-faad-3456f479d739,64,439730,439730,454245,460261,14515,14515,0,0,0,0
456506,fe812d84-6abd-ee14-eefc-a5b88abbf53e,64,441985,441985,456506,455007,14521,14521,0,0,0,0
458190,ac620f66-5176-777f-9c45-e35e7ec39149,64,441986,442045,458190,459052,16145,16204,59,0,0,0
464488,ce19c9e3-0375-3465-566c-a73079fa2d51,64,454847,454847,464488,471042,9641,9641,0,0,0,0
471215,f53d7637-bb9e-acb8-a25e-3bb5773d2de7,64,469765,469765,471215,475684,1450,1450,0,0,0,0
472133,915fe1be-9fbf-c6f9-f0b3-912d208dcf81,64,469765,469765,472133,474199,2368,2368,0,0,0,0
473144,6a8c0fc8-2906-f7d2-2ff4-931d32f8d1ea,64,469766,469825,473144,473101,3319,3378,59,0,0,0
480064,e5d60392-7522-efb9-67a8-fc6fb441520e,64,470732,471215,480064,485440,8849,9332,483,0,0,0
482274,c824dd9b-33e6-fc58-5858-3f9567cb4a86,64,468604,468604,482274,485501,13670,13670,0,0,0,0
483612,be4799ef-19ac-234c-408e-079d8de25f83,64,379865,379865,483612,462277,103747,103747,0,0,0,0
486093,6a6248cd-583b-b0f9-1560-5ac850c87167,64,474125,474125,486093,486168,11968,11968,0,0,0,0
488090,d7bedd64-2c3d-420a-609d-8eb21d75f479,64,470732,470732,488090,482078,17358,17358,0,0,0,0
489476,468d1b94-90f2-9aaf-bb7d-4c0c91f0a496,64,470732,473144,489476,489146,16332,18744,2412,0,0,0
491664,a65cf542-19f2-8e47-ca75-92b544de7004,64,480827,482274,491664,497447,9390,10837,1447,0,0,0
492680,24fb3d3a-08d0-39fa-24a0-d7e514f652e3,64,488705,488705,492680,496315,3975,3975,0,0,0,0
528134,db8ff9e0-81d6-b704-f4e5-908093f61d20,64,48927,48927,528134,443495,479207,479207,0,0,0,0
533463,ba5ddb0a-0337-5e28-6bd2-b5e373b5e5e7,32,523713,523713,533463,542082,9750,9750,0,0,0,0
533523,9202fcdc-6c24-4305-0e40-eabe15904fad,32,523713,523713,533484,541743,9771,9771,0,0,0,0
533523,eea68c44-a7bd-2d53-f3fc-bf095d2d5b5a,32,523715,523773,533517,531215,9744,9802,58,0,0,0
537944,3d06ee50-cef3-cf3d-be57-2f5d53b84cc2,64,458422,458422,537944,584120,79522,79522,0,0,0,0
538124,98cc638a-3777-dfdf-c57a-a4316a00042e,64,523713,523713,538124,540787,14411,14411,0,0,0,0
541194,83bc4316-426d-9788-eba3-7969e1f38d65,64,527814,527814,541194,550028,13380,13380,0,0,0,0
541649,ec3af1c0-820c-82d6-0451-c06ee9452e51,64,468540,468540,541649,519405,73109,73109,0,0,0,0
553227,27d14542-38be-5982-2f8e-b2bbf7e6a5e1,64,549389,549447,553227,554353,3780,3838,58,0,0,0
557033,c1a2c6d1-9f77-0e6b-1d72-472984b34d95,64,549387,549387,557033,557512,7646,7646,0,0,0,0
557160,66de99c7-4ad4-7ade-6865-7a0b05912a14,64,549388,549447,557160,563606,7713,7772,59,0,0,0
559757,9eb88fd5-d8d2-1da3-bb7e-c54b0979cb92,64,549391,549447,559757,563274,10310,10366,56,0,0,0
560401,2e84377e-8573-a350-fd11-abcd0f5a3828,64,551525,551525,560401,573483,8876,8876,0,0,0,0
562511,384dd0b9-1f04-30f7-97ac-5366b7f12e0d,64,551525,551525,562511,572300,10986,10986,0,0,0,0
569543,b7e45f77-155a-2f4b-c065-944a83faadf8,64,50370,50370,569543,422304,519173,519173,0,0,0,0
570816,f3676a37-2a69-9380-b8c8-b9da87ee3a06,64,46667,46667,570816,418655,524149,524149,0,0,0,0
571028,dc18314c-510f-8c61-6129-e7ff18189b01,64,527815,527874,571028,582211,43154,43213,59,0,0,0
571088,629b6715-240d-320e-82e2-8d0146a3f3df,64,570514,570514,571084,571473,570,570,0,0,0,0
571320,57919d9b-9521-b0fe-3ae0-e617d35efb8b,64,496275,496275,571320,665983,75045,75045,0,0,0,0
573444,58e31e60-79dd-d034-1ca4-b5f0c15b73ac,64,572336,572336,573444,572891,1108,1108,0,0,0,0
575865,700a051c-bc0e-9d13-dc0b-2aa657884e3d,64,533251,533251,575865,575742,42614,42614,0,0,0,0
576586,379cac86-2c60-07f7-4b1d-649fa225ecb4,32,575724,575724,576586,576857,862,862,0,0,0,0
581043,ad5eec30-9e5d-272a-4426-4a3a453fdd62,64,545382,545382,581043,596322,35661,35661,0,0,0,0
593776,138b5754-e6b0-e671-fa73-04de3226513c,64,588205,588205,593776,607550,5571,5571,0,0,0,0
594480,07813300-12ac-1acf-82dc-bca23d10afa3,64,593402,593402,594480,595140,1078,1078,0,0,0,0
620859,a58d0e7f-eb32-59f2-3102-a3e66bf56b5e,64,617350,617409,620859,624441,3450,3509,59,0,0,0
621655,ad08ba34-30d6-817d-6314-e061eed02773,64,617351,617409,621655,625123,4246,4304,58,0,0,0
621820,6c8ebc13-dcf9-8f24-2a20-70ec1e892458,64,618990,618990,621820,630816,2830,2830,0,0,0,0
622924,fc864a8f-21bc-c0d3-e8ce-00e16ef3e4cf,64,617351,617409,622924,625152,5515,5573,58,0,0,0
623242,83c821b3-9708-f965-0a31-e7957aa51b94,64,617349,617349,623242,627185,5893,5893,0,0,0,0
640556,d897402f-82e1-5b2d-1bed-d598648c155c,64,639792,639792,640556,640249,764,764,0,0,0,0
646575,f783fd33-18ed-4c57-0a0a-056b18316028,64,639179,639179,646575,659408,7396,7396,0,0,0,0
651516,c640de83-dc80-ce4f-474b-559b27b66b42,64,614177,614177,651516,661315,37339,37339,0,0,0,0
655392,b363caf7-95ff-2475-a5df-723b12c33883,64,644390,644390,655392,656678,11002,11002,0,0,0,0
657495,4faaa183-3a02-5983-2781-6506eddf5727,64,644988,644988,657495,662993,12507,12507,0,0,0,0
658883,f569c3eb-d45e-3086-9f62-4fd65266bcb5,64,644160,644160,658883,665688,14723,14723,0,0,0,0
659561,8f6c0ecc-8050-b30e-14b4-83a68be686f9,64,650261,650261,659561,662365,9300,9300,0,0,0,0
666201,873a57a2-4224-d401-0501-c2a372b6e4ea,64,636888,636888,666201,706312,29313,29313,0,0,0,0
668886,98c9cd00-13a4-135e-337d-dfa45585e365,64,667724,667724,668850,668814,1126,1126,0,0,0,0
669347,4abe1238-79b8-2d58-8e07-291ebb354aec,64,668826,668826,669347,669361,521,521,0,0,0,0
671256,26ba5961-b86d-30be-4119-1b0acb44c06d,64,670072,670072,671256,671216,1184,1184,0,0,0,0
672253,897e0ab6-d3c9-c3f5-6b55-7a51654669c5,64,671721,671721,672253,672284,532,532,0,0,0,0
672313,7a73478f-a532-e111-eb15-204a57172489,64,671403,671403,672260,672849,857,857,0,0,0,0
673541,bb6d5625-9674-36ca-01c2-2d44fe9b6aa9,64,672668,672668,673541,673633,873,873,0,0,0,0
676391,5ba2384b-1500-6efb-6df3-99508fccf9fa,64,650336,650336,676391,692787,26055,26055,0,0,0,0
682006,4ff43344-4175-db40-25b0-edda7375e185,32,545496,545496,682006,804477,136510,136510,0,0,0,0
711082,b2c2f807-7477-1e37-f0eb-79dcd77845ac,64,644780,644780,711082,720209,66302,66302,0,0,0,0
737358,51d3d008-751a-1a69-d7b0-9caab3157055,64,736892,736892,737358,737867,466,466,0,0,0,0
737647,c5242773-c5d9-c6c6-47ce-a87eb7051e66,64,736588,736588,737647,737603,1059,1059,0,0,0,0
767587,a9fb1d06-13a3-08a7-e1a2-f8e4ce9b5f4d,64,766398,766452,767587,767669,1135,1189,54,0,0,0
768194,580fd0c8-23a0-c367-1962-ee51faf21514,64,766400,766452,768194,768145,1742,1794,52,0,0,0
769389,cdd39df9-efab-dfca-06bb-f0ec912a7718,64,766398,766452,769389,770012,2937,2991,54,0,0,0
769449,1eb00c17-3971-b0cd-ffed-8f164ff29102,64,766396,766452,769423,771099,2971,3027,56,0,0,0
770676,4f5826ee-66e9-3b5a-7689-a051e6e8737d,64,766397,766452,770676,771834,4224,4279,55,0,0,0
770812,b9b3943e-3b79-a6a3-d74e-0b86010732db,64,766396,766452,770812,772497,4360,4416,56,0,0,0
772850,9dde43be-b232-03b2-27c2-72c407d8a281,64,766396,769449,772850,773821,3401,6454,3053,0,0,0
772921,581d84d2-7364-0c2a-e45d-ad860e29a199,64,766396,768194,772921,772681,4727,6525,1798,0,0,0
773682,b4dbb303-2f92-a806-8b1d-b91d9c1ee1b4,64,766400,767587,773682,772614,6095,7282,1187,0,0,0
773824,6f6dd3b8-19ab-bcfc-b47d-e8c43fb9f39a,64,766395,766452,773824,770648,7372,7429,57,0,0,0
774311,b154f4cf-8e28-598c-3681-426062896134,64,766397,766452,774311,770717,7859,7914,55,0,0,0
775576,b06c5762-fd17-65aa-bd58-2d2ecc1d268a,64,766399,769389,775576,773001,6187,9177,2990,0,0,0
777296,a66afbf3-1154-92b2-6bc3-a70f058049ad,64,766399,772921,777296,775847,4375,10897,6522,0,0,0
777390,914cae6a-05f3-384c-5751-0bdba58d2e53,64,766398,770676,777390,774310,6714,10992,4278,0,0,0
777506,21341d9d-e134-7e3e-31ab-8695694fd2b4,64,766400,773682,777506,776294,3824,11106,7282,0,0,0
777938,ead56d45-c22d-e5ed-c83c-05f569940e03,64,766395,772850,777938,775335,5088,11543,6455,0,0,0
779630,4dded48c-dec4-f4f7-ca81-bf9cf735c25c,64,766392,766392,779630,779979,13238,13238,0,0,0,0
779791,4a28dce1-b31f-eb5c-8616-d74823b7179b,64,766392,766392,779791,779098,13399,13399,0,0,0,0
780067,1694fec5-0874-2d06-d371-11455e82bc4b,32,766392,766392,780067,778173,13675,13675,0,0,0,0
782007,38bae5e6-83d1-cdb9-8e03-7e5a41b3ea5b,64,766398,770812,782007,774678,11195,15609,4414,0,0,0
783276,24055a69-19b4-678f-4b80-f31398569e9f,64,766398,777296,783276,781788,5980,16878,10898,0,0,0
784444,1228bbdb-7563-b124-d883-26635478dcf7,64,766399,773824,784444,778081,10620,18045,7425,0,0,0
795866,0339e160-2af0-3727-ce40-02ff144c637d,64,768230,783276,795866,815162,12590,27636,15046,0,0,0
797818,a26133bd-4c0c-b31c-2a4e-1acc7137aa23,64,766396,777506,797818,797420,20312,31422,11110,0,0,0
804238,8fe17642-495b-5413-4f65-59864c99a53f,64,766392,766392,804238,805542,37846,37846,0,0,0,0
807726,6da910e1-2596-7c07-7d3f-ebfa38f57074,64,766398,777938,807726,799189,29788,41328,11540,0,0,0
809845,c6c9f8a7-18ad-8492-946d-363d0f64be5d,32,766395,783276,809845,813833,26569,43450,16881,0,0,0
844121,6b493c29-6230-26a6-8d38-7cd17b057474,64,757180,757180,844121,796852,86941,86941,0,0,0,0
867973,6ee752a4-f1f4-08d6-9048-2afd29c5b616,64,647896,647896,867973,809821,220077,220077,0,0,0,0
879834,a291789e-a96f-364f-ef4f-6cf4060c718e,64,854487,854487,879834,873945,25347,25347,0,0,0,0
896084,2579b838-3eac-9744-918e-c281d0c68dc0,64,894559,894618,896084,898626,1466,1525,59,0,0,0
900869,ff5d12b4-72b3-0e23-6808-ed48909f53e4,64,894559,894618,900869,903768,6251,6310,59,0,0,0
901381,02a3ba28-ea4b-e124-61f8-5138b03f3b16,64,894558,894558,901381,903073,6823,6823,0,0,0,0
904295,a12698cb-e3ad-5493-7b14-6976dfff67ad,64,872080,872110,904295,890380,32185,32215,30,0,0,0
905506,12b7ae3a-ef8a-213b-5081-21899771b1fe,64,894559,896084,905506,909911,9422,10947,1525,0,0,0
906066,d4e0c931-340e-9439-7990-0dbc6dc61203,64,894558,894558,906066,905221,11508,11508,0,0,0,0
906253,f932b117-d89f-cfd3-126e-0ebb586b7cab,64,872050,872050,906253,896661,34203,34203,0,0,0,0
912067,b47144cb-9c3f-8284-8985-63c20adfeaa5,64,893189,893189,912067,920640,18878,18878,0,0,0,0
915229,a815ca98-8516-6c74-fb1f-0b3dc91f035b,64,652396,655392,915229,810146,259837,262833,2996,0,0,0
916088,3b9b1b26-0e03-d2f6-18e1-4826bbb30175,64,893190,906066,916088,946407,10022,22898,12876,0,0,0
924848,dab44100-fc6c-fd4d-ad75-a56a3b691342,64,893190,893249,924848,934114,31599,31658,59,0,0,0
927470,c2c73e17-1cfd-873a-4e1a-08208d112a3d,64,893189,893189,927470,932537,34281,34281,0,0,0,0
936306,5d06140f-d082-00b5-2ebe-36bae5ed20a2,64,925878,925898,936306,958328,10408,10428,20,0,0,0
939511,c9d58426-96ef-256d-8cc3-59325c031a06,64,893190,893249,939511,929273,46262,46321,59,0,0,0
959912,d4f90c7e-df70-6c5e-eaf4-596fd43e526e,64,925838,925838,959912,970747,34074,34074,0,0,0,0
970639,36d1de60-d9cd-7c20-e080-ec7094c2d6be,64,929670,929670,970639,967994,40969,40969,0,0,0,0
988996,ba90194d-8d62-16ae-9bb1-0c304ca547ec,64,646724,646724,988996,1342401,342272,342272,0,0,0,0
997208,9cb00458-ba74-a0ec-49d0-11e15da581a1,64,996651,996710,997208,997397,498,557,59,0,0,0
997304,d66aac3f-4edc-f550-cbb0-ed44a5d08e8a,64,996654,996710,997304,997874,594,650,56,0,0,0
997769,a0471a81-604f-73fd-93f7-dab74e616196,64,996650,996650,997769,998060,1119,1119,0,0,0,0
998015,61a768ad-ae13-f392-d175-e41538ea564f,64,927759,927759,998015,1019252,70256,70256,0,0,0,0
1003672,d362b035-9778-dc51-c146-a1573668c2e6,64,665328,665328,1003672,1021907,338344,338344,0,0,0,0
1010365,0732e070-c766-deb0-d6ba-85ff6d309097,64,997901,997901,1010365,1025024,12464,12464,0,0,0,0
1013227,2225a007-87bd-578b-baf0-dc54b524f4aa,64,1012604,1012604,1013227,1013288,623,623,0,0,0,0
1015733,c921ea4d-aa0a-130f-a0d9-471710d0d93d,64,1014636,1014636,1015733,1015437,1097,1097,0,0,0,0
1017062,7d529d81-5a42-592c-baf4-aa647dbedd33,64,1016046,1016046,1017062,1017467,1016,1016,0,0,0,0
1017122,d9344318-408c-a8b6-7482-ae0a97d64d7b,64,1015949,1015949,1017111,1016667,1162,1162,0,0,0,0
1018005,c3d914ac-2ee6-202d-5a9d-4d370e538edc,64,906294,906313,1018005,961769,111692,111711,19,0,0,0
1036593,ca22392f-2420-cf7d-f114-3cf46b41c5a6,32,998361,998369,1036593,1046963,38224,38232,8,0,0,0
1044851,fad9a222-562d-5082-f2a4-eec4bf6ebfb4,64,1025644,1025644,1044851,1055926,19207,19207,0,0,0,0
1047098,0f8c51a4-af9e-07ce-51d7-71f4417404b0,64,756506,756506,1047098,894092,290592,290592,0,0,0,0
1049779,e8934118-3bcf-f141-5a71-a26af89ce4e3,64,1026317,1026317,1049779,1062062,23462,23462,0,0,0,0
1051226,5985ec97-5f76-c60f-ffd0-843e2d099670,64,1026699,1026699,1051226,1053123,24527,24527,0,0,0,0
1053819,444438fe-2c9e-902d-72d6-63b8ba1cd102,32,1052199,1052255,1053819,1055601,1564,1620,56,0,0,0
1054638,dca86096-ca5e-763c-1402-4f2e3a4823db,64,1053208,1053267,1054638,1067014,1371,1430,59,0,0,0
1054840,ffeabdab-ec90-9c16-e3be-ef6aa682e50a,64,1052197,1052255,1054840,1056313,2585,2643,58,0,0,0
1054900,68b40bc2-68c9-d1ec-854e-9f38c002c580,64,1053208,1053267,1054858,1060209,1591,1650,59,0,0,0
1055309,95721c80-1dfb-535c-f0fe-15f04cf59f22,64,1052196,1052255,1055309,1053795,3054,3113,59,0,0,0
1055500,0fea2b4a-a500-58ad-1578-d9d2944bddfd,64,1052195,1052195,1055500,1054409,3305,3305,0,0,0,0
1056123,445bfa1b-7149-80b6-d357-19d6370bc640,64,1053208,1054638,1056123,1068405,1485,2915,1430,0,0,0
1056261,c976e3c6-6e7c-b12e-f61e-390ef4bf949c,64,1053207,1053207,1056261,1071311,3054,3054,0,0,0,0
1056616,30bd2596-5e7d-758a-717a-103cef03d3d1,64,1053210,1053267,1056616,1060932,3349,3406,57,0,0,0
1061280,4921d21d-63c6-68b5-482b-57f057fb3663,64,1025898,1025898,1061280,1061118,35382,35382,0,0,0,0
1061340,f861017a-b6d9-a814-4b25-165097252517,64,1060459,1060517,1061292,1063054,775,833,58,0,0,0
1062629,7d7fce03-28e3-9b52-fd2a-8680b2e80225,64,1060457,1060457,1062629,1063976,2172,2172,0,0,0,0
1062689,e0d69315-7eb9-cee4-7494-a3c7c9ee9528,64,1060458,1060517,1062657,1062989,2140,2199,59,0,0,0
1062916,d801e1e4-14ee-13d4-ed09-41bdb262762f,64,1060457,1060457,1062916,1063012,2459,2459,0,0,0,0
1062976,6562d164-042f-38d4-3298-16f9aaeae0ae,64,1061106,1061106,1062952,1077259,1846,1846,0,0,0,0
1063036,c814445b-44cf-0f64-b696-2d8c19916060,64,1060458,1060517,1062990,1063473,2473,2532,59,0,0,0
1065990,0bbde737-d284-98fe-ddf5-ffa9ee035463,64,1061107,1061280,1065990,1079723,4710,4883,173,0,0,0
1068917,3c91452f-837f-35e4-d6f4-1d4d2f09d845,64,1061107,1062629,1068917,1083167,6288,7810,1522,0,0,0
1071559,a06b9de7-6dda-2641-e250-51fc0efceb56,64,1061107,1062689,1071559,1094158,8870,10452,1582,0,0,0
1071726,c697e08a-d565-3971-46a4-f5c20023d461,64,998309,998309,1071726,1042594,73417,73417,0,0,0,0
1072431,f51ee600-2b51-5b74-3001-f7fa7d87b0f1,64,1070489,1070489,1072431,1082439,1942,1942,0,0,0,0
1072947,15cf6188-23fd-9aff-ec10-e1f8b9fc82c7,64,1070561,1070609,1072947,1076675,2338,2386,48,0,0,0
1073089,0d4b438a-d6e3-8a7a-4d93-c9cea8a5f970,64,1061107,1061340,1073089,1082516,11749,11982,233,0,0,0
1073804,6cccd823-f16f-5ab1-89ab-9c39f2dfaef0,64,1070491,1070549,1073804,1080063,3255,3313,58,0,0,0
1077644,9986d79a-159a-8b10-c29c-fe7fb0bfc05f,64,1070490,1070549,1077644,1089062,7095,7154,59,0,0,0
1079012,20ad0cda-f1b8-a180-59a4-a5bb6a51ebdc,64,1070490,1070549,1079012,1096670,8463,8522,59,0,0,0
1082490,8ef96d1d-ab03-5b9d-73c1-ca0ecfb7f286,64,1071571,1073804,1082490,1105436,8686,10919,2233,0,0,0
1083042,46f9e321-c431-af91-132f-68556553fc29,64,1071574,1071619,1083042,1092953,11423,11468,45,0,0,0
1084703,e95d4f3f-64b3-1c15-66de-504f669d4e54,64,1071571,1072431,1084703,1100079,12272,13132,860,0,0,0
1086224,ce5e7953-7c47-0439-195b-e9889965b63d,32,1078611,1078611,1086224,1092343,7613,7613,0,0,0,0
1093451,5b9bbe0b-eada-7aab-4fc4-afe20d426fcb,64,1064471,1064471,1093451,1120619,28980,28980,0,0,0,0
1094934,77b28ef7-cbd6-91f2-23f6-1b0f4bf0d344,64,1066933,1066933,1094934,1111789,28001,28001,0,0,0,0
1095960,bae222bd-1a9e-6038-7663-18c3ade637fc,64,1071571,1072947,1095960,1102354,23013,24389,1376,0,0,0
1096993,31a79ab7-2bb7-606f-d6f1-9ed129af80cd,64,1071571,1071619,1096993,1096585,25374,25422,48,0,0,0
1105098,63d071a4-ee84-c377-43bf-3fbd177dde3f,32,1104451,1104451,1105098,1105512,647,647,0,0,0,0
1105466,f814470e-ddab-291d-c91d-c8e15973c4fe,64,1104453,1104511,1105466,1105165,955,1013,58,0,0,0
1105527,21d9bb71-5287-ba9b-99b6-ea0dbf21b644,64,1104451,1104451,1105527,1105089,1076,1076,0,0,0,0
1107042,321ad789-92dd-2a85-43ff-9b458a7472b1,64,1087024,1087024,1107042,1114103,20018,20018,0,0,0,0
1115713,59525d09-bbde-5189-b43f-b27bebc7a4bd,64,1102477,1102536,1115713,1135671,13177,13236,59,0,0,0
1117957,16a28d57-c2e4-c5f9-8140-5c0bcbfc05b7,64,1101722,1101722,1117957,1114360,16235,16235,0,0,0,0
1119149,2a5f1281-c1f9-0df0-1d8b-e70d85517035,64,1101722,1101722,1119149,1147015,17427,17427,0,0,0,0
1120222,b947ccbd-a0ee-49c4-9b96-ba66111c2bcb,64,1087101,1087101,1120222,1110704,33121,33121,0,0,0,0
1132798,7755186e-0709-2506-6c8c-0bf7415724b7,64,1101722,1101722,1132798,1140739,31076,31076,0,0,0,0
1133251,fdcff48e-f682-8d38-4344-4bdd14863559,64,1066863,1066863,1133251,1103537,66388,66388,0,0,0,0
1140931,cd75ec26-f908-445c-31ae-643f3bd471c2,64,1101722,1101722,1140931,1157040,39209,39209,0,0,0,0
1142577,246b9039-a8d6-d52b-dd01-af9de8fbcbb5,64,1126135,1126135,1142577,1147780,16442,16442,0,0,0,0
1145930,28c0d9d7-9e00-a25c-d9dd-1168d8230ab6,64,1102476,1102476,1145930,1131884,43454,43454,0,0,0,0
1145990,9236f028-4096-6bde-966e-1fe9d3b91cce,64,1102477,1119149,1145959,1195677,26810,43482,16672,0,0,0
1166486,dd19089a-c0df-c9fa-1fa9-17171adbc816,64,1102478,1117957,1166486,1185886,48529,64008,15479,0,0,0
1173194,e8686cdb-60ae-e922-28b4-b176eadc2b3a,64,1159142,1159142,1173194,1173742,14052,14052,0,0,0,0
1192920,3ed9058f-fe4c-8365-b546-57af7219a19c,64,1189566,1189566,1192920,1199041,3354,3354,0,0,0,0
1193142,c011b984-6742-8cc9-243a-f5070394f573,64,1155380,1155380,1193142,1184888,37762,37762,0,0,0,0
1194240,41065145-a0f1-13a9-7ab8-b30bf343e220,64,1152087,1152087,1194240,1198402,42153,42153,0,0,0,0
1197778,d9280efb-4f50-29eb-7185-3225b46eb4bc,64,1159214,1159214,1197778,1200577,38564,38564,0,0,0,0
1198951,eedccefc-da8d-5e09-59b6-dfbd8e6abca3,64,1195448,1195448,1198951,1204353,3503,3503,0,0,0,0
1206205,f111a610-e782-1d04-9570-44a4bc0f80f4,64,1181134,1181134,1206205,1207017,25071,25071,0,0,0,0
1213829,180f7c28-6d80-b414-a6ed-75bea13a55f4,64,1182088,1198951,1213829,1215521,14878,31741,16863,0,0,0
1213897,e065fbbf-020b-8818-1c2f-2b781bbf6549,64,1155380,1155380,1213897,1185459,58517,58517,0,0,0,0
1216842,48f50a26-9bef-46b6-7c00-096ac6dc2fd7,64,1182067,1193142,1216842,1211510,23700,34775,11075,0,0,0
1219973,0b2b4aec-61ae-c7e4-ae53-141da4c316be,64,1150945,1151004,1219973,1187034,68969,69028,59,0,0,0
1220053,5ca00738-17de-9c8c-ecf4-a6ef727ec8dc,64,1150944,1150944,1220053,1225700,69109,69109,0,0,0,0
1220893,c517aab9-48a5-85ab-2d0c-27dc2bcd8637,64,1181262,1181262,1220893,1207215,39631,39631,0,0,0,0
1231311,a31b4949-e33b-87c6-a633-09284a443c7b,64,1150946,1151004,1231311,1213010,80307,80365,58,0,0,0
1243927,c22898eb-aa21-6e2d-98ef-f15bd57b5f77,64,1182011,1213829,1243927,1220070,30098,61916,31818,0,0,0
1249252,e67f6567-3cc0-d13a-7846-47853f19c434,64,1181318,1206205,1249252,1216209,43047,67934,24887,0,0,0
1259676,4aabf204-55e5-52ed-f9e3-4da2c00ec065,64,1252428,1252428,1259676,1260022,7248,7248,0,0,0,0
1260995,e927e96a-a0af-d6c5-8a46-c639e2f2e9b1,64,1255980,1255980,1260995,1260697,5015,5015,0,0,0,0
1273440,c7db9c2f-41f7-5c92-0a6c-ffb880b75299,64,1226391,1226450,1273440,1270057,46990,47049,59,0,0,0
1274733,45fecbb7-1220-2e65-ef53-78be71c937da,64,1240710,1243927,1274733,1282316,30806,34023,3217,0,0,0
1279903,fd46e78e-79fc-89b4-50cf-9dc217d3862d,64,1226390,1226390,1279903,1279814,53513,53513,0,0,0,0
1283144,d5afb1f2-1286-0afd-35f4-282486bbca40,64,1226392,1231311,1283144,1285522,51833,56752,4919,0,0,0
1284609,f9a77656-9d51-2836-691c-5f384c23b99c,64,1226393,1226450,1284609,1260434,58159,58216,57,0,0,0
1288022,7c2d17b7-3c0a-4ab0-13cc-0bcd85b1309b,64,1102477,1120222,1288022,1228647,167800,185545,17745,0,0,0
1292022,639a8b21-e5da-bd8d-462b-58bd8f626239,64,1240713,1240764,1292022,1279095,51258,51309,51,0,0,0
1299436,131926d7-ffc5-f0dd-973f-6c8514490841,64,1259042,1273440,1299436,1288557,25996,40394,14398,0,0,0
1304873,84ba53ed-17ea-bcb9-1c7d-8d12c7e77d0f,64,1261812,1283144,1304873,1290221,21729,43061,21332,0,0,0
1310439,0fe5919a-002c-1b6f-9add-33286dcace8a,64,1299487,1299496,1310439,1314336,10943,10952,9,0,0,0
1312831,8cbe92a2-10c5-d131-6142-827ecd88cff7,64,1240704,1284609,1312831,1309924,28222,72127,43905,0,0,0
1316342,d0925502-212c-2a65-f5eb-c6db5adc8876,64,1017166,1017182,1316342,1160499,299160,299176,16,0,0,0
1318915,3ec7ffff-2419-b2d7-451c-2c272e67a7a7,64,1299505,1304873,1318915,1321631,14042,19410,5368,0,0,0
1320047,fdc1bfa0-4568-c6cb-b5c0-c6b2b932ace1,64,1240708,1279903,1320047,1288961,40144,79339,39195,0,0,0
1325448,df60b6a2-5e94-b673-55d4-f687da6c84f2,64,1299596,1312831,1325448,1322999,12617,25852,13235,0,0,0
1328158,8a4d8551-b77b-7d49-ed25-3bb622c02c4f,64,1240711,1288022,1328158,1314889,40136,87447,47311,0,0,0
1329644,4aba6c97-165e-85ae-fc2a-9599146f530d,64,1226394,1274733,1329644,1288932,54911,103250,48339,0,0,0
1338491,b21a8ccf-8e68-b052-fd36-9ae7df097f1d,64,1299963,1310439,1338491,1321784,28052,38528,10476,0,0,0
1342822,f48ff43b-48e2-3369-19cb-9d229ff9cc0c,64,1300006,1320047,1342822,1338617,22775,42816,20041,0,0,0
1343262,0dd7d5ca-1510-fac2-96cd-51b5348b9ddf,64,1258024,1292022,1343262,1320530,51240,85238,33998,0,0,0
1350469,154a3f38-42a8-2bf2-ba8c-5a803e263894,64,1343631,1343631,1350469,1348190,6838,6838,0,0,0,0
1350744,7eb60a32-cb96-3e91-60c3-340b226ea8de,64,1299876,1318915,1350744,1337690,31829,50868,19039,0,0,0
1358115,7ed7a9ea-6f13-3776-bbd5-8ac59d33cbf6,64,1299861,1325448,1358115,1351101,32667,58254,25587,0,0,0
1362724,72f59bd6-bbf0-a38a-8ac0-a5ab6c46f485,64,1356793,1356793,1362724,1360918,5931,5931,0,0,0,0
1363068,046cdbcb-14c3-204e-f535-a292adcc3a97,64,1299750,1329644,1363068,1357882,33424,63318,29894,0,0,0
1364909,cc1f7a67-0dec-bd44-b283-ee48d90723af,64,1356858,1356858,1364909,1360326,8051,8051,0,0,0,0
1370885,ceb09fbc-94ce-efd9-0ffc-b124097317ce,64,1299678,1316342,1370885,1332951,54543,71207,16664,0,0,0
1425541,beddfff4-f85e-3f4c-e5fa-d7400f917695,64,1299238,1299436,1425541,1355893,126105,126303,198,0,0,0
1450901,4862b39a-36f7-d782-5e21-237f0b8d02cb,64,1432126,1432126,1450901,1470852,18775,18775,0,0,0,0
1460205,a463979f-ebcc-2391-602b-8a9baf23a809,64,1433701,1433701,1460205,1450094,26504,26504,0,0,0,0
1466855,716ad57d-e8bd-a252-ba57-4833f9c8665e,64,1433759,1433761,1466855,1455192,33094,33096,2,0,0,0
1482869,559018cc-a9f6-06a4-0e4f-8fd3a49caeb1,64,1474722,1474722,1482869,1485515,8147,8147,0,0,0,0
1482929,80660e6a-7e18-c7f5-a028-fcc1ac560926,64,1474727,1474782,1482922,1482450,8140,8195,55,0,0,0
1482989,b009ea93-0a2c-4b26-dad6-f2d1efc49028,64,1474729,1474782,1482941,1496421,8159,8212,53,0,0,0
1487847,9796e4a8-b471-3cae-25b1-04f807f85676,64,1474725,1474782,1487847,1492748,13065,13122,57,0,0,0
1489628,0a2becda-b652-6f1f-c655-e8b919072536,64,1474723,1474782,1489628,1485867,14846,14905,59,0,0,0
1498604,6cf7d833-c1f6-4956-f7fa-1734345732c5,64,1477345,1477402,1498604,1502164,21202,21259,57,0,0,0
1508992,6a01243e-c0b4-9496-12c1-8b50105c6365,64,1433529,1433529,1508992,1508765,75463,75463,0,0,0,0
1512384,60b071cb-3f98-4dfb-329a-18c6ddade203,64,1477342,1477342,1512384,1504410,35042,35042,0,0,0,0
1523333,285c81b3-2e3d-c6f6-c68e-578a4bc4befe,64,1477344,1482989,1523333,1532638,40344,45989,5645,0,0,0
1523691,e0451752-2560-7109-27d9-14f660c61390,64,1477344,1482929,1523691,1522401,40762,46347,5585,0,0,0
1525250,44fef4ee-dbaa-775d-0ea5-0542ceafcef1,64,1477343,1482869,1525250,1509427,42381,47907,5526,0,0,0
1526328,6385e5ba-a69f-2a45-a72a-ffc81149040b,64,1513800,1513800,1526328,1547123,12528,12528,0,0,0,0
1532355,9e9add66-024c-f9c6-febd-2f2326701a88,64,1507575,1507625,1532355,1534941,24730,24780,50,0,0,0
1545289,05313eae-9d64-66bb-fce3-6086fd7c581f,64,1507565,1507565,1545289,1556694,37724,37724,0,0,0,0
1549620,32578935-6415-670f-3baa-d0347196721e,64,1507568,1512384,1549620,1556730,37236,42052,4816,0,0,0
1555291,120bf8da-2b06-3821-7071-4dd8af4a1353,64,1538186,1538186,1555291,1545446,17105,17105,0,0,0,0
1556961,fabf757a-2bef-d5c8-6e12-55ea25ab957d,64,1507565,1507565,1556961,1539930,49396,49396,0,0,0,0
1557030,f3053157-4de3-566e-a514-d6979d9eb4b4,64,1507574,1507625,1557030,1536073,49405,49456,51,0,0,0
1558933,89d61386-a749-4814-a936-a04d8c70f0da,64,1541464,1549620,1558933,1562232,9313,17469,8156,0,0,0
1566513,8b9b6c7a-19b0-fc99-12b4-07e48d7939f0,64,1513235,1513235,1566513,1545987,53278,53278,0,0,0,0
1572850,4b3e597a-956b-5a88-e419-e351edd820ee,32,1509236,1509236,1572850,1556183,63614,63614,0,0,0,0
1575427,1da4f9b7-7296-ef3f-1d53-e010645c1929,64,1513235,1513235,1575427,1552209,62192,62192,0,0,0,0
1577627,cd2c99c2-f13b-88cf-7041-f2ae73297767,64,1513236,1557030,1577627,1588281,20597,64391,43794,0,0,0
1579772,487aad88-1ed1-23e4-e4de-ce0981dd1eaa,64,1513238,1526328,1579772,1559111,53444,66534,13090,0,0,0
1592731,29e3c43a-af68-6645-3e19-95abd810abb7,64,1528722,1532355,1592681,1559511,60326,63959,3633,0,0,0
1595863,2e815810-22f1-15a4-825f-17f91fb62189,64,1595469,1595469,1595863,1597485,394,394,0,0,0,0
1597247,7bae8ff5-4f90-8f60-fb96-a5dfdf57f8a5,64,1596228,1596228,1597247,1597448,1019,1019,0,0,0,0
1603214,680beca3-0702-4003-d0ac-e5a5231dfaaf,64,1513235,1556961,1603214,1582365,46253,89979,43726,0,0,0
1604469,cc4caf75-0cd8-58c9-05e2-d981ed73d7f2,64,1599943,1599943,1604469,1604141,4526,4526,0,0,0,0
1609668,0c3dc9aa-0a74-40d6-2bdf-b4e8ff52eb03,64,1509237,1558933,1609668,1594373,50735,100431,49696,0,0,0
1609888,e0c8feae-9c28-06c4-7d0b-e862ce349cdf,64,1509236,1566513,1609888,1596402,43375,100652,57277,0,0,0
1612021,12845ced-1b20-690e-b246-843473a03176,64,1608388,1608388,1612021,1617045,3633,3633,0,0,0,0
1612821,48319c94-bc96-c9a2-101d-8e159dde5625,64,1611417,1611417,1612821,1612206,1404,1404,0,0,0,0
1616804,fb4c8db0-eeae-c9df-356b-b318ac25d007,64,1509236,1555291,1616804,1570109,61513,107568,46055,0,0,0
1617142,29e976d4-57b1-9c28-f47b-38e28b4aa54f,64,1572475,1575427,1617142,1599912,41715,44667,2952,0,0,0
1624115,28c3bfb6-6192-910c-4847-7869e02064e8,64,1615419,1615419,1624115,1620781,8696,8696,0,0,0,0
1626740,e385e0ac-010e-edfd-ebe3-948271b73321,64,1625092,1625092,1626740,1627564,1648,1648,0,0,0,0
1627226,c11263df-3260-8aa0-3e0a-a90f75ecfcf9,64,1625372,1625372,1627226,1627237,1854,1854,0,0,0,0
1629795,305c70a2-3a3e-0b9f-b637-a2faa44b6f98,64,1627861,1627861,1629795,1630476,1934,1934,0,0,0,0
1630630,b541ce2e-00e7-567c-9d08-86fdc0a03dd1,64,1627949,1627949,1630630,1629995,2681,2681,0,0,0,0
1632397,826aada3-b721-9885-4060-86e71a0acca5,64,1628081,1628081,1632397,1632734,4316,4316,0,0,0,0
1634195,70068cce-94e4-dc3f-0898-bab0b31b8c07,64,1628118,1628141,1634195,1634478,6054,6077,23,0,0,0
1634694,ead6a157-3e93-18f0-e6df-3370eaf7588f,64,1572475,1579772,1634694,1622813,54922,62219,7297,0,0,0
1639903,7a69f46a-e89f-34c2-5dd8-bb7af4d37280,32,1592671,1609888,1639903,1642211,30015,47232,17217,0,0,0
1641576,0a6099e4-df52-4bb9-da58-b56e94b9e2f5,64,1640380,1640380,1641522,1641793,1142,1142,0,0,0,0
1641773,ba198686-154d-e0bd-9878-61d01577551a,64,1640383,1640440,1641773,1641304,1333,1390,57,0,0,0
1642551,cc280cba-3dfb-863d-6a64-0b5527bec87a,32,1572476,1604469,1642551,1628520,38082,70075,31993,0,0,0
1643935,bfa121f2-e7cd-126b-8a9a-9be0eaaba77d,64,1635324,1635324,1643935,1640708,8611,8611,0,0,0,0
1648397,c526199b-1591-2a0d-f407-18eacf553bea,64,1630348,1632397,1648397,1646751,16000,18049,2049,0,0,0
1651787,32303ee2-2707-c6ba-cfaa-3b1f60c5e090,64,1642023,1643935,1651787,1651530,7852,9764,1912,0,0,0
1652719,70af2ac0-7d71-f733-cb6c-52997942ed9a,64,1572475,1604469,1652719,1637801,48250,80244,31994,0,0,0
1653678,217cf31d-74a2-f3df-9c22-7efd345f120e,32,1642021,1643935,1653678,1651314,9743,11657,1914,0,0,0
1656288,50c12d97-c052-200b-64ae-4c4aaffdfbca,64,1641518,1641773,1656288,1651310,14515,14770,255,0,0,0
1659515,3cf40455-4211-bb02-7c68-83a01fcfe00e,64,1642022,1651787,1659515,1651974,7728,17493,9765,0,0,0
1661161,afb0b87f-3b02-c0d2-8efd-1d922a2c4d7f,64,1572477,1592731,1661161,1624163,68430,88684,20254,0,0,0
1665535,9db849a8-2c07-2525-7cf4-f3bb6d9d2c7c,64,1509236,1577627,1665535,1620912,87908,156299,68391,0,0,0
1665699,db895525-0fce-83cd-e417-fe84b7426ac9,64,1616590,1616590,1665699,1641634,49109,49109,0,0,0,0
1667791,08310ab1-b88a-9c95-a426-c86da549dbf6,64,1641517,1652719,1667791,1652090,15072,26274,11202,0,0,0
1672455,f5c683b3-50cd-67a5-ec4b-6aab7d4b9110,64,1639355,1661161,1672455,1654220,11294,33100,21806,0,0,0
1673438,0a6a1ef3-62b8-e3ee-93c0-3327ac6b71a4,64,1642021,1665699,1673438,1657197,7739,31417,23678,0,0,0
1674145,fdbe885c-a535-a77d-838f-eff5c38f3905,64,1642021,1659515,1674145,1653618,14630,32124,17494,0,0,0
1675088,3ec37e7a-75a2-d9d0-9ea0-2b254473b5e8,64,1616598,1656288,1675088,1653543,18800,58490,39690,0,0,0
1675449,b7eeb5fa-588e-5a83-fdc2-b1d624cf8e36,32,1642021,1665699,1675449,1656738,9750,33428,23678,0,0,0
1679290,a2b8183b-99c7-fd44-18bf-5990853c381b,64,1574447,1612821,1679290,1648754,66469,104843,38374,0,0,0
1679924,2d7de476-4a63-fb07-64bd-beded92042d1,64,1641518,1674145,1679924,1661261,5779,38406,32627,0,0,0
1679993,ade07438-b8f4-c5d1-d0d4-ba5fe43dde13,64,1642022,1665535,1679993,1656010,14458,37971,23513,0,0,0
1680508,e4bfaf39-125d-65fd-d731-d6ebf2352655,64,1642023,1672455,1680508,1660190,8053,38485,30432,0,0,0
1681436,95ca5e3f-1884-a76e-5804-53bce4d1b98f,64,1641516,1673438,1681436,1660868,7998,39920,31922,0,0,0
1682773,a179197f-fc4d-4a98-08fb-d8e7d7f31656,64,1642022,1675088,1682773,1661737,7685,40751,33066,0,0,0
1683861,ae98ac79-ba4e-c9ad-60be-a0d36fcc4bd6,64,1669720,1679993,1683861,1673606,3868,14141,10273,0,0,0
1684691,40a2cd25-a154-f9f1-ba1c-7eece6ee5146,64,1586623,1624115,1684691,1651624,60576,98068,37492,0,0,0
1685511,9ad2b94a-9e11-3a8d-888c-51905e983853,64,1641517,1679924,1685511,1662545,5587,43994,38407,0,0,0
1685511,90208366-74d7-5669-d11a-2e49ce7ac563,64,1669928,1680508,1685511,1676547,5003,15583,10580,0,0,0
1686872,052851d1-a3de-4368-2b46-7c82de3373c2,64,1642024,1679290,1686872,1662312,7582,44848,37266,0,0,0
1689264,2c70d3d9-d4d5-1e25-f0aa-7a9736936fd0,64,1669619,1681436,1689264,1679424,7828,19645,11817,0,0,0
1691847,3bc3a901-7eb2-6731-2fc6-6673fb261992,64,1691088,1691088,1691847,1692781,759,759,0,0,0,0
1694897,6595597b-cc9d-df76-f632-8f110a103bb2,64,1694290,1694290,1694897,1695553,607,607,0,0,0,0
1695122,ac15a3e2-b62e-491e-0f8c-8eefd34d2adc,64,1688849,1688849,1695122,1695119,6273,6273,0,0,0,0
1697134,a4ba7d64-a943-f88b-2f4a-761468a396fc,64,1689876,1689876,1697134,1699378,7258,7258,0,0,0,0
1698876,7ece0280-042f-d6f9-c638-1cb02dbfde84,64,1689425,1689425,1698876,1701734,9451,9451,0,0,0,0
1700366,46cb2917-626d-eafa-bd4d-75c0bbd4437b,64,1699446,1699446,1700366,1701457,920,920,0,0,0,0
1702236,673f940f-98c2-4bbb-2d74-2ac7ec7af8bb,64,1690983,1690983,1702236,1704884,11253,11253,0,0,0,0
1702422,eb8a5707-aaba-9548-10d2-596e027d35b4,64,1698755,1698755,1702422,1702679,3667,3667,0,0,0,0
1704309,56513a60-ea7e-628d-51a0-045414564931,64,1699944,1699944,1704309,1704438,4365,4365,0,0,0,0
1706205,8c56a176-732c-4627-5358-39793cf7816e,64,1705000,1705000,1706205,1706196,1205,1205,0,0,0,0
1706936,922e169b-dbb7-ffc5-9ff5-6dae1f46317d,64,1635325,1682773,1706936,1679880,24163,71611,47448,0,0,0
1708791,49255abc-2540-ca4a-e7b4-076a46001018,64,1668493,1683861,1708791,1706458,24930,40298,15368,0,0,0
1712777,367c876c-b3ed-b9b3-8f79-ae8ecc12069d,32,1672200,1683861,1712777,1697787,28916,40577,11661,0,0,0
1714486,592f8c40-c7df-f956-5649-97f4c1aba9ff,64,1577950,1667791,1714486,1657498,46695,136536,89841,0,0,0
1718068,916c84eb-369e-4297-3770-c481b94967e4,64,1711647,1711647,1718068,1716102,6421,6421,0,0,0,0
1718397,70a4d16c-9d82-db53-31ce-da2b483656fb,64,1702782,1702782,1718397,1713932,15615,15615,0,0,0,0
1718801,ed2b3a9e-fdd8-1d0f-b5dc-0c0ee3456fc9,64,1684906,1684906,1718801,1714211,33895,33895,0,0,0,0
1723173,b02eafe6-e8c1-7500-d956-81eb65807598,64,1687194,1687194,1723173,1708878,35979,35979,0,0,0,0
1739419,d3ac1bf7-711c-a44b-1f1e-08090a5c262a,32,1729642,1729642,1739419,1740821,9777,9777,0,0,0,0
1741306,226b8bd4-55ea-2cb9-63f9-20cbc5a4df44,64,1729642,1729642,1741306,1744839,11664,11664,0,0,0,0
1743993,f6361bed-5c4e-75a3-63a6-6609f2595fad,64,1729643,1729702,1743993,1741829,14291,14350,59,0,0,0
1744279,0d98f784-45ea-9cf4-348b-19f67bc3c47e,64,1729642,1729642,1744279,1741715,14637,14637,0,0,0,0
1744791,11092304-38df-5403-e471-efac59bce82b,64,1729792,1729792,1744791,1739528,14999,14999,0,0,0,0
1745813,9e253f6c-6749-fe74-a479-e642b25050f4,64,1706779,1706936,1745813,1744016,38877,39034,157,0,0,0
1747507,f5a2be71-eefc-bef2-c6e4-d726d09068a7,64,1729792,1729792,1747507,1741839,17715,17715,0,0,0,0
1753003,600494ff-2b1c-4594-ed34-d31fb8abbe50,64,1664763,1685511,1753003,1723117,67492,88240,20748,0,0,0
1755887,54db444a-4fc8-b678-142e-5ff5ec5c80a0,64,1754963,1754975,1755887,1757320,912,924,12,0,0,0
1756971,3058fa22-9634-13ba-a096-f194705620a7,64,1754855,1754855,1756971,1757632,2116,2116,0,0,0,0
1757993,5f35d9f3-5a5d-b202-ac65-0fe67c351c35,64,1754855,1754855,1757993,1757883,3138,3138,0,0,0,0
1758539,487fec63-10a2-a70d-8c9e-30dd7059fe6c,64,1754856,1756971,1758539,1759379,1568,3683,2115,0,0,0
1758976,1898fe69-e2ea-4d43-8e5a-aea32637fabc,64,1729792,1743993,1758976,1748948,14983,29184,14201,0,0,0
1759072,c0c371de-d548-e2dd-0d5a-5b542ab7751b,64,1729792,1741306,1759072,1746631,17766,29280,11514,0,0,0
1760139,9ebef109-efbd-9c98-f92b-d4481ada8914,64,1757870,1758539,1760139,1760015,1600,2269,669,0,0,0
1760815,d305c1ae-82ca-e121-2026-da8b9fbd994a,64,1729643,1729702,1760815,1750999,31113,31172,59,0,0,0
1761921,a6a50ff4-6b88-3397-0582-2f752d8b6108,64,1729792,1744279,1761921,1749387,17642,32129,14487,0,0,0
1762146,8ab1ad93-0ea8-9557-0d96-39c9e1108410,64,1754337,1754337,1762146,1759690,7809,7809,0,0,0,0
1762146,cd32ef88-edc7-07ed-0282-786c56a9a696,64,1757869,1759072,1762146,1760482,3074,4277,1203,0,0,0
1762558,33daf705-6243-049e-1e84-1a61d599eb52,64,1754856,1758976,1762506,1760223,3530,7650,4120,0,0,0
1762981,046188b2-5636-4e16-5f36-749acc02e629,64,1757869,1760815,1762981,1761305,2166,5112,2946,0,0,0
1764065,fd32c920-b89a-45d4-ff5d-3e07036dda75,64,1757869,1762558,1764065,1763360,1507,6196,4689,0,0,0
1764396,10aaeeb1-f367-f96a-fa0f-d3f876f831de,64,1762438,1762981,1764396,1763474,1415,1958,543,0,0,0
1764572,02d48550-a8b0-6a78-7122-1afc068ad35b,64,1754855,1760139,1764572,1760623,4433,9717,5284,0,0,0
1764702,f05a1757-c2a2-60b4-90cd-7a7c457364a6,64,1757869,1762146,1764702,1762533,2556,6833,4277,0,0,0
1765553,4d56af40-6af4-30b3-24e8-1d8321918ba0,64,1762439,1764572,1765553,1764404,981,3114,2133,0,0,0
1766309,d400f82d-31d6-26fd-d7bd-19a200418183,64,1762440,1764702,1766309,1764838,1607,3869,2262,0,0,0
1766369,3a3ddbdf-50da-6274-7384-5caa6ef88033,64,1762439,1764396,1766360,1764128,1964,3921,1957,0,0,0
1767540,80ab90b8-3f02-380d-2e34-9d8d31f1b6ec,64,1762439,1765553,1767540,1764932,1987,5101,3114,0,0,0
1767600,87876acd-a2d5-9a85-d85a-e11fe6d97788,64,1671192,1684691,1767577,1718906,82886,96385,13499,0,0,0
1775796,9f1a7077-f82c-cd42-a9ef-531905572a24,64,1759183,1766309,1775796,1767232,9487,16613,7126,0,0,0
1776681,f0f95657-3162-c152-aecb-87443ac410cc,64,1758557,1766369,1776681,1768500,10312,18124,7812,0,0,0
1781049,d735ca2a-52dc-036d-a2cc-ca3e3f2f1a1c,64,1771078,1775796,1781049,1775658,5253,9971,4718,0,0,0
1781822,94b352dc-2dfb-196c-7fae-f1da66c080cf,32,1733554,1747507,1781822,1759460,34315,48268,13953,0,0,0
1784925,74a3950d-7070-4351-677d-cb35b19e2107,64,1775099,1776681,1784925,1779285,8244,9826,1582,0,0,0
1788495,ac8ade90-bdba-6a7b-bac1-4b64f87a4e5d,64,1733553,1764065,1788495,1763562,24430,54942,30512,0,0,0
1788966,f0b2d9c0-1ced-73dd-ac42-df3eb375d09b,64,1771078,1781822,1788966,1780375,7144,17888,10744,0,0,0
1792535,8636ed97-7036-2e95-980f-1808f8b4b8c8,64,1711647,1714486,1792535,1779947,78049,80888,2839,0,0,0
1792595,e1fb2a96-30a7-cf20-0006-944818d05bc5,64,1771080,1788966,1792548,1781640,3582,21468,17886,0,0,0
1797448,3a351908-8e37-f7b9-596e-718890e6c3ed,64,1733553,1745813,1797448,1757768,51635,63895,12260,0,0,0
1797698,b0dc36ab-6f5c-b81e-d059-4dbe1d2d227d,32,1704673,1708791,1797698,1761489,88907,93025,4118,0,0,0
1798985,60e5736d-fb6b-5d6d-9528-d18c3f5fb9e7,64,1733812,1767600,1798985,1772996,31385,65173,33788,0,0,0
1803347,b160db28-5a46-389d-6947-22266eb72bb2,64,1771078,1792595,1803347,1786934,10752,32269,21517,0,0,0
1803434,720c5e44-a894-dccd-2663-196522da0119,64,1733811,1753003,1803434,1762395,50431,69623,19192,0,0,0
1804655,dd2a62a7-f61c-6fe9-32ec-81aaf42b0176,64,1781099,1798985,1804655,1791685,5670,23556,17886,0,0,0
1805457,a3d2b101-6ebe-0406-721c-7f99d9bb17b5,64,1775008,1792535,1805457,1786469,12922,30449,17527,0,0,0
1806227,5147f81c-c6cc-60a3-bda8-958a5f6a2847,64,1733811,1784925,1806227,1781229,21302,72416,51114,0,0,0
1808029,1501dbbc-ca10-4019-1abb-29dcccb5dd3d,32,1791737,1806227,1808029,1795499,1802,16292,14490,0,0,0
1809542,021e8345-8ec6-7684-3f0c-7e4a7c2a29d4,64,1733813,1767540,1809542,1771559,42002,75729,33727,0,0,0
1811060,d5b21bf1-c66a-87d0-e6cb-674e43a71e40,64,1781106,1803434,1811060,1793156,7626,29954,22328,0,0,0
1811745,3906a2a9-63e3-c17a-5e6c-5cebd69472d5,64,1791737,1809542,1811745,1795823,2203,20008,17805,0,0,0
1812177,6faa2983-2622-7180-82b9-9c7be41eb440,64,1791736,1808029,1812177,1795616,4148,20441,16293,0,0,0
1813477,3143bd0e-52b8-dc8e-4923-656ae2fd3de4,64,1781098,1805457,1813477,1795112,8020,32379,24359,0,0,0
1814640,561957fd-530d-2537-f1c5-020223afa774,64,1733813,1788495,1814640,1781293,26145,80827,54682,0,0,0
1814953,806f20d0-3e6b-65de-9702-929dc3608cc6,32,1794777,1812177,1814953,1799206,2776,20176,17400,0,0,0
1817128,cd7c207e-3de2-befd-eae3-0f4b86854b28,64,1796647,1814640,1817128,1802302,2488,20481,17993,0,0,0
1817600,26344a66-7a96-98c2-eea5-98f9495bfb6f,32,1771078,1804655,1817600,1793737,12945,46522,33577,0,0,0
1820232,a8caef85-7bd7-f5b0-0c4a-47492c6cb095,64,1791737,1813477,1820232,1799985,6755,28495,21740,0,0,0
1822890,3bb77cfa-c36f-d9c4-e176-a48353cc8405,64,1781097,1814953,1822890,1802676,7937,41793,33856,0,0,0
1826980,86bfacc7-5df4-6dd5-b0c5-34b4b37dea2c,64,1781097,1811745,1826980,1796966,15235,45883,30648,0,0,0
1827511,35c5609c-e0ac-292e-4252-e73e54bfa7a4,64,1803021,1822890,1827511,1808289,4621,24490,19869,0,0,0
1831743,2a41c15c-de72-3b9b-b64c-30c7abb24a6a,64,1771077,1811060,1831743,1796165,20683,60666,39983,0,0,0
1833322,8e0fe8d7-4dde-bfec-1889-e2112ec37446,64,1733563,1803347,1833322,1792021,29975,99759,69784,0,0,0
1839938,ff928ac3-3a90-db29-70f0-c832487b3bfc,64,1791769,1820232,1839938,1804421,19706,48169,28463,0,0,0
1844226,6aab28db-1e42-9668-a0f4-24117836fdba,64,1780067,1817128,1844226,1803182,27098,64159,37061,0,0,0
1844945,246f9528-66cc-52f1-cb49-7e6e980b1b50,64,1733564,1804655,1844945,1794437,40290,111381,71091,0,0,0
1845144,39094dc6-bc10-1e62-8eec-c2cbb8355ffe,64,1791737,1827511,1845144,1812945,17633,53407,35774,0,0,0
1846212,2d5488de-a3fc-c4cb-0ce9-d23d0ce0ddd2,32,1791294,1827511,1846212,1812674,18701,54918,36217,0,0,0
1848143,170dfdf1-6335-c6b7-6ba4-5237fd9fc808,64,1791365,1826980,1848143,1810777,21163,56778,35615,0,0,0
1849062,6beb0aa5-2824-0bca-cd25-c551f0151972,64,1791367,1831743,1849062,1813591,17319,57695,40376,0,0,0
1856744,ddc8b5c2-d7b4-eea5-0b1f-d61dc2c1da39,64,1705673,1718068,1856744,1787893,138676,151071,12395,0,0,0
1862042,6f06ed50-216f-3715-d65c-1a0a0962cc56,64,1759234,1839938,1862042,1816500,22104,102808,80704,0,0,0
1866048,adca248c-d705-2665-34f8-6bdd74a1847f,64,1791367,1833322,1866048,1813878,32726,74681,41955,0,0,0
1868354,6ef1cb21-d1bd-203d-28b3-9bb7a04949ab,64,1791294,1844226,1868354,1817389,24128,77060,52932,0,0,0
1872427,224c42b2-6d0f-3b33-1a45-46a2190e5195,64,1791294,1848143,1872427,1823762,24284,81133,56849,0,0,0
1873140,4268cfa7-6f9d-5564-669e-febb7c3a2e25,64,1791294,1845144,1873140,1819187,27996,81846,53850,0,0,0
1875809,4c1cbb45-b06e-bc9c-55e0-d06bed2ac32b,64,1783770,1844945,1875809,1817792,30864,92039,61175,0,0,0
1877154,ecef10fb-ea67-3147-af51-9026a6fa2813,64,1822976,1866048,1877154,1828518,11106,54178,43072,0,0,0
1878208,6b12121a-8be1-4d07-3acb-981fa734db7b,64,1835331,1873140,1878208,1837976,5068,42877,37809,0,0,0
1878981,d9896731-cbea-7cc9-08c2-1b997a105b0d,32,1839481,1878208,1878981,1840111,773,39500,38727,0,0,0
1880013,0ffa787b-e9d2-b271-c222-563d90f1edf8,32,1835330,1877154,1880013,1838638,2859,44683,41824,0,0,0
1881166,c42ca275-d0a8-1cef-2530-4f467c7b789a,64,1835330,1875809,1881166,1838632,5357,45836,40479,0,0,0
1881949,54ff7e4c-c2df-af6f-91bd-c21c9fff13d1,64,1791294,1849062,1881949,1824318,32887,90655,57768,0,0,0
1882387,ad4574d4-8b07-d558-3302-280b891a9bcd,64,1839675,1881166,1882387,1841215,1221,42712,41491,0,0,0
1883121,67931ab9-ac49-aa53-b9df-99ca495bb9b3,64,1835331,1878981,1883121,1840540,4140,47790,43650,0,0,0
1883201,6f32c404-172f-9c04-3def-8dcf0b191009,64,1839706,1881949,1883201,1841343,1252,43495,42243,0,0,0
1884669,d6d9ff96-5a1c-47d4-e90f-97c071df3f59,64,1839300,1882387,1884669,1845385,2282,45369,43087,0,0,0
1885396,f258fad7-1c2a-7b24-651b-c6e428654259,64,1791368,1868354,1885396,1829098,17042,94028,76986,0,0,0
1889379,ee47ba00-56dd-14df-3d4a-bc3cb908e8e1,64,1822975,1877154,1889379,1838902,12225,66404,54179,0,0,0
1890913,9c887de3-055a-d48f-3558-91c3d172611b,64,1791367,1856744,1890913,1824678,34169,99546,65377,0,0,0
1894551,fc261a31-5691-1e98-800b-137f8a9cf5cc,64,1850565,1889379,1894551,1859418,5172,43986,38814,0,0,0
1898765,7a941d6c-de18-984d-d232-e1131b692f30,64,1860800,1894551,1898765,1863387,4214,37965,33751,0,0,0
1899925,458d5042-4961-0a59-d54a-f5d7d79b71a5,64,1849586,1884669,1899925,1856708,15256,50339,35083,0,0,0
1902514,9bf5097c-8668-db07-2dc0-c33c95c9f1fe,64,1860799,1898765,1902514,1864016,3749,41715,37966,0,0,0
1903809,4c39b06e-8b5f-d4e5-3122-359a39aeada8,64,1860799,1899925,1903809,1864022,3884,43010,39126,0,0,0
1904319,140234a1-f9ed-7f8b-e08d-b89f6174972f,64,1849589,1890913,1904319,1860452,13406,54730,41324,0,0,0
1907824,0a70e53c-a03f-6417-f6f4-af9b7e0a7c12,64,1860801,1903809,1907824,1866178,4015,47023,43008,0,0,0
1908588,0aa2d334-cd55-740c-77af-d188653107e3,64,1860800,1904319,1908588,1866258,4269,47788,43519,0,0,0
1909765,3f7f42da-adae-e6fc-1f07-72fe22dc7727,64,1857589,1902514,1909765,1865715,7251,52176,44925,0,0,0
1912644,9039a6ce-fbdc-b2c8-b7d4-3146370359d5,64,1861752,1908588,1912644,1867768,4056,50892,46836,0,0,0
1913755,6a3e1ac5-5cf5-88b3-4ca5-73f96c9f5188,64,1872999,1912644,1913755,1874363,1111,40756,39645,0,0,0
1914192,4aade55d-85db-b9a9-4179-f7b35b33cd2b,64,1871702,1909765,1914192,1874055,4427,42490,38063,0,0,0
1914724,eba0ce6b-0c7b-5f76-3365-cc2030dcf8c7,64,1874525,1913755,1914724,1875369,969,40199,39230,0,0,0
1915897,79575cf5-99af-a0f9-a26b-11999e6156a1,64,1874717,1914724,1915897,1875997,1173,41180,40007,0,0,0
1917039,06b8f092-8515-985f-e884-aa8353891467,64,1874638,1915897,1917039,1876429,1142,42401,41259,0,0,0
1920215,d3705ef8-2666-f8d1-f3c9-97dbc400ba3c,32,1876914,1917039,1920215,1880154,3176,43301,40125,0,0,0
1920734,c9a03f87-ed54-8edb-29c0-4900c1fcc794,64,1789263,1862042,1920734,1827207,58692,131471,72779,0,0,0
1921485,dffe5691-cd41-9e43-81d8-f990ce1c4c84,64,1782588,1883201,1921485,1851841,38284,138897,100613,0,0,0
1922466,1dd2879d-ea67-8e49-d312-ce4bf78b90b1,64,1856409,1914192,1922466,1875393,8274,66057,57783,0,0,0
1923246,4e5b2424-385c-9e81-8aca-c467ecba5167,64,1885006,1922466,1923246,1885735,780,38240,37460,0,0,0
1924010,6d27cda9-34a0-7a6e-8f7f-2b7e7e9cbd14,64,1884989,1923246,1924010,1886338,764,39021,38257,0,0,0
1924237,7d8b85f7-43ea-d37b-cb22-dd328a360253,64,1789262,1872427,1924237,1837430,51810,134975,83165,0,0,0
1924615,61f3be26-8fc7-f55c-5041-db802e2aee73,64,1885007,1924010,1924615,1886379,605,39608,39003,0,0,0
1925093,ce477169-c84b-e083-face-a57b086d6fbb,64,1857589,1907824,1925093,1866810,17269,67504,50235,0,0,0
1925536,3dd0d038-da97-8786-9255-e9022a689142,64,1885003,1924237,1925536,1886821,1299,40533,39234,0,0,0
1927139,ee75c353-f122-25d3-2ed4-889b9309794d,64,1885005,1925093,1927139,1888693,2046,42134,40088,0,0,0
1927432,dd6d9196-a728-4889-eea6-40134b15964d,32,1885004,1924615,1927432,1887215,2817,42428,39611,0,0,0
1929319,ce9102f2-ee98-0ecf-536b-00cd6fe3b95a,64,1884993,1924615,1929319,1888469,4704,44326,39622,0,0,0
1931062,54b69482-f903-81e5-fa86-80ddae6773af,64,1872065,1921485,1931062,1883431,9577,58997,49420,0,0,0
1932575,2f11f76f-e88c-1fc4-b7c1-3c6589bb80f7,64,1885008,1927139,1932575,1890278,5436,47567,42131,0,0,0
1933123,6a63c6a9-3b6d-4b6e-0668-bd6b624307a2,64,1789273,1883121,1933123,1851683,50002,143850,93848,0,0,0
1934336,48eec5a8-da79-15de-9200-e1eab2657984,64,1789262,1885396,1934336,1856849,48940,145074,96134,0,0,0
1934774,d1125d59-57bd-a882-f363-19e2a06f3903,64,1857591,1925536,1934774,1889112,9238,77183,67945,0,0,0
1937779,969b62c2-e903-6f51-d4d5-0e9d8ae392cd,64,1860800,1917039,1937779,1880369,20740,76979,56239,0,0,0
1939861,d3ad13e4-ffdf-194d-d9ee-454e1533a36b,64,1860800,1920734,1939861,1881718,19127,79061,59934,0,0,0
1944707,238d09b2-a970-e556-d260-62cd314bbef8,64,1884994,1931062,1944707,1892663,13645,59713,46068,0,0,0
1946098,3f7c5f19-f318-6370-7fe5-8ce6886fdebc,64,1876758,1932575,1946098,1893712,13523,69340,55817,0,0,0
1947568,1d83f40b-e42b-97b5-792d-35d4cd70ed21,64,1885000,1934774,1947568,1898101,12794,62568,49774,0,0,0
1953562,5214c4d0-95ac-64cc-9f35-b111f551de2b,64,1885013,1946098,1953562,1902463,7464,68549,61085,0,0,0
1953884,0d2a26b2-79d8-6d23-4fe4-5ad21122439d,64,1884995,1944707,1953884,1901527,9177,68889,59712,0,0,0
1954049,9741389c-13a2-2651-9012-4c6aaf50eb84,64,1885002,1937779,1954049,1898591,16270,69047,52777,0,0,0
1956578,40e8f94d-5157-52ad-0f77-bbb60fe506a7,64,1884990,1934336,1956578,1897571,22242,71588,49346,0,0,0
1957161,11538be1-50ea-a4be-1e19-fd8528a56ddc,64,1885011,1933123,1957161,1896863,24038,72150,48112,0,0,0
1964218,2163d059-a9b4-9c8d-4f00-8b221dbb86c8,64,1884988,1953562,1964218,1908341,10656,79230,68574,0,0,0
1967196,72d13031-fd1d-f5a4-c905-ef90998a75dd,64,1884988,1947568,1967196,1907189,19628,82208,62580,0,0,0
1967256,e869d312-8bb7-85da-1c97-19143e60242b,64,1885003,1957161,1967230,1912265,10069,82227,72158,0,0,0
1969179,9dbf9e57-a3cc-e8b4-326c-f0652ca2ad11,64,1885016,1954049,1969179,1910520,15130,84163,69033,0,0,0
1969508,0ae5f9ad-d193-ef51-09fc-5c3ef60ef290,64,1857590,1939861,1969508,1901359,29647,111918,82271,0,0,0
1970623,66d29dd4-6fc9-70f1-b2c7-59b9ea0659c6,32,1943813,1969508,1970623,1944563,1115,26810,25695,0,0,0
1971875,342686c6-0690-cc65-d633-17eccc946300,64,1885736,1969179,1971875,1938838,2696,86139,83443,0,0,0
1971993,a71bf1bd-3bb5-e21d-0d87-bf1e0ccfed6e,64,1944459,1970623,1971993,1946364,1370,27534,26164,0,0,0
1974515,2b8a6340-dbdc-d38c-0581-f43ae7b30057,32,1947114,1971993,1974515,1949297,2522,27401,24879,0,0,0
1975967,ae990cf9-debe-f30e-c7a2-3fd9772e6680,32,1947763,1974515,1975967,1949853,1452,28204,26752,0,0,0
1976485,2f01bb8e-4890-f6a4-0852-19c8400c0fa7,32,1952149,1975967,1976485,1952753,518,24336,23818,0,0,0
1976556,e1677795-64f9-56ba-c041-3b0c82ee00c4,64,1885016,1953884,1976556,1910327,22672,91540,68868,0,0,0
1977102,a026d7b9-a5cc-7276-2548-debef3ca8d97,32,1952149,1976485,1977102,1952833,617,24953,24336,0,0,0
1977550,51dadd61-33d7-a9ac-317f-d7b8d00206a3,32,1952149,1977102,1977550,1953266,448,25401,24953,0,0,0
1977610,4d741278-a84b-69d7-858e-54ad39cc53a0,64,1952149,1976556,1977565,1952957,1009,25416,24407,0,0,0
1978348,9b0c4940-a88f-6c8b-78b7-35c78a7c1384,64,1952149,1977550,1978348,1953348,798,26199,25401,0,0,0
1979261,bea195e3-d6e5-a9cd-9d45-05e4be9961b0,32,1951588,1977610,1979261,1954443,1651,27673,26022,0,0,0
1980520,7bd7bbd2-22e5-8336-f164-28eeadf7e749,64,1885000,1956578,1980520,1911960,23942,95520,71578,0,0,0
1980580,eee23864-5195-395f-14d0-82318e944685,64,1953666,1979261,1980534,1955165,1273,26868,25595,0,0,0
1983086,f98e5faa-7129-028d-abe1-f0d8ec582762,64,1950921,1978348,1983086,1954945,4738,32165,27427,0,0,0
1983305,970e8338-82ca-d196-beb3-53a14394d833,32,1884989,1967256,1983305,1917986,16049,98316,82267,0,0,0
1983743,5012e1f0-d9d0-71d2-fa0b-d4b4b0136945,64,1950361,1980520,1983743,1958450,3223,33382,30159,0,0,0
1984110,a470c293-50bf-179c-6e4a-e46abe4f9916,64,1880795,1967256,1984110,1918988,16854,103315,86461,0,0,0
1986868,555c9462-1a78-e2d7-c8c4-1fae53fe9e4e,64,1884988,1967196,1986868,1913460,19672,101880,82208,0,0,0
2012380,54dd56b3-eecf-a6d1-c3dd-50f6c7014f62,64,2001974,2001974,2012380,2016993,10406,10406,0,0,0,0
2014809,7ed17acd-c855-7e96-6ba8-d736a329a76f,64,1701774,1718397,2014809,1892579,296412,313035,16623,0,0,0
2023434,02a996e0-845f-88ac-f264-d70a6e93aa6f,64,1853623,1964218,2023434,1913397,59216,169811,110595,0,0,0
2030540,6ad733bb-9eb0-7517-1d0d-d78aedb037ba,64,2010008,2010067,2030540,2043328,20473,20532,59,0,0,0
2044857,0595138b-6e7b-0b3e-a4dc-f755626d3576,64,1859619,1971875,2044857,1946936,72982,185238,112256,0,0,0
2049197,91a92d1c-24c2-b86a-0182-d5e41a146704,64,2010015,2014809,2049197,2052906,34388,39182,4794,0,0,0
2049458,45cd4a2f-20ff-56b1-2ef7-ceccf5d4745b,64,2010012,2030540,2049458,2062854,18918,39446,20528,0,0,0
2053031,653d3fcb-5db5-c3f6-3b78-456939fc62ee,64,2010014,2012380,2053031,2048992,40651,43017,2366,0,0,0
2053704,6f8774d6-2977-6d3f-fa83-6458fed14a2d,64,2010007,2010007,2053704,2056733,43697,43697,0,0,0,0
2056265,d22ad770-9285-6268-25fe-d72cffab4b56,64,2010008,2010067,2056265,2045500,46198,46257,59,0,0,0
2069664,5d6cc085-9293-b9ee-78c9-4a85af6ca0bd,64,2010013,2053031,2069664,2076548,16633,59651,43018,0,0,0
2071377,8de1470b-51ce-05f1-d1b5-6c9a2409bf27,64,1704597,1718801,2071377,1968148,352576,366780,14204,0,0,0
2091406,446f41f0-84b2-6961-776c-65cd34941ef8,64,2010007,2049197,2091406,2068758,42209,81399,39190,0,0,0
2093304,2b2165a7-d4f5-3d8e-8d93-8aad8bdc6241,64,2010008,2053704,2093304,2078310,39600,83296,43696,0,0,0
2095810,24c5e9ab-2db8-074b-679d-071d6e58947b,64,2010009,2049458,2095810,2069736,46352,85801,39449,0,0,0
2096640,c818ab72-aea3-1181-37a9-9592d67a6b6f,64,1951372,1983086,2096640,2042941,113554,145268,31714,0,0,0
2097303,bca3288d-7fef-5649-11b7-71744a29afad,64,2079451,2079451,2097303,2097869,17852,17852,0,0,0,0
2097860,4596a56a-b6ec-49de-7a12-74b923546c81,64,2093460,2093519,2097860,2096188,4341,4400,59,0,0,0
2098027,0450f4c2-5777-3094-a9e6-bcd581f0571e,64,2093566,2093579,2098027,2096854,4448,4461,13,0,0,0
2098392,f92727db-9028-30f2-ab16-fd8fb0897025,64,2093460,2093519,2098392,2097993,4873,4932,59,0,0,0
2098506,6b444e2e-e469-ee4e-d63e-a949d603ed0b,64,2093460,2093519,2098506,2096723,4987,5046,59,0,0,0
2098898,984d6ce6-cffc-52ab-64c6-67e7f6d645c5,64,2093459,2093459,2098898,2098481,5439,5439,0,0,0,0
2098958,d1b94526-22ef-faa3-e3b0-d2a9f402cacd,64,2093565,2097303,2098936,2099142,1633,5371,3738,0,0,0
2100266,2f538aae-bebb-3961-6ac2-4c11f5e5b7a2,64,2093566,2098027,2100266,2099281,2239,6700,4461,0,0,0
2101555,ca43d8ca-7197-7153-4074-51d33b36fda8,64,2093461,2096640,2101555,2099088,4915,8094,3179,0,0,0
2101615,4694605f-48ef-6305-5dc3-e10188d48e51,64,2093566,2098506,2101556,2099603,3050,7990,4940,0,0,0
2102074,6f11b5b2-09c6-f153-9cc7-8704f3e5be52,64,2079452,2079511,2102074,2105493,22563,22622,59,0,0,0
2102134,1651b50b-2448-5b05-a09b-7e46f7cbc0b4,64,2093460,2097860,2102105,2099223,4245,8645,4400,0,0,0
2103107,f8bedffd-9f5a-d5a6-9fe8-afc70438e676,64,2093565,2098392,2103107,2099328,4715,9542,4827,0,0,0
2106114,8e3de159-73fe-f59b-b35e-7337c67542b6,64,2100156,2100156,2106114,2105272,5958,5958,0,0,0,0
2107816,a8be954f-dce6-293e-e8c7-bdd7adabe067,64,2094481,2102074,2107816,2110223,5742,13335,7593,0,0,0
2112196,48ba840b-53ef-dad2-3372-2b2865ba309a,64,2079708,2079708,2112196,2106457,32488,32488,0,0,0,0
2113032,949c9e1a-bee6-32f3-f80a-9cdee198deed,64,2099333,2099333,2113032,2106275,13699,13699,0,0,0,0
2113109,abbcad01-f4a5-02d1-f971-da3b17130cc4,64,2079751,2103107,2113109,2115664,10002,33358,23356,0,0,0
2127557,e0bd6573-8fbc-ea4d-887c-a18f19f36dd5,64,2079452,2079511,2127557,2110073,48046,48105,59,0,0,0
2132351,cfde1ff8-6212-8152-9d96-36c7d582b38d,64,2089424,2093304,2132351,2113547,39047,42927,3880,0,0,0
2134938,d26e045e-657c-b9fe-5931-3d4d142ed4c5,32,2079593,2112196,2134938,2124036,22742,55345,32603,0,0,0
2135627,18ddd0ec-3161-0d58-7580-2785bab619b7,32,2089417,2113109,2135627,2138586,22518,46210,23692,0,0,0
2142401,691772b7-58aa-73f2-0e88-84cdd2c1911b,64,2079452,2106114,2142401,2116775,36287,62949,26662,0,0,0
2146395,08ac88fd-ad39-dcc2-5449-cc2e1d4f3938,64,2079451,2079451,2146395,2117957,66944,66944,0,0,0,0
2146888,21db6de0-13ce-9b17-735f-11e9b3d620b8,64,2124618,2132351,2146888,2145092,14537,22270,7733,0,0,0
2147927,09bc46ae-7d30-b51c-c351-714ece48294e,64,2089417,2112196,2147927,2124375,35731,58510,22779,0,0,0
2150099,c5d3c0d7-9e77-4063-98b4-1588501801cc,64,2148483,2148542,2150099,2151049,1557,1616,59,0,0,0
2150731,5ebb6735-4096-2535-fba6-666c245b8b37,64,2146059,2146059,2150731,2149128,4672,4672,0,0,0,0
2150799,a1220d0f-1690-f830-6b5b-29a8ef848004,64,2148484,2148542,2150799,2151423,2257,2315,58,0,0,0
2153004,48280c5f-bbd3-b56a-e2fc-ec9fe892cb44,64,2148483,2150731,2153004,2153287,2273,4521,2248,0,0,0
2153508,26bbfb66-17f7-70f0-49dc-757e1d78c7c7,64,2148483,2148542,2153508,2150867,4966,5025,59,0,0,0
2153588,cec308ac-8980-3c04-5737-d05e0d42b0f6,32,2148482,2148482,2153588,2153578,5106,5106,0,0,0,0
2154361,94dd71ed-1d73-6c6d-e230-b9df4359c3bf,64,2148483,2150099,2154361,2152441,4262,5878,1616,0,0,0
2154462,cdafbd48-3d6d-194f-d1e9-53c8cc10d7f1,64,2148482,2148482,2154462,2153756,5980,5980,0,0,0,0
2157112,628c4362-8656-2106-5f6c-66ea1b2104af,64,2148482,2148482,2157112,2154202,8630,8630,0,0,0,0
2158537,05bb6080-bdb2-4e71-0a9f-53ab4e4592ea,64,2148485,2154361,2158537,2154465,4176,10052,5876,0,0,0
2158603,40864941-eed4-6d81-af1d-de8b758f8e50,64,2124618,2127557,2158603,2144092,31046,33985,2939,0,0,0
2161330,dd839d94-bc11-fe6d-8657-52d85849b91a,64,2148483,2157112,2161330,2154597,4218,12847,8629,0,0,0
2166138,fb14a814-4ab4-64c3-b55e-85b308c6614c,64,2124618,2134938,2166138,2146747,31200,41520,10320,0,0,0
2168049,8753ce2e-c6dc-9cbe-d031-41a249abf564,64,2124618,2146888,2168049,2154474,21161,43431,22270,0,0,0
2173716,f984aa7d-e896-5288-dd70-0abb1b6b71b8,64,2094917,2161330,2173716,2179822,12386,78799,66413,0,0,0
2173964,cd6a227b-6855-022d-8a35-c6b2f6311f57,64,2089417,2142401,2173964,2154043,31563,84547,52984,0,0,0
2176944,5caba07f-a823-ae8f-048a-7b42134f1a1e,64,2089424,2147927,2176944,2156003,29017,87520,58503,0,0,0
2186540,ac908d2f-966c-b6f7-1892-a5dded7d7aaf,64,2124618,2158603,2186540,2161950,27937,61922,33985,0,0,0
2188300,e34535a4-bb64-287b-9034-4090b322ba91,64,2186912,2186912,2188300,2188991,1388,1388,0,0,0,0
2188360,7fb7f269-19ad-6aa3-601e-df98548fac8c,64,2089417,2113032,2188343,2133017,75311,98926,23615,0,0,0
2188420,d549aab0-6a20-7a17-737f-43e8870a3a33,64,2186913,2186972,2188407,2189217,1435,1494,59,0,0,0
2189632,091cabe5-f9d9-1cb2-7948-9a7ee67b476a,64,2186913,2186972,2189632,2189510,2660,2719,59,0,0,0
2190108,b7426edd-f8bd-eac6-5fed-7221ebcd63b3,64,2186913,2188300,2190108,2189745,1808,3195,1387,0,0,0
2190589,61d19b52-e19e-817b-c0d2-3e9dcf4d2143,64,2186149,2186208,2190589,2190447,4381,4440,59,0,0,0
2191506,8a83f25a-311c-20d6-bcea-4b9b21e171c8,64,2186148,2186148,2191506,2189696,5358,5358,0,0,0,0
2191727,1f2c6a70-95dd-e9fd-1592-24d03b806ef1,64,2186912,2186912,2191727,2192249,4815,4815,0,0,0,0
2191835,d0cb172e-c5e7-3f91-c246-34e59b900ed0,64,2186149,2186540,2191835,2193255,5295,5686,391,0,0,0
2193537,914073d8-447b-68d0-5978-941f92b0c4c7,64,2186148,2186148,2193537,2193033,7389,7389,0,0,0,0
2194372,8db52395-3431-0812-bb05-35b8f62e6476,64,2193801,2193860,2194372,2202260,512,571,59,0,0,0
2194618,cc2dd3c5-cd2d-1f3e-f4eb-645b7ddb0c24,64,2193800,2193800,2194618,2199829,818,818,0,0,0,0
2195286,01afbbb1-d5ee-9464-3250-49e0ccc3277c,64,2193801,2194372,2195286,2203624,914,1485,571,0,0,0
2195478,6a8a2a4a-5d2c-0ba0-d196-7559eb9b21a1,64,2193802,2193860,2195478,2201695,1618,1676,58,0,0,0
2196924,f8aa86db-9935-759f-9b11-0ca207c3f441,64,2186149,2190589,2196924,2193729,6335,10775,4440,0,0,0
2197280,889a3a96-7056-fe37-7155-19e368527344,64,2193800,2193800,2197280,2200825,3480,3480,0,0,0,0
2202836,93c10f37-d052-1ecd-c23a-4034c6071229,64,2181905,2181905,2202836,2206416,20931,20931,0,0,0,0
2206314,28c37c5e-dd08-b84d-e66b-2b38ed0391cd,64,2203544,2203544,2206314,2205887,2770,2770,0,0,0,0
2210277,db2d62ea-efbb-6956-678f-1fec24ae0c1d,64,2207188,2207188,2210277,2209579,3089,3089,0,0,0,0
2212810,8a12d261-0d2f-64a9-32fd-26cfd37410c5,64,2211201,2211201,2212810,2213779,1609,1609,0,0,0,0
2213217,ae37674f-c898-fff5-132d-0a5a3653856e,32,2183011,2183011,2213217,2216923,30206,30206,0,0,0,0
2215501,d961adc3-10a7-16cd-a843-35cdfd86f705,64,2212363,2212363,2215501,2214071,3138,3138,0,0,0,0
2216220,4dfb95bb-3573-ec42-e5e8-6a7a93f825c2,64,2215035,2215035,2216220,2217441,1185,1185,0,0,0,0
2218377,aa58feda-b960-cb74-e32f-be6b7dd2ab19,64,2183734,2193537,2218377,2235482,24840,34643,9803,0,0,0
2222761,bc17aedb-39a2-4058-e881-e2c8959c8a7c,64,2219824,2219824,2222761,2222086,2937,2937,0,0,0,0
2225456,c14b09d4-f67b-2b50-7753-c4eeff19c621,64,2222368,2222426,2225456,2226036,3030,3088,58,0,0,0
2226981,c4afee94-8558-c0e2-816b-122ddc952f82,64,2222366,2222366,2226981,2225518,4615,4615,0,0,0,0
2227116,67f106e7-8881-d87e-8eff-82eb431b1d4f,64,2222366,2222366,2227116,2228699,4750,4750,0,0,0,0
2227339,0eeff43e-1241-e40a-763e-290ee92ca0df,64,2222367,2222761,2227339,2226528,4578,4972,394,0,0,0
2228199,c68b6e64-7b49-d369-dced-012ee380efea,64,2089417,2168049,2228199,2183062,60150,138782,78632,0,0,0
2228756,c5589cc7-b144-417d-3275-9085b04e9f00,64,2222366,2226981,2228756,2229094,1775,6390,4615,0,0,0
2231646,caf959aa-bb18-5d4a-156f-3a5db2060fb1,64,2222366,2227116,2231646,2229144,4530,9280,4750,0,0,0
2234032,acf647e5-8d39-83b5-e67e-5ed37fbc8b9d,64,2223774,2228199,2234032,2233730,5833,10258,4425,0,0,0
2235238,e92ab319-5bff-8c46-4963-45cd1f302f02,64,2223589,2227339,2235238,2231922,7899,11649,3750,0,0,0
2237011,652fa661-f6b3-8c33-2c56-c894cd8fa84f,64,2231388,2234032,2237011,2235271,2979,5623,2644,0,0,0
2237530,00772049-4130-50cf-6855-43f5303ac1e0,64,2223774,2231646,2237530,2234849,5884,13756,7872,0,0,0
2238083,8eabe1fd-945f-3ce4-bcee-abed0702bff2,64,2233705,2237011,2238083,2237480,1072,4378,3306,0,0,0
2242908,ab4f2c5b-d193-21f1-be06-36e3e3e94379,64,2223774,2228756,2242908,2233860,14152,19134,4982,0,0,0
2243117,e4a4a490-108a-dc52-45e0-c76ca547232d,64,2223773,2238083,2243117,2238912,5034,19344,14310,0,0,0
2245232,60c7e78f-74c5-f38f-95f2-2749b0d69cd2,64,2092769,2173716,2245232,2209949,71516,152463,80947,0,0,0
2247438,6b267371-5b26-e5b8-230d-56d15d274d4f,64,2223772,2242908,2247438,2238946,4530,23666,19136,0,0,0
2256692,823da9af-571e-80bd-5b89-6d966201f0ac,64,2224481,2245232,2256692,2241360,11460,32211,20751,0,0,0
2264347,adf7ff82-cb12-3253-5a41-b422b33c514d,64,2222447,2243117,2264347,2241037,21230,41900,20670,0,0,0
2277666,076d50f5-fab1-a4cf-6bf5-a7f2af4cb18c,64,2089417,2173964,2277666,2221622,103702,188249,84547,0,0,0
2282202,6aaf7dad-3d8a-b409-8050-a1bdf90135ac,64,2223055,2247438,2282202,2244113,34764,59147,24383,0,0,0
2285218,3a1927cd-88b0-157e-e1ec-294455a54a4a,64,2223057,2256692,2285218,2246446,28526,62161,33635,0,0,0
2285691,0be80648-ede5-51af-a9a4-21e11304aa0b,64,2174324,2176944,2285691,2236921,108747,111367,2620,0,0,0
2289833,e2e590fe-8294-4168-c856-359b869c5f97,64,2233802,2282202,2289833,2249018,7631,56031,48400,0,0,0
2294970,f463c0fa-51e6-79d3-de14-30d7d9f9bf16,64,2233806,2277666,2294970,2248966,17304,61164,43860,0,0,0
2295032,655fe95f-5a21-1411-d5a4-cdaa8f5468e5,32,2233803,2285218,2295032,2250189,9814,61229,51415,0,0,0
2298403,e6b9849a-878b-011f-b33a-5ba2dc95c07a,64,2223057,2285218,2298403,2250535,13185,75346,62161,0,0,0
2300080,ca95dc3b-d0ce-eae3-0c73-e1a84c7e1b16,64,2233803,2285691,2300080,2251621,14389,66277,51888,0,0,0
2307632,712d5b03-c23d-bf55-6946-3b4aa3f864ba,64,2224480,2300080,2307632,2254492,7552,83152,75600,0,0,0
2308406,20b70dda-f45c-7bd1-925b-f1461bf131bb,64,2149828,2218377,2308406,2248388,90029,158578,68549,0,0,0
2310383,7b09757d-c003-457a-0030-11523af912c4,64,2233804,2294970,2310383,2252747,15413,76579,61166,0,0,0
2319965,cb38a2f4-52a6-f47a-4a9e-9e6f33630786,64,2234122,2298403,2319965,2254352,21562,85843,64281,0,0,0
2320136,854db45f-b006-232f-6400-082c968c7a7c,64,2234123,2289833,2320136,2251815,30303,86013,55710,0,0,0
2322786,6a1f7f97-bc97-b464-8af7-31667e2f718e,64,2234224,2307632,2322786,2255735,15154,88562,73408,0,0,0
2336899,a676dc48-c8ea-44d8-2a0e-88f445c751af,64,2224479,2310383,2336899,2256981,26516,112420,85904,0,0,0
2348994,8788bdfa-8089-6774-5cd0-3f260d1e57f6,64,2234123,2319965,2348994,2257340,29029,114871,85842,0,0,0
2352526,7cb70a85-7aad-793e-26a0-5e9db637cfae,64,2222448,2308406,2352526,2256139,44120,130078,85958,0,0,0
2354167,af56b50c-80fc-de83-4abf-977905c674db,64,2093543,2202836,2354167,2238213,151331,260624,109293,0,0,0
2360201,59c88514-1da9-a45c-bfac-69ec3d2f41bc,64,2224479,2336899,2360201,2258470,23302,135722,112420,0,0,0
2361507,a7e91fee-c92d-9929-55e0-f913268e1070,64,1842662,1983743,2361507,2064321,377764,518845,141081,0,0,0
2366784,d081fc1d-4451-b57e-4701-22d841fc1292,64,2222448,2322786,2366784,2257671,43998,144336,100338,0,0,0
2372745,22fed722-27d7-2031-fedd-4ac440ea4115,32,2234225,2354167,2372745,2260317,18578,138520,119942,0,0,0
2373447,a6e9b3fb-33c6-5af0-cff7-2fcbe8257c5f,64,2222447,2352526,2373447,2259876,20921,151000,130079,0,0,0
2374519,2e865d50-86ec-e471-96fa-f49ddc8a12a7,64,2223056,2361507,2374519,2263107,13012,151463,138451,0,0,0
2375709,bb1113e3-f0c6-25fc-0325-2bdcb5b92c65,64,2234122,2354167,2375709,2260345,21542,141587,120045,0,0,0
2383472,8ef6f5f5-ed4b-df57-a658-4681ba8aa5d9,64,2224480,2374519,2383472,2264285,8953,158992,150039,0,0,0
2389093,3dabb376-c545-b206-3ddb-5192e03a6cda,64,2184543,2320136,2389093,2257373,68957,204550,135593,0,0,0
2389747,c9a795f9-3633-cf81-d287-1f0d1a2d4ebc,64,2248346,2375709,2389747,2264297,14038,141401,127363,0,0,0
2392303,1bf9b608-e078-107f-b41d-fad355de5699,64,2222447,2360201,2392303,2261973,32102,169856,137754,0,0,0
2394184,fa634aac-ac9c-a0de-4d38-ad2cf6487a5c,64,2234228,2366784,2394184,2263309,27400,159956,132556,0,0,0
2395520,821dadce-3559-5fdf-69e0-5ebd5dfdc4cd,64,2244828,2373447,2395520,2263384,22073,150692,128619,0,0,0
2397035,904e30f1-d628-5ca5-b846-bf20561ffb69,32,2265733,2394184,2397035,2267913,2851,131302,128451,0,0,0
2398294,830fc407-d52b-b10c-895a-78c79dff9267,64,2265802,2394184,2398294,2268280,4110,132492,128382,0,0,0
2398810,eb42a8c9-63fb-28fc-92c6-9354580c0582,64,2265803,2397035,2398810,2268588,1775,133007,131232,0,0,0
2400687,0d414ccf-5bb0-a015-60da-c202e9b4cde5,64,2265802,2398294,2400687,2268715,2393,134885,132492,0,0,0
2401069,bf761225-e657-dc72-bde4-48bbb3356d8d,64,2265734,2398810,2401069,2268910,2259,135335,133076,0,0,0
2402290,e83af7ef-ab76-f06a-44b6-49d01e778690,64,2265803,2400687,2402290,2268921,1603,136487,134884,0,0,0
2405470,f63420b3-f348-1478-7034-c67b27c0b8d9,64,2265740,2401069,2405470,2269252,4401,139730,135329,0,0,0
2406401,a8ab7495-e387-5beb-da02-9afc25e3f892,64,2265802,2402290,2406401,2269299,4111,140599,136488,0,0,0
2408190,22af032a-dd58-ba80-cd21-b396cac4863d,64,2265734,2405470,2408190,2269363,2720,142456,139736,0,0,0
2412413,ab8a2e8e-cd83-6844-1ddf-f7fd9c03699f,32,2265802,2408190,2412413,2269637,4223,146611,142388,0,0,0
2412536,1289093b-752c-b91c-ecf6-7bcdff6f10e2,64,2244827,2383472,2412536,2265886,29064,167709,138645,0,0,0
2413323,bb480db3-49fa-9ada-24b3-0a5deff0c8c6,32,2248346,2395520,2413323,2268380,17803,164977,147174,0,0,0
2414634,c0f61b24-3934-54d1-4084-c72d7ee8f72e,64,2265733,2412413,2414634,2269903,2221,148901,146680,0,0,0
2414928,99194ae3-10fa-be47-591b-f6e1adaaa339,64,2264761,2406401,2414928,2269451,8527,150167,141640,0,0,0
2417124,f17ff4d8-cd02-69b7-1147-a17d71e3b64b,64,2265806,2414928,2417124,2270523,2196,151318,149122,0,0,0
2418852,c5d68edf-22a2-7798-11c1-ae8202e2ef68,64,2265735,2414634,2418852,2270294,4218,153117,148899,0,0,0
2418912,baddaf6c-c58c-d7b2-c11c-75e0ea37966b,64,2244827,2389093,2418910,2267279,29817,174083,144266,0,0,0
2419851,70e4d888-0952-c8c8-0cb5-ce532a4c01f4,32,2265735,2417124,2419851,2271008,2727,154116,151389,0,0,0
2421153,9c5e2c2b-f403-fe63-1710-06856850a579,64,2265734,2418912,2421153,2271176,2241,155419,153178,0,0,0
2421260,4dc4341f-0917-1e43-2ff5-a8cc3d27d09c,64,2265690,2412536,2421260,2270025,8724,155570,146846,0,0,0
2421474,28c0df38-d109-24d2-10bf-8cc3989d23b3,64,2265735,2417124,2421474,2271120,4350,155739,151389,0,0,0
2421658,ecea4144-efc7-9baa-60e7-46a862ffe3e7,32,2265734,2418852,2421658,2271166,2806,155924,153118,0,0,0
2422633,8ab930d2-4cdc-3b9a-52f4-af9702644899,64,2265801,2419851,2422633,2271350,2782,156832,154050,0,0,0
2423170,9dcf6e0a-e3ea-39d1-f416-bfb7cec25562,64,2234226,2392303,2423170,2267721,30867,188944,158077,0,0,0
2423538,e0561a93-79e8-5b50-d11b-f383832b0f8b,64,2265800,2421153,2423538,2271501,2385,157738,155353,0,0,0
2425352,4415a38f-d1bc-fb2b-e7f2-bb2c6baa9211,64,2265735,2423170,2425352,2271865,2182,159617,157435,0,0,0
2425449,d7be2dac-acf7-e08a-1e83-723ce401d4d2,64,2223057,2389747,2425449,2267320,35702,202392,166690,0,0,0
2425863,d7767313-8829-a9c2-34d0-82bce71a5759,64,2265803,2421260,2425863,2271552,4603,160060,155457,0,0,0
2425997,6f792a91-95db-b3ba-9e07-820a7017aa8b,64,2265804,2421474,2425997,2271670,4523,160193,155670,0,0,0
2426838,68619d1b-046c-1f72-20c7-cf491ce982af,64,2265691,2423538,2426838,2272085,3300,161147,157847,0,0,0
2428660,a081f555-979a-cc69-15bb-ff19c7be2d69,64,2265690,2425352,2428660,2272106,3308,162970,159662,0,0,0
2433154,ca9e39ee-e223-731a-221c-52593ff9de89,64,2265691,2428660,2433154,2274006,4494,167463,162969,0,0,0
2434416,9fb0ab0d-8f06-7ab6-d742-772afcf7ef7c,64,2264760,2425863,2434416,2272272,8553,169656,161103,0,0,0
2449175,0160b56b-e4e1-524d-313a-c46424206bc2,64,2262123,2433154,2449175,2274021,16021,187052,171031,0,0,0
2452266,5c279375-9b98-882f-79ca-245e82ea1277,64,2248347,2422633,2452266,2271694,29633,203919,174286,0,0,0
2453905,2f652492-e379-3df6-1b63-4434a380f89c,64,2265691,2449175,2453905,2274367,4730,188214,183484,0,0,0
2454787,e3871417-73e5-dc0b-ce62-fa09190fe912,64,2234225,2425997,2454787,2273006,28790,220562,191772,0,0,0
2455011,506b97e4-091f-323f-a93a-26d460f68115,64,2244828,2425449,2455011,2272133,29562,210183,180621,0,0,0
2455071,429df6a1-ba23-590e-d361-6a9e7b9c007c,64,2234123,2426838,2455065,2273629,28227,220942,192715,0,0,0
2462427,8c31d850-ee4e-8cf1-5406-cfd13474d315,64,2248346,2434416,2462427,2274060,28011,214081,186070,0,0,0
2463476,282797fb-9e60-3d8d-98a8-f810e05f6854,64,2264759,2454787,2463476,2276224,8689,198717,190028,0,0,0
2463858,68494df2-4c7e-d3ac-1a74-bab661c881b6,64,2264759,2455071,2463858,2277151,8787,199099,190312,0,0,0
2464597,60a6f4da-bc83-327c-206c-428d1b1a4bd7,64,2264759,2455011,2464597,2276230,9586,199838,190252,0,0,0
2470781,6c7e61cc-e71e-6484-2840-bc44236eba4c,64,2261302,2452266,2470781,2275226,18515,209479,190964,0,0,0
2471703,84f5d7d1-3421-db3c-3e87-9da48fdabee5,64,2248154,2453905,2471670,2275259,17765,223516,205751,0,0,0
2473104,859b05cd-876b-fc20-de0c-bd581115d925,64,2262122,2463476,2473104,2279564,9628,210982,201354,0,0,0
2479503,e05076d5-88d3-4613-76c5-c5e130d51c8b,64,2244827,2464597,2479503,2281873,14906,234676,219770,0,0,0
2480409,8cda07ae-af8e-2bc5-562d-8e63e87e1eaa,64,2261302,2470781,2480409,2283481,9628,219107,209479,0,0,0
2480602,c180b76e-b5a4-160b-168c-76faa5298ef2,64,2261303,2462427,2480602,2279069,18175,219299,201124,0,0,0
2481713,d2fe1c67-c3a2-8d68-67e3-3758d6e3bec0,64,2261305,2471703,2481713,2284755,10010,220408,210398,0,0,0
2486538,10ae8fd1-cadb-646b-a366-c34d789739e8,64,2262122,2479503,2486538,2285451,7035,224416,217381,0,0,0
2494688,d035c3ca-12ad-7487-28f5-a57795b057e9,64,2262122,2480409,2494688,2285686,14279,232566,218287,0,0,0
2496397,296bc878-b3e8-86bf-1425-8378d2cb0fa8,64,2248346,2473104,2496397,2285382,23293,248051,224758,0,0,0
2497184,2980f7b5-e86b-b300-bc20-0b625be3dc80,64,2248153,2463858,2497184,2280280,33326,249031,215705,0,0,0
2498752,280c9be1-1ef8-0a8b-3812-99e8b1ad1c8a,64,2286521,2496397,2498752,2288846,2355,212231,209876,0,0,0
2500445,9d7db622-8ed8-b731-018e-923b43184265,64,2261302,2481713,2500445,2286827,18732,239143,220411,0,0,0
2500783,d27be71e-685d-0751-1a19-5aa4a111f44b,64,2262123,2486538,2500783,2287282,14245,238660,224415,0,0,0
2501170,3aeaaa0f-b5a5-1112-d5bd-c8ad55ecdedc,64,2286456,2498752,2501170,2290319,2418,214714,212296,0,0,0
2505675,188f3807-e915-855f-6a72-92a645fbe0e3,64,2301450,2501170,2505675,2303761,4505,204225,199720,0,0,0
2507216,868afcc3-db03-6d65-d387-5ee0bc91f98f,64,2248152,2494688,2507216,2288525,12528,259064,246536,0,0,0
2512294,0d29bcbe-5cb8-f9a2-8627-bdd38eba7a88,64,2301449,2507216,2512294,2304676,5078,210845,205767,0,0,0
2514313,d14b740f-76c3-4232-2470-a5d8fafd37bc,64,2248153,2497184,2514313,2290145,17129,266160,249031,0,0,0
2517209,e0eb2ef0-df96-53e8-4f9f-9da20216695b,64,2301448,2512294,2517209,2304911,4915,215761,210846,0,0,0
2518829,68090654-56ca-2769-2428-d6cd74c25452,64,2301448,2514313,2518829,2306526,4516,217381,212865,0,0,0
2520278,07879108-a131-d3a2-b990-9cd1807c99c8,64,2301451,2517209,2520278,2306682,3069,218827,215758,0,0,0
2524256,0e5ce39f-7955-cdb7-84b3-1a4df68c76c7,64,2301449,2518829,2524256,2306948,5427,222807,217380,0,0,0
2524645,4612ca2b-faa9-6362-302b-7606fafcc5af,32,2309395,2524256,2524645,2309809,389,215250,214861,0,0,0
2524770,555b60f3-a266-07d3-c39a-a2ad92344a2a,64,2301447,2520278,2524770,2307453,4492,223323,218831,0,0,0
2525426,bb4b4060-3581-4f6e-ebe6-d2b4cd4650f3,32,2310700,2524770,2525426,2311120,656,214726,214070,0,0,0
2525994,8e0f4617-3c4e-fd0c-24fa-95c15d029c3c,32,2311669,2525426,2525994,2312154,568,214325,213757,0,0,0
2526552,5caf20ae-3f45-f107-82ff-b3e362e9826e,32,2311634,2525994,2526552,2312198,558,214918,214360,0,0,0
2527709,bdc15eef-6aac-67f4-5d33-98309ad911b5,64,2306914,2524645,2527709,2310293,3064,220795,217731,0,0,0
2528419,d7cbce85-fc9f-31e6-fb50-690fc33218c4,32,2312112,2527709,2528419,2312547,710,216307,215597,0,0,0
2529083,4810e70b-06b1-2063-ad21-d9547b6e5d95,32,2312070,2528419,2529083,2312944,664,217013,216349,0,0,0
2529143,bf3c2af2-4956-fac7-fb05-8827aa7b000e,32,2301449,2524256,2529100,2308211,4844,227651,222807,0,0,0
2529853,2609718e-7dd8-13a4-c9c1-872b1ed57758,64,2303257,2526552,2529853,2312518,3301,226596,223295,0,0,0
2533309,7efa8dc1-dc58-d723-b3a5-19a49ce86886,64,2094533,2348994,2533309,2259779,184315,438776,254461,0,0,0
2533920,64fc06ba-3ff8-c67a-a118-3f918d08b6f8,64,2248153,2500445,2533920,2294272,33475,285767,252292,0,0,0
2534503,109797e1-bd4b-da9d-3c88-f1dfc22b6013,64,2303256,2529853,2534503,2316173,4650,231247,226597,0,0,0
2536295,61647399-5912-5e55-aa1d-f1b1432a7685,32,2316623,2534503,2536295,2318974,1792,219672,217880,0,0,0
2545244,309fa6ce-2e08-a182-11cd-47e4368a962f,64,2301448,2533309,2545244,2316670,11935,243796,231861,0,0,0
2547477,a53b3da3-ffcb-6dfb-57af-73c4f82c80e0,64,2303257,2533920,2547477,2318426,13557,244220,230663,0,0,0
2547831,4d65bcea-2269-21eb-601c-56e26b813e22,64,2174324,2480602,2547831,2285721,67229,373507,306278,0,0,0
2550600,605ba454-7e77-1a81-da65-97eac9d67ae0,64,2299341,2529083,2550600,2316013,21517,251259,229742,0,0,0
2555418,03cfd821-d88a-907a-9176-94db083c56cc,64,2303257,2547831,2555418,2324399,7587,252161,244574,0,0,0
2560560,cd9154c4-7968-f364-ed48-861b4eed56dc,64,2303257,2547477,2560560,2324083,13083,257303,244220,0,0,0
2567701,7d9d6715-48cc-bf79-7cde-4129a0357bf5,64,2299343,2550600,2567701,2332708,17101,268358,251257,0,0,0
2573226,3b4e450c-7501-0ae2-6b34-ee5b6f6c345c,64,2299342,2534503,2573226,2319997,38723,273884,235161,0,0,0
2591208,a9927ce9-888d-0d4d-c4ab-29b8924d88d7,64,2330755,2573226,2591208,2353615,17982,260453,242471,0,0,0
2592000,9caf2fc4-a2e9-a072-23e3-3d376ed3d084,64,2299342,2555418,2592000,2337551,36582,292658,256076,0,0,0
2592570,e88973a6-1fd4-42bc-981d-bf302b1dc571,64,2174323,2545244,2592570,2323998,47326,418247,370921,0,0,0
2594828,3710194d-dee0-3067-15de-7226165886f0,64,2299341,2560560,2594828,2347143,34268,295487,261219,0,0,0
2595600,e68e4345-3d74-ada8-03be-274378caf0ab,64,2356320,2591208,2595600,2359267,4392,239280,234888,0,0,0
2595660,1d4489f4-7398-bc20-54ed-8b694a35bd63,32,2356320,2591208,2595654,2358782,4446,239334,234888,0,0,0
2596867,9b33a68d-4646-7710-f1fa-ffe7ad1099fc,64,2174355,2500783,2596867,2301714,96084,422512,326428,0,0,0
2597032,c5ea94c7-803b-77e7-eb6f-997ddff961c2,64,2356322,2592000,2597032,2359391,5032,240710,235678,0,0,0
2597567,0cea7f59-860b-5ee0-32c7-eaf4f8a2c004,64,2356320,2592570,2597567,2360050,4997,241247,236250,0,0,0
2598560,9b570c7f-70e1-d1a1-63a6-fb91ea3ffa71,64,2330756,2567701,2598560,2348176,30859,267804,236945,0,0,0
2599059,ff62236c-6987-5328-550d-987d226f09a1,64,2356319,2595600,2599059,2362124,3459,242740,239281,0,0,0
2599871,ee10ecad-a48c-26c3-e1a7-fc196a2050cd,64,2356320,2594828,2599871,2360314,5043,243551,238508,0,0,0
2601410,11c08c0c-65fa-d5f2-575e-54d5674c8603,64,2356320,2596867,2601410,2362181,4543,245090,240547,0,0,0
2602369,0950a6cb-62e6-172a-c751-6421833888f9,64,2174323,2505675,2602369,2304520,96694,428046,331352,0,0,0
2610489,f20f428d-a56d-1c5f-2f6e-8aa84f5a671b,64,2330757,2598560,2610489,2370852,11929,279732,267803,0,0,0
2614589,81147d80-6140-addc-00aa-bc1a6cc0ae5b,64,2330756,2597567,2614589,2369945,17022,283833,266811,0,0,0
2618296,704dc28c-8f36-48b4-ca53-6e222fcde2a7,64,2294735,2599871,2618296,2395351,18425,323561,305136,0,0,0
2620612,e8695c25-9281-95a0-ed98-833ef3645eb4,64,2292622,2610489,2620612,2406968,10123,327990,317867,0,0,0
2621082,bd9d0a81-6785-32f9-0e39-4b3dcdc07f5a,64,2292703,2599059,2621082,2384364,22023,328379,306356,0,0,0
2621983,d1b3b623-4991-6111-971e-f037db9fdb37,64,2413396,2621082,2621983,2414240,901,208587,207686,0,0,0
2622101,51b0981f-7972-23f2-2ec3-5c27f0115b08,64,2413395,2620612,2622101,2414041,1489,208706,207217,0,0,0
2622443,919337ca-65b6-85bf-0eb8-d1b162ae6405,64,2413396,2621983,2622443,2414317,460,209047,208587,0,0,0
2622765,b1098d5f-94ff-69bb-e442-e3d7d1551de6,64,2413396,2622101,2622765,2414725,664,209369,208705,0,0,0
2623098,9e9d3b3e-c2c2-d9fe-07f9-64942621d492,64,2413395,2622443,2623098,2415044,655,209703,209048,0,0,0
2623991,09bf3f6d-53dd-437f-0691-1c1dfc8e92ea,64,2413396,2622765,2623991,2415141,1226,210595,209369,0,0,0
2627952,5023277a-7e0d-493c-cf85-5e61b6567099,64,2330756,2597032,2627952,2367808,30920,297196,266276,0,0,0
2636261,636a6100-0f3f-c461-0450-c068e34ede51,64,2383295,2602369,2636261,2406201,33892,252966,219074,0,0,0
2645481,debd7bfa-51b8-181f-66b9-4d32fee673d7,32,2383298,2623098,2645481,2417468,22383,262183,239800,0,0,0
2652045,e72f3acb-a16c-b5eb-874a-abc61e9c4a25,64,1600591,1686872,2652045,2182628,965173,1051454,86281,0,0,0
2653387,8a41ee5b-d1ac-9fb2-f6ba-e4663a7fd06e,64,2383295,2618296,2653387,2413037,35091,270092,235001,0,0,0
2656950,422fbb33-1f21-fcb1-0443-cfda137dc095,64,2383295,2623098,2656950,2421663,33852,273655,239803,0,0,0
2660728,bd54c13c-ac26-f2e4-6d9e-cb6f198db629,64,2383296,2623991,2660728,2422792,36737,277432,240695,0,0,0
2664554,e3bd1c68-71b4-5b12-cce8-c3339efc6fc2,64,2416227,2653387,2664554,2437125,11167,248327,237160,0,0,0
2674646,d057ebe6-caa7-eb21-aea7-de61c1ffecad,64,2276480,2601410,2674646,2405887,73236,398166,324930,0,0,0
2676575,56dfdf3a-ed68-5dd3-d080-e1e4415336a1,64,2416225,2660728,2676575,2444671,15847,260350,244503,0,0,0
2679388,49c68405-fb5e-dae9-b833-40a6227d7f51,64,2441906,2674646,2679388,2453589,4742,237482,232740,0,0,0
2687909,e383f4b4-f7e4-0b14-1bed-8665d70c9f40,64,2374074,2636261,2687909,2430906,51648,313835,262187,0,0,0
2688713,140f0c7e-0d45-de90-ffde-9f0f7224a012,32,2464684,2687909,2688713,2465694,804,224029,223225,0,0,0
2689261,b33a3c51-4315-abae-750c-32addec00011,64,2416226,2656950,2689261,2440801,32311,273035,240724,0,0,0
2690233,cb8616e0-73f6-505a-f514-7012814c2c83,64,2465274,2688713,2690233,2466272,1520,224959,223439,0,0,0
2690966,ba53ecff-9750-7183-8102-a7d6e8efd6ac,64,2465274,2689261,2690966,2466489,1705,225692,223987,0,0,0
2691230,3414fcba-8340-0cdc-693c-43e498267af8,64,2465274,2690233,2691230,2466547,997,225956,224959,0,0,0
2692520,327e1943-6f2c-4e21-e1af-f24f1130b1e8,64,2465274,2690966,2692520,2466565,1554,227246,225692,0,0,0
2693556,4d8da5ac-13e3-5b4b-3579-ea622adfc39c,32,2465071,2692520,2693556,2466759,1036,228485,227449,0,0,0
2694064,feb1d806-3c08-75e8-4fa9-0af88a9c4cc4,64,2416227,2664554,2694064,2451103,29510,277837,248327,0,0,0
2694344,f213364d-cb1f-4fe0-c790-f4fbec2fc93d,64,2465273,2693556,2694344,2466907,788,229071,228283,0,0,0
2695008,aa211b1a-0584-5985-3dd6-818f6814cde4,64,2466329,2694064,2695008,2467530,944,228679,227735,0,0,0
2695758,fc4ab3f7-b1b5-b684-3382-82da14b3c01b,64,2471643,2694344,2695758,2472787,1414,224115,222701,0,0,0
2696777,85e3fb23-4cf3-b903-5cdb-219703de99f5,64,2471845,2695008,2696777,2473814,1769,224932,223163,0,0,0
2698965,31db8a90-1769-74e4-6f02-9d52a331120e,64,2416225,2676575,2698965,2454811,22390,282740,260350,0,0,0
2700451,63e25042-dd2f-455d-6db6-800d17a2a368,64,2464498,2695758,2700451,2474211,4693,235953,231260,0,0,0
2700586,53a4d245-f920-6066-81e1-9daf9c9810b1,64,2475241,2698965,2700586,2476814,1621,225345,223724,0,0,0
2705543,d160cf42-4f03-0adf-e846-875e45f363f4,64,2472870,2700586,2705543,2479397,4957,232673,227716,0,0,0
2712136,ecb7034c-b192-a7f5-574a-92d2706bd73c,64,2442300,2691230,2712136,2466674,20906,269836,248930,0,0,0
2712196,3eae060b-0e84-63ce-469f-006ad749cf12,64,2416010,2679388,2712138,2455563,32750,296128,263378,0,0,0
2714335,53cb413f-d78a-2471-2604-3b5e385e239b,64,2484521,2712136,2714335,2489052,2199,229814,227615,0,0,0
2719475,81238f51-5251-ac2b-1de3-35c276252e09,64,2452022,2700451,2719475,2477132,19024,267453,248429,0,0,0
2720030,43696518-8f06-e1ed-a361-8e1a75c6e3c5,32,2492651,2719475,2720030,2493099,555,227379,226824,0,0,0
2723074,645be719-5396-c7ff-e4a2-a4438fc79671,32,2294799,2687909,2723074,2465234,35165,428275,393110,0,0,0
2741253,4506c144-57f7-de45-597a-f8bdf07e3384,64,2374073,2627952,2741253,2430609,113301,367180,253879,0,0,0
2745406,b6fd96b1-ca67-d7af-5e1b-e5e577ff1a82,32,2454017,2712196,2745406,2490218,33210,291389,258179,0,0,0
2749064,aa92f060-755d-0629-0340-52474b9a0b10,64,2374072,2652045,2749064,2430963,97019,374992,277973,0,0,0
2757452,6e9060ab-0dc8-a778-8b13-577abeeea7f7,64,2452022,2705543,2757452,2485585,51909,305430,253521,0,0,0
2761703,6b5bf467-b850-4e23-2f51-e180f46ae51d,32,2374073,2696777,2761703,2476763,64926,387630,322704,0,0,0
2761778,cca00e5a-c999-79c6-2b37-d44f0c3ff969,64,2452023,2712196,2761778,2490555,49582,309755,260173,0,0,0
2763474,7c4a8c8b-1631-6655-de6b-6517898e3229,64,2454017,2714335,2763474,2492876,49139,309457,260318,0,0,0
2767968,5081e9fc-018f-21b5-eafb-51f98fd9139a,64,2454017,2749064,2767968,2504462,18904,313951,295047,0,0,0
2769501,c05912b3-84f4-4361-69a7-18a56823ec2b,32,2524100,2767968,2769501,2526013,1533,245401,243868,0,0,0
2778806,c0ba04eb-ff69-0ec4-6d3c-042849355466,32,2452024,2745406,2778806,2502274,33400,326782,293382,0,0,0
2780923,8d14b247-f6cf-df1e-78fd-484c82733f98,64,2503461,2763474,2780923,2519723,17449,277462,260013,0,0,0
2782375,0ce63efb-1e2d-76f9-3598-9117327d0102,64,2526324,2780923,2782375,2528240,1452,256051,254599,0,0,0
2790242,8aaf21c6-5dbd-b23a-6ade-63c0dbe1a033,64,2454017,2741253,2790242,2502119,48989,336225,287236,0,0,0
2790637,1ce100e3-88a5-dbc6-7f94-b6ea854dd018,32,2454017,2757452,2790637,2505093,33185,336620,303435,0,0,0
2793836,1a2fb74b-5905-799e-292a-c2cac24e2a72,64,2452022,2761778,2793836,2511216,32058,341814,309756,0,0,0
2795451,fd6bf551-c15f-c2b1-57eb-218d8b6cf567,32,2536672,2793836,2795451,2538337,1615,258779,257164,0,0,0
2797348,cd854361-c284-97fe-854a-4b54bb6fe822,32,2442783,2757452,2797348,2504597,39896,354565,314669,0,0,0
2800013,c1e8915d-b0a4-8c34-8c6a-ac6e74abea5e,64,2292828,2769501,2800013,2527150,30512,507185,476673,0,0,0
2805390,a61b4f74-fc43-263f-7235-554c31b04656,64,2441953,2761703,2805390,2506469,43687,363437,319750,0,0,0
2810068,f2d16b75-0bd6-4166-c0bc-deeee08fb5a4,64,2546628,2805390,2810068,2551062,4678,263440,258762,0,0,0
2814583,c8f87675-8d2b-20bf-6a44-f3538c567659,64,2503463,2782375,2814583,2532436,32208,311120,278912,0,0,0
2816559,4ca39c10-a416-87ad-b98c-78ed287c3c14,64,2549671,2814583,2816559,2553032,1976,266888,264912,0,0,0
2816643,20abd324-1b01-ac79-1b7b-9fd18f2e9b4c,64,2374073,2720030,2816643,2497714,96613,442570,345957,0,0,0
2817735,05c8f991-b9b7-123b-4972-ca2021900edb,64,2503461,2800013,2817735,2550206,17722,314274,296552,0,0,0
2821257,5250895d-46fb-c5b0-2a98-c22bb78860ba,64,2552097,2816559,2821257,2557185,4698,269160,264462,0,0,0
2822910,66594df2-8542-f068-c421-d16a638b6a24,64,2503462,2790242,2822910,2533291,32668,319448,286780,0,0,0
2825478,701daebf-c142-c184-5664-7b59c8ba8729,64,2503412,2790637,2825478,2537215,34841,322066,287225,0,0,0
2827582,48b1a6aa-af0c-6f07-9341-5e84303c0d87,64,2549066,2817735,2827582,2583023,9847,278516,268669,0,0,0
2829443,0993f8bf-485a-b6f2-3d46-53b74488b8e6,64,2503461,2795451,2829443,2541718,33992,325982,291990,0,0,0
2842933,7bbae4d8-867b-fd7e-5b44-f17bb78310b0,64,2553531,2816643,2842933,2578279,26290,289402,263112,0,0,0
2846568,e23bb258-1c67-5323-8465-fc98972b69cf,64,2578263,2829443,2846568,2609569,17125,268305,251180,0,0,0
2847945,b0121057-de26-8194-7717-7df674600844,64,2552301,2825478,2847945,2602952,22467,295644,273177,0,0,0
2848301,9c7bdfd5-7b84-b160-4654-3a82e13f0e66,64,2578265,2822910,2848301,2601901,25391,270036,244645,0,0,0
2848564,bac6d96b-a359-bc32-fc75-fe235f8d566a,64,2096810,2614589,2848564,2409585,233975,751754,517779,0,0,0
2851727,2561a0de-ccab-aa2a-c81a-d24fe11e825b,64,2642465,2848301,2851727,2645114,3426,209262,205836,0,0,0
2853026,855ab411-061e-1762-2555-9f5cf70b3a05,64,2642465,2848564,2853026,2646079,4462,210561,206099,0,0,0
2853278,0e48e3a1-f0d4-4ff2-bd4b-a8c26a2a68f9,64,2578264,2827582,2853278,2603222,25696,275014,249318,0,0,0
2856329,7f74740a-3fe7-888c-6da3-1410ac6ffdca,64,2642465,2851727,2856329,2647971,4602,213864,209262,0,0,0
2859170,465b0e7c-4d79-7882-7866-19f6026a925c,64,2578263,2846568,2859170,2618307,12602,280907,268305,0,0,0
2865103,4b89264a-e100-569f-0661-4e5cef526bd5,64,2552496,2821257,2865103,2596592,43846,312607,268761,0,0,0
2876194,55bb22df-859d-845e-8478-eaa9e2ee7402,64,2578263,2842933,2876194,2616451,33261,297931,264670,0,0,0
2901324,4247fd42-d6bd-1a82-8ddc-d54626560d7f,64,2441990,2810068,2901324,2552005,91256,459334,368078,0,0,0
2917665,b0ebb018-ed56-35a8-fbac-634f76b57231,64,2552588,2847945,2917665,2623445,69720,365077,295357,0,0,0
2923078,2a025177-2936-d686-ee8c-ee8f344f45ed,64,2523761,2853278,2923078,2651380,69800,399317,329517,0,0,0
2924425,9b4adf5a-7f83-e6da-5782-9d6c4dc6f6ae,64,2552212,2876194,2924425,2672462,48231,372213,323982,0,0,0
2925744,f8bca74e-b8a2-617d-2877-96f5bd4dfa2c,64,2707060,2924425,2925744,2708995,1319,218684,217365,0,0,0
2927944,1bc50478-20c5-df11-edf6-e5a0e500ff86,64,2552851,2859170,2927944,2666336,68774,375093,306319,0,0,0
2954114,cc298920-d7e4-0920-ee34-42d40f5407eb,64,2523760,2856329,2954114,2657083,97785,430354,332569,0,0,0
2975632,2f289654-ef43-0f20-cf09-47c5d25d5ca7,64,2523755,2853026,2975632,2648919,122606,451877,329271,0,0,0
2976625,267863e2-365d-acc3-e6d9-011a77af791c,64,2694874,2925744,2976625,2720252,50881,281751,230870,0,0,0
2979760,fd40504c-2c5d-ba22-2062-e7f485041e4e,64,2719339,2975632,2979760,2724213,4128,260421,256293,0,0,0
2983298,7bc7c7f7-b52b-b796-1cd6-7b903dfc79a5,64,2694874,2927944,2983298,2722956,55354,288424,233070,0,0,0
3003682,41c9bccb-bab8-dd5b-99f4-8d60cebcabed,64,2694177,2976625,3003682,2726301,27057,309505,282448,0,0,0
3005812,a0e42f79-1985-dbb9-e93f-7f9ff9044054,64,2694179,2954114,3005812,2723919,51698,311633,259935,0,0,0
3006658,c78266b2-4682-c377-9b42-fa0eba3636e3,64,2694874,2983298,3006658,2732958,23360,311784,288424,0,0,0
3013439,48f9b17a-08a2-1434-f20d-02621a794bbf,32,2694874,2979760,3013439,2729110,33679,318565,284886,0,0,0
3016709,dfe520a8-58bf-a9a1-6975-c7c3db491bb8,64,2700310,3003682,3016709,2734361,13027,316399,303372,0,0,0
3017846,ca27bb43-4ffc-71c0-e088-14e110b09c15,64,2719389,3005812,3017846,2736180,12034,298457,286423,0,0,0
3018133,e8dc375e-2d22-11a5-b651-2be2fb34b569,64,2694180,2979760,3018133,2729190,38373,323953,285580,0,0,0
3027287,95045996-0361-5001-4401-47393ba1e896,64,2694874,3006658,3027287,2738434,20629,332413,311784,0,0,0
3042426,f1008f68-a35b-750c-aee9-e2b9bc0469f2,64,2694178,3016709,3042426,2741132,25717,348248,322531,0,0,0
3053540,6629ef02-e3f4-a404-3a5e-89f1058334ad,64,2523757,2865103,3053540,2670347,188437,529783,341346,0,0,0
3054937,52a557ea-e0ad-3e99-f14a-5ef7da2b6e64,64,2729974,3042426,3054906,2757489,12480,324932,312452,0,0,0
3059498,dc8de4b9-7f09-6df7-23c2-deaa482ebe2c,64,2694178,3027287,3059498,2754322,32211,365320,333109,0,0,0
3080405,e44630f3-3860-1436-2168-83098243bbfa,64,2715490,3053540,3080405,2767168,26865,364915,338050,0,0,0
3098015,5c1ed84f-b2a6-1bc7-1e04-3a70c59600f1,64,2715492,3054937,3098015,2767272,43078,382523,339445,0,0,0
3098175,fc2805e4-983b-8393-4337-00eab06abb80,64,2729974,3080405,3098175,2770735,17770,368201,350431,0,0,0
3110126,d3af3619-f36d-5a36-5af7-f22cd4d84d00,64,2523755,2917665,3110126,2680527,192461,586371,393910,0,0,0
3111825,a444a9d8-3f57-bf04-dd42-99bc80646357,64,2523755,2901324,3111825,2677024,210501,588070,377569,0,0,0
3114456,47c3b88a-25b9-e59d-1d51-edc46d519462,64,2715491,3059498,3114456,2770507,54958,398965,344007,0,0,0
3114914,5ee20e37-2be8-c923-95f3-56e321920600,64,2776462,3114456,3114914,2776861,458,338452,337994,0,0,0
3115373,e682e667-472c-de51-db30-65583ab701ba,64,2729974,3098175,3115373,2772217,17198,385399,368201,0,0,0
3116152,9cc9d6e3-5822-bc3c-30fb-6528f1404752,64,2776462,3115373,3116152,2777221,779,339690,338911,0,0,0
3116921,e57bdbbe-f9af-a2b3-4791-49c83bbc1d28,64,2776461,3116152,3116921,2777735,769,340460,339691,0,0,0
3140797,be475dfc-0d26-c3b6-2053-6392b3f4e57e,64,2523763,3018133,3140797,2753431,122664,617034,494370,0,0,0
3142584,f872e796-1bf7-1f97-224a-042d1b095a7b,64,2523756,2923078,3142584,2686325,219506,618828,399322,0,0,0
3143965,03c85720-86ec-7402-0d41-89a904cfd5e4,64,2715491,3116921,3143965,2777986,27044,428474,401430,0,0,0
3144085,394cfd4f-9df3-fdd8-97bc-a4925221febc,64,2729974,3111825,3144085,2775771,32260,414111,381851,0,0,0
3148109,43a50bf5-dc87-2485-887c-6a5b163946b8,64,2729974,3114914,3148109,2776934,33195,418135,384940,0,0,0
3159786,14eb383a-65f2-bc1b-12d1-9c16fd52e5fb,64,2715491,3110126,3159786,2772960,49660,444295,394635,0,0,0
3176751,7545eb0b-8926-a08a-3583-840b904e1689,64,2771355,3144085,3176751,2787960,32666,405396,372730,0,0,0
3176931,d33d0933-c890-8f7e-bedc-24cdf234348a,64,2754338,3140797,3176931,2778737,36134,422593,386459,0,0,0
3195084,7b027f18-e389-8e31-8571-3bb558b8978e,64,2523762,3098015,3195084,2771928,97069,671322,574253,0,0,0
3196981,97693724-1ff3-f365-f627-108d0feb4230,64,2753862,3142584,3196981,2786785,54397,443119,388722,0,0,0
3197373,76de3e6f-e1a6-b4c4-efe8-77e608d0e66b,64,2754338,3159786,3197373,2790443,37587,443035,405448,0,0,0
3202504,f91bd964-970a-3a73-95fe-bca1fb5724a6,64,2786693,3196981,3202504,2797781,5523,415811,410288,0,0,0
3209870,c893471b-6c76-04b7-f47a-847bc33d789a,64,2523763,3017846,3209870,2747082,192024,686107,494083,0,0,0
3212039,64ce2e92-2547-e898-f8b8-9a8317c333ff,64,2771355,3195084,3212039,2794905,16955,440684,423729,0,0,0
3227543,acda8680-3be9-69cd-5148-632271eab516,64,2784631,3212039,3227543,2798967,15504,442912,427408,0,0,0
3231207,095dd836-ef6c-a861-7601-f89abd53a0b9,64,2771354,3202504,3231207,2797949,28703,459853,431150,0,0,0
3231808,438fd1e8-22de-662f-1659-b3532a9d05d5,64,2771355,3197373,3231808,2797793,34435,460453,426018,0,0,0
3240323,5d4ca1ee-20ee-3782-9b23-c9b96a4fc1e0,64,2523765,3143965,3240323,2787598,96358,716558,620200,0,0,0
3242189,07f33e14-88ba-39c3-2c2d-a376cbd5aa22,64,2754337,3209870,3242189,2798082,32319,487852,455533,0,0,0
3242855,cf433079-ffa3-0182-1c69-ea7ee92958c0,64,2803583,3240323,3242855,2804670,2532,439272,436740,0,0,0
3243736,05f89735-b553-7adc-1462-23163abdf120,64,2754338,3231207,3243736,2800364,12529,489398,476869,0,0,0
3246105,a9fdc717-6830-dfbb-2c79-5c888bb1e809,64,2803582,3243736,3246105,2805692,2369,442523,440154,0,0,0
3248268,3a38a29d-8947-5739-8051-268b1f152152,64,2803582,3246105,3248268,2806041,2163,444686,442523,0,0,0
3250430,b435dc7c-ffcc-f126-d8f3-9ed368962b35,64,2803582,3248268,3250430,2806267,2162,446848,444686,0,0,0
3252860,ba56012b-a60d-111d-9728-4904cd155008,64,2803584,3250430,3252860,2806811,2430,449276,446846,0,0,0
3255315,8d34162f-68fc-d237-811c-81c9a2b13ac4,64,2806937,3252860,3255315,2809593,2455,448378,445923,0,0,0
3257144,d806e7f9-67c6-8fc9-ac48-5563d55e7400,64,2806938,3255315,3257144,2809945,1829,450206,448377,0,0,0
3257405,5d977a16-dbeb-c54e-f3c5-65cd548871ae,64,2784632,3227543,3257405,2800162,29862,472773,442911,0,0,0
3260497,95bd9eac-2ae4-1c9b-4f6e-670802d7b184,64,2806937,3257405,3260497,2812323,3092,453560,450468,0,0,0
3263145,d0fc126c-4e82-cd70-ac25-7aae214ed0e3,32,2806938,3260497,3263145,2813224,2648,456207,453559,0,0,0
3263639,2d447633-e0b5-2e04-d43a-843cfc9c61e6,32,2806939,3260497,3263639,2812684,3142,456700,453558,0,0,0
3265892,2514ca68-7856-8682-10f6-ccbb0ab9f72e,64,2754338,3231808,3265892,2800751,34084,511554,477470,0,0,0
3269326,6ee2e2d6-413f-8437-57b5-709a1a46bc93,32,2814793,3265892,3269326,2819189,3434,454533,451099,0,0,0
3274282,fa47b897-60b0-8f1c-d584-7b24772333f5,32,2814794,3269326,3274282,2819221,4956,459488,454532,0,0,0
3278579,e5d1da47-edce-fcf6-3ed0-90ff1f92c7f4,64,2720765,3176751,3278579,2792141,101828,557814,455986,0,0,0
3279680,5ed323d6-e24f-d7b8-5c96-4bc36cf9aff3,64,2753862,3242189,3279680,2804900,37491,525818,488327,0,0,0
3285011,f514875c-a21e-fafc-ff49-e3195844e380,32,2784630,3265892,3285011,2814329,19119,500381,481262,0,0,0
3285071,bf005529-25f5-bb7f-7df6-319ae8136e2e,64,2784630,3263145,3285038,2814241,21893,500408,478515,0,0,0
3285556,2d5d5b2b-9c02-7b84-274f-ef136dac10e2,32,2832317,3285071,3285556,2833042,485,453239,452754,0,0,0
3287836,11ac2697-42b2-db4f-0adf-e3cf66e0d74e,64,2826107,3279680,3287836,2830314,8156,461729,453573,0,0,0
3289301,372b5a14-d3aa-55cc-110f-c3d375b580e8,64,2771353,3257144,3289301,2811227,32157,517948,485791,0,0,0
3292203,9ba95c59-249d-f917-6a09-fb2076992d10,64,2826107,3287836,3292203,2834718,4367,466096,461729,0,0,0
3293218,af7f8b1d-54ce-605b-4c09-2e882439a89f,64,2826107,3285011,3293218,2832982,8207,467111,458904,0,0,0
3297405,1aa902a5-f2ab-2051-c6ca-6088addaf64b,64,2826106,3289301,3297405,2835278,8104,471299,463195,0,0,0
3303966,c9c5709f-9b3c-9070-f1a3-134d77e40dd6,64,2800505,3293218,3303966,2837840,10748,503461,492713,0,0,0
3306537,347cc236-14b5-6b25-0ef6-2d3d05f8c31b,64,2784629,3278579,3306537,2823134,27958,521908,493950,0,0,0
3319395,ddf99f87-b4d9-a1a8-3275-4c3a0a2af4e3,64,2833794,3303966,3319395,2849192,15429,485601,470172,0,0,0
3338861,645b21a6-9321-aef1-8def-c2cd44ff00ca,64,2716180,3285556,3338861,2834491,53305,622681,569376,0,0,0
3339557,5d5e1495-312d-02d5-546d-de048b124792,32,2720765,3274282,3339557,2821092,65275,618792,553517,0,0,0
3340494,ba3a548d-fb4d-6472-33c9-e8f31e1f1fb7,64,2720765,3242855,3340494,2805665,97639,619729,522090,0,0,0
3344413,a21ae28b-af98-aa71-c743-78124ee47b02,64,2871528,3338861,3344413,2881485,5552,472885,467333,0,0,0
3351186,4cd3e7a8-2b54-c062-0db1-499ad97f02b4,64,2856536,3319395,3351186,2878252,31791,494650,462859,0,0,0
3362504,3721c57a-13a6-0486-a4a3-0744ebd59d18,64,2523757,3176931,3362504,2793755,185573,838747,653174,0,0,0
3365667,92c451eb-a2b8-65c5-9fc1-0eed24019abe,64,2883595,3362504,3365667,2887939,3163,482072,478909,0,0,0
3371729,4fd74822-1381-427a-8458-d5588f7ff209,64,2883594,3365667,3371729,2888180,6062,488135,482073,0,0,0
3374196,96ca6de4-0e13-7524-90ec-e69431f33af3,64,2887399,3371729,3374196,2889147,2467,486797,484330,0,0,0
3379387,68869693-459a-4785-c53c-bfb2ff430c3e,64,2883595,3374196,3379387,2889350,5191,495792,490601,0,0,0
3383067,2b4723fc-937f-ae81-193e-c69ff262717d,64,2720764,3306537,3383067,2858560,76530,662303,585773,0,0,0
3383555,139969d6-d67d-9ba4-638a-5cdb4be685da,64,2856538,3344413,3383555,2884377,39142,527017,487875,0,0,0
3385504,87b59fb2-6707-5ace-0263-8eeeb11c7a00,64,2856538,3351186,3385504,2886679,34318,528966,494648,0,0,0
3385589,53975925-b957-9a72-90bd-55353f0404c4,64,2883596,3379387,3385589,2891741,6202,501993,495791,0,0,0
3386275,f7f17bcb-f0a6-df72-008f-0656b9e7e4db,64,2883595,3383067,3386275,2892730,3208,502680,499472,0,0,0
3397569,7d7a6321-9979-5f80-bee3-6e20d9f1ea8f,64,2879486,3386275,3397569,2896987,11294,518083,506789,0,0,0
3400044,211cd828-ec0f-3e26-35c3-54a72fb892cd,64,2720764,3292203,3400044,2837823,107841,679280,571439,0,0,0
3404390,e5ddbc1d-d42b-e9c6-5e83-5e3f6041be05,64,2835201,3340494,3404390,2882742,63896,569189,505293,0,0,0
3412060,092b5b60-d050-04a6-c0b4-a713eea82cac,64,2856537,3383555,3412060,2892854,28505,555523,527018,0,0,0
3417230,1975f625-865f-695b-f701-6b664c2c64df,32,2879487,3397569,3417230,2898662,19661,537743,518082,0,0,0
3418373,c0e7e1a7-e84d-82e6-5712-00edc4922fe4,64,2856537,3385589,3418373,2896023,32784,561836,529052,0,0,0
3419863,a45bfdfa-d72f-1f80-10f7-90f67f3a02b2,64,2856540,3385504,3419863,2893986,34359,563323,528964,0,0,0
3422046,137f5fb7-0d56-c2fb-978f-c74499dab8d8,64,2856539,3404390,3422046,2900461,17656,565507,547851,0,0,0
3425649,25abfb65-5dfc-6483-53c3-65404c28647f,64,2856537,3412060,3425649,2900896,13589,569112,555523,0,0,0
3428256,0bb05c94-73ab-0a2f-66be-fa854504fedf,64,2856538,3400044,3428256,2899840,28212,571718,543506,0,0,0
3430139,a674ff88-d39d-328f-6827-7f1e8c9af5b3,64,2856537,3397569,3430139,2898781,32570,573602,541032,0,0,0
3433613,17542536-e346-04aa-abad-c838722f180e,64,2879486,3418373,3433613,2902760,15240,554127,538887,0,0,0
3433673,30274284-3426-e93d-7d09-727d33e9aca0,64,2961647,3430139,3433648,2964869,3509,472001,468492,0,0,0
3437041,37dda186-90d4-faee-6a81-a841e927194f,32,2961648,3433673,3437041,2966931,3368,475393,472025,0,0,0
3437256,549fe456-e485-c017-c942-a8165cb35017,64,2895074,3422046,3437256,2912745,15210,542182,526972,0,0,0
3440744,45fb0dcf-d08d-2a30-ba39-fd6ffbd3bfcb,64,2961646,3433613,3440744,2965634,7131,479098,471967,0,0,0
3441561,b5edda23-9f6a-0010-2531-2620b990d38f,64,2879486,3425649,3441561,2917978,15912,562075,546163,0,0,0
3441841,0265a891-056a-922d-894f-0b0377873bba,64,2961648,3437041,3441841,2967245,4800,480193,475393,0,0,0
3442472,556373c6-4dbf-0f14-9d86-a3dd24bea962,64,2961647,3437256,3442472,2968190,5216,480825,475609,0,0,0
3444738,4dad9bbd-6be2-bcdb-b1ae-cbe1c13540fd,64,2961646,3441561,3444738,2969834,3177,483092,479915,0,0,0
3445111,7617d80d-2943-bf77-ff0f-6b76c89d6f14,64,2961646,3441841,3445111,2969886,3270,483465,480195,0,0,0
3447623,de5da310-2437-3a2c-4a02-bcde3b6b348d,64,2961648,3440744,3447623,2969394,6879,485975,479096,0,0,0
3448000,318d69a9-3d5f-103c-5c59-0351bb802cb8,32,3012832,3447623,3448000,3014311,377,435168,434791,0,0,0
3452750,c05f1eb0-d3b5-8e50-87e1-13efb6267c2c,64,2993805,3444738,3452750,2999964,8012,458945,450933,0,0,0
3452907,a34e0e6e-7288-40a3-b08d-629efd3256d6,32,3035627,3452750,3452907,3036045,157,417280,417123,0,0,0
3453073,7536bee7-f383-8240-db07-affcac57084b,32,3035132,3452907,3453073,3036160,166,417941,417775,0,0,0
3453290,79c21cab-40c7-863d-8a41-7c7e6f6719cf,32,3034863,3453073,3453290,3036268,217,418427,418210,0,0,0
3453455,baf8034c-b4fd-c347-0e16-abcbc654001d,32,3035125,3453290,3453455,3036288,165,418330,418165,0,0,0
3453586,0b2c7790-9e19-5755-5d2e-7eec15de2c3b,64,2879486,3428256,3453586,2922243,25330,574100,548770,0,0,0
3453646,cb178f8a-0f59-4c1a-e657-7578a1fa03a3,32,3035793,3453455,3453627,3036451,172,417834,417662,0,0,0
3453883,a14f33be-3d96-7c33-cc32-80b006057709,64,3035851,3453586,3453883,3036456,297,418032,417735,0,0,0
3454135,66fca497-dba7-a305-583d-9255143ba1cc,64,3039895,3453646,3454135,3040778,489,414240,413751,0,0,0
3455648,3f9e7619-d0a9-aeac-a2d0-4968846eae8f,32,3039893,3454135,3455648,3041981,1513,415755,414242,0,0,0
3456116,99837629-e3e0-26d8-e67d-6a76e8325744,64,3039888,3453883,3456116,3041423,2233,416228,413995,0,0,0
3458970,43f7e062-e621-a526-4c64-b6bae31ca474,64,2552902,3297405,3458970,2840025,161565,906068,744503,0,0,0
3459405,af8287db-9d69-2daa-2d91-cb746937349c,64,3039886,3455648,3459405,3043931,3757,419519,415762,0,0,0
3459465,42470e00-72b9-0548-8ef5-620b01b439c6,64,3039891,3456116,3459438,3045060,3322,419547,416225,0,0,0
3463816,6eba98df-f435-85c5-ed3b-038385d5164f,64,2979618,3448000,3463816,3016630,15816,484198,468382,0,0,0
3464724,c054265d-d6a0-e170-da02-1d48bf4ec27d,32,3039899,3458970,3464724,3047330,5754,424825,419071,0,0,0
3465277,43171bfa-f1c1-086c-2fb6-e78383c159ac,32,2835202,3425649,3465277,2913584,39628,630075,590447,0,0,0
3465449,e6a5a353-bbd7-6c95-1faf-ff4cac0f0b1b,64,2424493,3148109,3465449,2788936,317340,1040956,723616,0,0,0
3467024,91f10c5f-7f96-32f6-f1f7-0daf30daf217,64,3039901,3459405,3467024,3049481,7619,427123,419504,0,0,0
3469343,d00fff50-9f87-8bc4-067b-f431380e2ccb,64,2961988,3442472,3469343,2999251,26871,507355,480484,0,0,0
3471785,80904dc8-d60c-2570-f946-c8ffd9fd157b,64,2993749,3445111,3471785,3006556,26674,478036,451362,0,0,0
3476250,b1e50b92-0081-895a-e9f4-c626357f5765,64,3039888,3463816,3476250,3050273,12434,436362,423928,0,0,0
3479451,73d312f6-e445-f322-a5e5-764ff5f3494c,64,3039867,3459465,3479451,3049689,19986,439584,419598,0,0,0
3482997,f937fecd-5b96-cb75-fb9e-c20f9c8786d1,64,3039878,3464724,3482997,3052291,18273,443119,424846,0,0,0
3483057,4b11c3bc-d4cf-4e60-5e77-fe41f5683579,64,3039874,3467024,3483056,3052746,16032,443182,427150,0,0,0
3483418,733edde4-c576-6506-6a44-83cea9143f18,64,3039867,3471785,3483418,3054277,11633,443551,431918,0,0,0
3484263,83d64725-0515-8c96-c952-e29183d2b28e,64,3039889,3465449,3484263,3052382,18814,444374,425560,0,0,0
3484395,5768ca2f-b7cb-2ce8-40f6-7383af801bb4,64,3039876,3469343,3484395,3053901,15052,444519,429467,0,0,0
3493167,f33db7cf-80d4-2e54-3a91-657c57c18680,64,3039867,3483418,3493167,3059636,9749,453300,443551,0,0,0
3496000,96ffd9a7-708b-af8a-9411-32a41c13f2e7,64,3039898,3482997,3496000,3058667,13003,456102,443099,0,0,0
3496620,de6af8b3-0e93-e787-ae93-cd309e8e458e,32,3039875,3479451,3496620,3056822,17169,456745,439576,0,0,0
3504267,b5e95fe6-0853-d664-a43a-3e389f293945,64,3039871,3479451,3504267,3058518,24816,464396,439580,0,0,0
3506563,33aed384-8512-4861-c2bf-73866c922161,64,3039887,3483057,3506563,3058745,23506,466676,443170,0,0,0
3506816,b0ec919f-99bc-1a56-3cb5-ed092bf24e83,64,3039879,3484263,3506816,3059812,22553,466937,444384,0,0,0
3508786,36d0340e-8715-6751-5a98-a51aeeccb80a,64,3039902,3476250,3508786,3056541,32536,468884,436348,0,0,0
3510976,c985a48b-5918-41c9-4018-68fa4f5e403c,64,3039879,3496000,3510976,3060634,14976,471097,456121,0,0,0
3517868,00dbea14-13a2-4bde-33ad-a4f2453591de,64,3039896,3506563,3517868,3066258,11305,477972,466667,0,0,0
3519727,857eaa97-7c97-34db-9607-b8a0627081aa,64,3039869,3484395,3519727,3059824,35332,479858,444526,0,0,0
3520104,d945fd1a-fec2-1522-1e95-995f344a004b,64,3039879,3493167,3520104,3060606,26937,480225,453288,0,0,0
3524363,95265676-d903-3297-13b2-b8afb1277ab3,64,3039882,3504267,3524363,3061110,20096,484481,464385,0,0,0
3525292,eea24f96-6db1-7513-7b83-55e9f8a35dd7,64,3039884,3508786,3525292,3071089,16506,485408,468902,0,0,0
3535287,2878e868-e02d-60d6-540b-afd0ca68e4f0,64,3039882,3510976,3535287,3072427,24311,495405,471094,0,0,0
3536217,18fc5bff-e84a-41b7-a24f-f6d59fb6281b,64,3039902,3506816,3536217,3070481,29401,496315,466914,0,0,0
3545760,bf93ece6-e261-cd1e-c889-a301ba5eb250,64,3039885,3517868,3545760,3076190,27892,505875,477983,0,0,0
3545880,46ac9a6e-b469-72b5-41d7-d788ed0651af,64,3104123,3545760,3545858,3104653,98,441735,441637,0,0,0
3545942,1c66c329-5876-30c7-8f33-5233be2c88bc,64,3103897,3545880,3545942,3104957,62,442045,441983,0,0,0
3546055,d31740a5-179e-4b03-bc25-797e6a05be46,64,3104341,3545942,3546055,3105149,113,441714,441601,0,0,0
3546147,15bc3f2d-f5c4-47b2-9828-1f9c97f51447,64,3105970,3546055,3546147,3106394,92,440177,440085,0,0,0
3546361,391d9571-11fd-818c-d656-5b10cbfdc1ac,64,3106221,3546147,3546361,3106943,214,440140,439926,0,0,0
3546421,0ad064e0-fa86-8117-983a-be78693c1c55,64,3106467,3546361,3546412,3107023,51,439945,439894,0,0,0
3548721,c4b179b8-7d75-a12b-96b3-80cc386a6c49,64,3039878,3520104,3548721,3080771,28617,508843,480226,0,0,0
3558452,093ce3df-8c16-ed1e-9e29-561643016101,64,3054651,3536217,3558452,3092379,22235,503801,481566,0,0,0
3565646,88e8e1a0-a3d2-af96-381d-979411a0dd24,64,3039884,3525292,3565646,3082923,40354,525762,485408,0,0,0
3568504,98653bd4-d978-ad95-6fac-6d2306f1862c,64,3039895,3519727,3568504,3077212,48777,528609,479832,0,0,0
3576516,84129bef-6eed-b15e-e54f-af225419aae0,64,3035356,3535287,3576516,3085522,41229,541160,499931,0,0,0
3576653,94f2f401-7d66-94b4-503e-14aa3f3b5126,64,3130159,3576516,3576653,3130646,137,446494,446357,0,0,0
3576790,b029447a-e5b4-cac4-030f-bed7b24aa14d,64,3130608,3576653,3576790,3131341,137,446182,446045,0,0,0
3576850,ebe1e6bd-7698-a6fe-a55f-230be75fb954,64,3130382,3576790,3576841,3131525,51,446459,446408,0,0,0
3579216,b9cbe58b-5362-cea2-3ff7-33ab527d3f17,64,3039895,3524363,3579216,3082776,54853,539321,484468,0,0,0
3586262,9514476b-ef55-7420-6036-14d3347bc168,64,3054877,3558452,3586262,3122994,27810,531385,503575,0,0,0
3586355,6f6ea2ec-f05e-fc5d-05a6-701c78dfeae2,64,3062412,3548721,3586355,3121043,37634,523943,486309,0,0,0
3586585,b241848e-c48c-0240-dae2-1ef6a152bc85,64,3140922,3586262,3586585,3141564,323,445663,445340,0,0,0
3586722,7a10ecf7-5d32-82f1-9337-b7fe1152b257,64,3141391,3586355,3586722,3141963,367,445331,444964,0,0,0
3586898,2e6ebf2b-408a-b81d-b447-2d32c1dd7b9c,64,3141150,3586722,3586898,3142546,176,445748,445572,0,0,0
3634107,0174a07f-197c-c035-c1ce-2dee5ca50379,64,3039894,3565646,3634107,3129631,68461,594213,525752,0,0,0
3643818,5627645e-fdc9-5c41-3173-4dca2fb17027,64,3039872,3576850,3643818,3134329,66968,603946,536978,0,0,0
3647408,3a538294-e03a-6cd8-55ef-913077b2afa6,64,3061238,3579216,3647408,3135996,68192,586170,517978,0,0,0
3664136,8725a06a-5bc5-2609-dfec-ae6070de10f5,64,3039867,3568504,3664136,3130019,95632,624269,528637,0,0,0
3667057,78ef4ad7-984c-f7f5-ef4b-d178ed576edd,64,3039870,3586585,3667057,3142116,80472,627187,546715,0,0,0
3674153,0e232341-d397-1d36-250d-59d189b4dbc0,64,3187856,3664136,3674153,3194378,10017,486297,476280,0,0,0
3676967,79bcc938-efe8-ed94-67a6-871dd122d40b,64,3039875,3586898,3676967,3144550,90069,637092,547023,0,0,0
3678582,7369f074-9c80-f7d5-87df-c5b12fdc1900,64,3187849,3667057,3678582,3194431,11525,490733,479208,0,0,0
3680790,813cd0ea-7f26-a239-0dd4-472134adeae8,64,3187866,3676967,3680790,3194993,3823,492924,489101,0,0,0
3687011,b93ba1c4-1516-a9f0-b6a5-19cd4e23a74a,64,3187863,3678582,3687011,3195320,8429,499148,490719,0,0,0
3688709,c995b41b-562e-db89-44cb-f2deafaf9dab,64,3187853,3674153,3688709,3194520,14556,500856,486300,0,0,0
3693882,3a54832c-821e-bcbb-b22e-c8a18343b3a3,64,3187854,3687011,3693882,3195586,6871,506028,499157,0,0,0
3695853,ef323e3e-0fa9-f9f8-a84c-c34d8fbc0388,64,3187846,3680790,3695853,3195526,15063,508007,492944,0,0,0
3696948,11b9f9f9-65cf-46e5-434d-83fe2058fd24,32,3187860,3688709,3696948,3195780,8239,509088,500849,0,0,0
3698857,cf72ee86-8e85-d415-7ff0-0009d553b1fb,64,3187860,3693882,3698857,3196456,4975,510997,506022,0,0,0
3704075,8503fc26-7cfb-7370-6e6b-75cd24ffa5f6,64,2799938,3546421,3704075,3108180,157654,904137,746483,0,0,0
3705505,b074dba9-a443-3c87-9ff8-05c5ac6bbaf7,64,3187847,3698857,3705454,3196794,6597,517607,511010,0,0,0
3708018,0d322337-3dd0-7e68-edfa-0cde910bc36b,64,3187866,3704075,3708018,3197202,3943,520152,516209,0,0,0
3708131,857da90d-f9e1-c9ee-0848-282c3035ebf4,64,3187863,3695853,3708131,3196671,12278,520268,507990,0,0,0
3714718,b6d166cd-0726-b291-c916-45ab9a8c8a39,64,3039867,3634107,3714718,3156065,80611,674851,594240,0,0,0
3718170,f14b8d7c-f6d7-09ce-c39b-3a9f2eb6fd39,64,3187856,3705505,3718170,3197564,12665,530314,517649,0,0,0
3718693,aebe7fc4-e250-7b50-4f21-969b61525d0b,64,3187853,3708018,3718693,3198968,10675,530840,520165,0,0,0
3721552,cf01c834-fbe1-4500-52a9-4174e9017ed1,64,3187850,3708131,3721552,3199011,13421,533702,520281,0,0,0
3729374,7135c7d1-a489-f872-9be3-13d0d5a087f2,64,3187850,3714718,3729374,3200669,14656,541524,526868,0,0,0
3729684,a3d9b386-d14c-ec16-bf36-5ea0d8a12230,64,3096554,3647408,3729684,3181290,82276,633130,550854,0,0,0
3733608,ea651d60-237a-9f32-5250-342759ef1808,64,3187846,3718693,3733608,3201810,14915,545762,530847,0,0,0
3734479,f516470f-2548-a2e0-86bb-0c437bae78c2,64,3187861,3721552,3734479,3202763,12927,546618,533691,0,0,0
3741355,8bfda0a5-6415-b551-dc9d-4546468dc50b,64,3187857,3729374,3741355,3203245,11981,553498,541517,0,0,0
3742129,8d3375de-716f-8b0b-3b1d-31cf79a70839,64,3187859,3729684,3742129,3203733,12445,554270,541825,0,0,0
3748601,4e34ee0d-f118-6e7a-733f-1a6f69a10d9a,64,3187845,3733608,3748601,3204394,14993,560756,545763,0,0,0
3750005,59710f84-7cfa-63d3-68e4-c9d9fdc9b4cf,64,3187848,3742129,3750005,3208572,7876,562157,554281,0,0,0
3750525,bfafab87-fea1-7af7-17d8-183856c5bca9,64,3187859,3734479,3750525,3207680,16046,562666,546620,0,0,0
3753776,42454dc2-fc00-319b-bfc8-df9298535c12,64,3300194,3750525,3753776,3303904,3251,453582,450331,0,0,0
3757433,6eb9e6fd-d8e2-35ca-4a67-13257e7e5c46,32,3300194,3753776,3757433,3304081,3657,457239,453582,0,0,0
3757811,3e9759ff-4f59-6af1-cb27-97f9df3de471,64,3187846,3741355,3757811,3208075,16456,569965,553509,0,0,0
3757928,f97cbde7-02e1-f7a7-6b35-707d979b190d,64,3300194,3753776,3757928,3304264,4152,457734,453582,0,0,0
3762172,57102df1-b1c4-6890-ba4d-c6bf224ea52f,64,3146591,3688709,3762172,3196124,73463,615581,542118,0,0,0
3762368,86264725-faa5-05f1-ebe7-9f89869e7a40,64,3304475,3757928,3762368,3312786,4440,457893,453453,0,0,0
3764424,9126f62b-2a45-fea3-7b87-461754d3ca1c,64,2424965,3419863,3764424,2907700,344561,1339459,994898,0,0,0
3764484,46854b19-d91c-97e3-2a8a-c10a4f820dba,64,3304477,3757811,3764447,3312179,6636,459970,453334,0,0,0
3770599,18672c82-82bd-0592-c89d-1e2a5fde8341,64,3304475,3762172,3770599,3314146,8427,466124,457697,0,0,0
3770807,845e895c-82d4-409b-cda2-67b788cd7f72,64,3304476,3762368,3770807,3314898,8439,466331,457892,0,0,0
3772423,df0e8915-41f1-1885-022f-83bbd3189d91,64,3330628,3770807,3772423,3331893,1616,441795,440179,0,0,0
3773034,15559eac-af20-c337-37cf-5f54180e2f0f,64,3304475,3764424,3773034,3315032,8610,468559,459949,0,0,0
3773156,7f855109-bbb4-0475-5282-5972625916c1,64,3330627,3772423,3773156,3331909,733,442529,441796,0,0,0
3774845,6ded6c2c-c613-9421-46a8-5628628da4f0,64,3330628,3773156,3774845,3333446,1689,444217,442528,0,0,0
3775161,712889fa-a94f-232a-5da1-d0384d11072f,64,3330627,3773034,3775161,3332888,2127,444534,442407,0,0,0
3778527,ade68538-1903-414e-9ea9-6ab521a5494d,64,3322502,3770599,3778527,3331097,7928,456025,448097,0,0,0
3785913,e7f17a32-ca3b-8919-dbad-d040ba2f9fbe,64,3329633,3778527,3785913,3344077,7386,456280,448894,0,0,0
3786094,ab228e9d-85e4-5a02-f72d-9ecf019796aa,32,3360375,3785913,3786094,3361853,181,425719,425538,0,0,0
3786154,e4d13a9c-4f05-ce3f-6a81-ef1d7f29a69e,32,3360111,3785913,3786126,3361131,213,426015,425802,0,0,0
3786530,d7b63729-125e-5b84-c53c-cc37a5a3f084,64,3360611,3786094,3786530,3362014,436,425919,425483,0,0,0
3787369,b0e69247-7c99-af92-a14d-e07d04a9c38c,64,3139440,3718170,3787369,3201129,69199,647929,578730,0,0,0
3787540,4bc09d07-df89-7d00-fd62-f4b97584330a,64,3362196,3787369,3787540,3362747,171,425344,425173,0,0,0
3787756,1e2215a9-f85f-549c-fd5a-4c3e403d9518,64,3362420,3787540,3787756,3363478,216,425336,425120,0,0,0
3788120,500cde27-4d3d-8d9c-7304-926dc231adad,64,3362647,3787756,3788120,3363874,364,425473,425109,0,0,0
3790779,89f9b992-118b-2ac4-81ee-f5e1bd949400,64,3315650,3774845,3790779,3338237,15934,475129,459195,0,0,0
3792595,808cef2f-85a4-9dd0-58bd-9674f9c18f3f,64,3210301,3750005,3792595,3272482,42590,582294,539704,0,0,0
3800219,f9329f7d-16d9-f8a4-e10d-c27d3a84311e,64,3329026,3775161,3800219,3341828,25058,471193,446135,0,0,0
3800752,aff2a9a6-8d5d-135f-c4f4-abf423264160,64,3388129,3800219,3800752,3388491,533,412623,412090,0,0,0
3801070,7a9e3e4e-254e-fd58-215d-7b3b292e324f,64,3388126,3800752,3801070,3388631,318,412944,412626,0,0,0
3801674,66024a18-798d-6acf-a020-72ff572bfeea,64,3388131,3801070,3801674,3388930,604,413543,412939,0,0,0
3801997,205c33a9-118d-ea23-2be2-0e0e88197a7d,64,3394406,3801674,3801997,3394964,323,407591,407268,0,0,0
3802316,2d2bacc7-b992-8653-7c59-6f036eda748e,64,3394409,3801997,3802316,3395107,319,407907,407588,0,0,0
3802716,24bf8efe-db91-ad58-e7a8-5c8f902680c2,64,3394406,3802316,3802716,3395198,400,408310,407910,0,0,0
3810955,54352af4-648f-c93a-af56-2d4abbe68747,64,3288334,3764484,3810955,3325662,46471,522621,476150,0,0,0
3811190,e90bc562-0cae-2826-d28c-cb496cf26c80,64,3423145,3810955,3811190,3423463,235,388045,387810,0,0,0
3811877,25c6dc8a-4298-8746-c96b-cd8b68d24a62,64,3423149,3811190,3811877,3423588,687,388728,388041,0,0,0
3812277,71ef5f95-eb93-6354-9274-c058431e0390,64,3423146,3811877,3812277,3423796,400,389131,388731,0,0,0
3812595,274a68bb-b964-cb59-0b5b-2dd5c74a56fb,64,3423145,3812277,3812595,3423981,318,389450,389132,0,0,0
3812858,74a36f5b-80f0-0348-e7c6-ab322aa3cf39,64,3449628,3812595,3812858,3450206,263,363230,362967,0,0,0
3812918,72061d39-1a4c-a283-a067-87d0a13b7a72,64,3449852,3812858,3812909,3450570,51,363057,363006,0,0,0
3813226,0caf3e0a-78e6-e8a2-87a4-9552e1bc46a4,64,3450071,3812918,3813226,3451076,308,363155,362847,0,0,0
3813374,f8e0cd5a-e4bc-dfa7-e941-deab7e2b8ac3,32,3475723,3813226,3813374,3476574,148,337651,337503,0,0,0
3813434,07276bdb-b8e7-7e1a-048a-c2aad707a313,32,3475473,3813226,3813393,3475967,167,337920,337753,0,0,0
3813494,cd78f4b6-7164-07b5-081f-e74313d2ac38,64,3475955,3813374,3813478,3476811,104,337523,337419,0,0,0
3815776,72be8f53-5d48-f4d8-f66b-72ae5af97c9e,64,3389127,3802716,3815776,3398673,13060,426649,413589,0,0,0
3821292,7ed30b72-6323-12d2-b051-d6ccff908122,64,3323432,3786530,3821292,3362668,34762,497860,463098,0,0,0
3821826,d478f8ac-c2bd-9ea1-8562-a95b1eb57f17,64,3480186,3813494,3821826,3484347,8332,341640,333308,0,0,0
3823210,7053b15b-bf18-2031-0f8e-a1f1508e9555,64,3480187,3815776,3823210,3484585,7434,343023,335589,0,0,0
3823426,a55ecb4e-a535-1789-f501-d54e94e17cc6,32,3493572,3823210,3823426,3494388,216,329854,329638,0,0,0
3824871,10c469e3-8027-ea01-dbff-671c24d9a6d7,64,3480186,3821826,3824871,3487347,3045,344685,341640,0,0,0
3825362,110995e9-640d-de5c-ce55-b826b50298b6,64,3328489,3788120,3825362,3380197,37242,496873,459631,0,0,0
3825509,bf99806c-a517-1401-d421-fa8b551361aa,64,3480187,3821292,3825509,3485087,4217,345322,341105,0,0,0
3826412,f3bf1b07-874b-d729-e161-a8df81f49b87,64,3508104,3823426,3826412,3509772,2986,318308,315322,0,0,0
3827888,7ee8f866-6bb3-6df2-90a1-8d9b83a35a85,64,3508105,3825509,3827888,3511506,2379,319783,317404,0,0,0
3828558,3c9f87e3-1586-0cdb-b094-114dff319c50,32,3480186,3823210,3828558,3488818,5348,348372,343024,0,0,0
3828785,3f4e8727-b310-e4a3-392f-da2e373f7f11,64,3508134,3824871,3828785,3510825,3914,320651,316737,0,0,0
3829181,b89261a8-9c68-46b7-4f31-308debad7b18,64,3508104,3825362,3829181,3510877,3819,321077,317258,0,0,0
3830143,0e20629f-2022-634f-a910-6253afefcc5a,64,3508104,3826412,3830143,3511795,3731,322039,318308,0,0,0
3831884,25e39ea9-07b5-9fd2-a3ad-5f1a19934fdf,64,3329133,3792595,3831884,3383202,39289,502751,463462,0,0,0
3831977,c72ffa73-e1d5-8ac7-0f92-c40c7c6d0687,64,3530510,3831884,3831977,3531543,93,301467,301374,0,0,0
3832135,e0279161-fd0b-722b-4047-98e908e46668,64,3508105,3828785,3832135,3512502,3350,324030,320680,0,0,0
3832195,8595dda3-8f51-1b7c-d049-a88be6eaf5d2,64,3530878,3831977,3832141,3531623,164,301263,301099,0,0,0
3832317,3a72defd-6cb2-9bca-66df-ce01a3dec17a,64,3530729,3832135,3832317,3531708,182,301588,301406,0,0,0
3832399,5fabb9a9-0713-078b-1c0e-dab37c2712b8,64,3534666,3832317,3832399,3535111,82,297733,297651,0,0,0
3832492,aec168fa-4ba8-bde0-d372-be776add0f92,64,3535174,3832399,3832492,3535577,93,297318,297225,0,0,0
3832552,893f77c7-857d-5b11-df93-591a22eac88b,64,3530986,3832195,3832548,3531927,353,301562,301209,0,0,0
3832901,580f87fe-c282-2d2a-3dc6-1fb6416a3371,64,3534889,3832552,3832901,3535913,349,298012,297663,0,0,0
3832961,695e15d8-a5aa-338b-d3b7-875bf6c0efba,64,3535026,3832492,3832924,3535815,432,297898,297466,0,0,0
3833094,eee887e4-073c-3b39-c393-5dbea7ebccce,64,3538331,3832961,3833094,3538697,133,294763,294630,0,0,0
3833154,0d00c96f-1f99-4e9c-8ea2-5b2d1f6c1bef,64,3537996,3832901,3833115,3538607,214,295119,294905,0,0,0
3833214,34e96bca-6cfa-b818-d6c7-39faa4a3a630,64,3514559,3829181,3833172,3517335,3991,318613,314622,0,0,0
3833214,83d4440d-34fb-03b3-ab14-e5263d7d7b2f,64,3538217,3833094,3833190,3538882,96,294973,294877,0,0,0
3833320,2f611f36-86c4-3d87-6d40-f72fc55ad23f,64,3538444,3833154,3833320,3538932,166,294876,294710,0,0,0
3833470,90868ed9-76b0-bf1a-7c5e-4627ca74b799,64,3545689,3833214,3833470,3546437,256,287781,287525,0,0,0
3833567,b6c4564a-5501-4fb5-2eeb-39d68b767a94,64,3545352,3833214,3833567,3546093,353,288215,287862,0,0,0
3833627,e50a1e54-2991-1bdd-9686-bb83634093f9,64,3545575,3833320,3833611,3546586,291,288036,287745,0,0,0
3833735,5d8739aa-79c0-2999-0bb5-c47e48c503fd,64,3548874,3833567,3833735,3549523,168,284861,284693,0,0,0
3833810,08baea08-df6d-2da3-dd84-0a88a586e69c,32,3549318,3833627,3833810,3549861,183,284492,284309,0,0,0
3833877,677035ca-b968-e2ff-c04e-6adc0f9c933b,64,3551713,3833735,3833877,3552224,142,282164,282022,0,0,0
3833956,0e5a1e40-c298-4b7a-31d7-669ed72f669a,64,3545802,3833470,3833956,3547152,486,288154,287668,0,0,0
3834047,d050a38a-5481-0632-8df2-4a5af1b256d0,32,3551937,3833877,3834047,3552837,170,282110,281940,0,0,0
3834137,b03e2943-916d-9cca-755d-7bff246ce79b,64,3549095,3833627,3834137,3550120,510,285042,284532,0,0,0
3834197,5025761c-e029-7f5d-f46d-39c93a301530,64,3552177,3833877,3834169,3553296,292,281992,281700,0,0,0
3834257,0b14dc28-271a-c10c-b005-ebff5741a155,64,3556068,3834137,3834209,3556745,72,278141,278069,0,0,0
3834257,88653f9f-0a4f-b3a8-ab64-0b50d5bed4f6,64,3329079,3790779,3834214,3381381,43435,505135,461700,0,0,0
3834317,b44a8c33-61a5-e9ec-417d-76dd1f4cd5b2,64,3555726,3834197,3834295,3556801,98,278569,278471,0,0,0
3834377,d65cf074-e31a-7153-ed2c-56bb508fd69e,32,3556193,3834197,3834371,3556789,174,278178,278004,0,0,0
3834465,80effb52-38c4-fe4a-f4fd-872de10f027f,64,3555954,3834257,3834465,3556968,208,278511,278303,0,0,0
3834540,ef80afad-d1a6-2e7a-69b0-4a13a5895a9b,64,3559049,3834317,3834540,3559916,223,275491,275268,0,0,0
3834600,fc4c1a7c-471b-3499-68b3-8ddcaff861e4,64,3558936,3834465,3834547,3559928,82,275611,275529,0,0,0
3834660,f7b567fc-334d-ecab-ec2a-78e1774d26bc,64,3559409,3834540,3834623,3559957,83,275214,275131,0,0,0
3834720,0339a5f9-1aeb-066e-aca9-f58c47051139,64,3559172,3834600,3834691,3560119,91,275519,275428,0,0,0
3838491,28daa155-12dc-746f-f9de-5e8c7ee797b3,64,3559204,3834660,3838491,3561281,3831,279287,275456,0,0,0
3841036,5ef980b7-8303-7d6d-0009-8a0a19dc1dc9,64,3563090,3838491,3841036,3566787,2545,277946,275401,0,0,0
3844838,bdc9b602-6776-1eb8-af31-0c0840382092,64,3562847,3841036,3844838,3567190,3802,281991,278189,0,0,0
3847720,17fd5485-3b8c-2fb2-19a4-494d5d2c3098,32,3566749,3844838,3847720,3570469,2882,280971,278089,0,0,0
3848022,cbca3c49-abe4-4f06-0272-a0f739a8e0bd,64,3574925,3844838,3848022,3576683,3184,273097,269913,0,0,0
3852228,4161d1b4-321e-50ab-d153-f754208ee09c,64,3574590,3848022,3852228,3582847,4206,277638,273432,0,0,0
3858593,61983f51-f022-6bce-58aa-240e4094d309,64,3574274,3852228,3858593,3583572,6365,284319,277954,0,0,0
3858916,fb2e358c-6ff4-7bb8-997c-b8d22ba9eee7,64,3584117,3858593,3858916,3584631,323,274799,274476,0,0,0
3859590,df1fe433-23a7-dcef-9172-300d5eaaae6d,64,3584966,3858916,3859590,3585321,674,274624,273950,0,0,0
3860299,139c83e9-08fd-ea91-428d-dadba9db336c,64,3584965,3859590,3860299,3585529,709,275334,274625,0,0,0
3861022,ec88f373-37c8-07ff-9631-13d608158818,64,3584964,3860299,3861022,3585561,723,276058,275335,0,0,0
3861437,2b95b846-1fb4-e090-94e5-ffac2544f255,64,3584963,3861022,3861437,3585603,415,276474,276059,0,0,0
3861655,54fd1c59-742e-3069-0457-7fb8e539aae8,64,3471032,3830143,3861655,3530927,31512,390623,359111,0,0,0
3862065,3d98f9a4-f454-cbfb-9aeb-011b48c495d1,64,3584964,3861437,3862065,3585674,628,277101,276473,0,0,0
3862293,3f81d4e7-da4d-a558-5d3c-c50618d50162,64,3584964,3861655,3862293,3585915,638,277329,276691,0,0,0
3862407,f31c1c24-40c0-9894-a68a-4282835288a4,64,3587309,3862065,3862407,3587819,342,275098,274756,0,0,0
3862647,2ba180e8-8482-2c0a-a3dc-719571f95eab,64,3587311,3862407,3862647,3587908,240,275336,275096,0,0,0
3863028,f7257825-e8ff-2991-7555-de6ec7020a01,64,3587309,3862293,3863028,3587838,735,275719,274984,0,0,0
3863142,fbac94bd-f39e-a0f2-3f85-59c79f4463a0,64,3587310,3862647,3863142,3587946,495,275832,275337,0,0,0
3863446,142825b2-ac30-9d0a-b244-62d2c016f7ee,32,3587309,3863028,3863446,3588213,418,276137,275719,0,0,0
3864392,62568c20-8fb1-0eed-da32-2f3ca6ddebc4,64,3494301,3827888,3864392,3512395,36504,370091,333587,0,0,0
3865083,5831da28-dae4-e4a9-1ec9-5c5b7d0e01f4,32,3602873,3863142,3865083,3606793,1941,262210,260269,0,0,0
3866892,8a125374-830a-3ba8-a238-cc385e024fa4,64,3596750,3863028,3866892,3601485,3864,270142,266278,0,0,0
3867255,36f0ef02-774e-2fb1-3af0-ff695ea6f62e,32,3613268,3866892,3867255,3614032,363,253987,253624,0,0,0
3867670,1bf60c6e-e839-c8f6-61ca-71ad2cce4996,32,3604677,3864392,3867670,3608809,3278,262993,259715,0,0,0
3867901,b33d6beb-15cb-da0f-86b4-76acc87db458,64,3618116,3867255,3867901,3618683,646,249785,249139,0,0,0
3869337,9becc679-8f06-cbf7-f471-e8d36d8b2c5f,64,3608688,3865083,3869337,3610993,4254,260649,256395,0,0,0
3872454,c49735bf-0f65-97f7-f63e-2f02921027ef,64,3616445,3867901,3872454,3618883,4553,256009,251456,0,0,0
3874971,d4fcc901-3a39-2c0f-b4b8-5a2b362406fa,32,3646220,3872454,3874971,3649127,2517,228751,226234,0,0,0
3875342,a57cb3d1-9989-456f-a143-5b48924bba7e,32,3646908,3872454,3875342,3648581,2888,228434,225546,0,0,0
3878749,2828e6a8-92d3-04b6-d8c4-72720534d2a8,64,3646221,3874971,3878749,3649307,3778,232528,228750,0,0,0
3881750,c3213e66-55d1-888b-34b0-30321f55321b,64,3646222,3878749,3881750,3649594,3001,235528,232527,0,0,0
3883727,bb00b7c8-b00a-a371-697a-09ea59cc3465,64,3505212,3834257,3883727,3556830,49470,378515,329045,0,0,0
3884299,943e3548-d8e9-9aa6-a41c-6ed486441478,64,3649905,3883727,3884299,3650247,572,234394,233822,0,0,0
3884882,fd854fa2-eb8c-fc85-db13-5ce8dec8551f,64,3647977,3881750,3884882,3649725,3132,236905,233773,0,0,0
3886279,ae11a2d4-d1f2-6a34-ebc3-406023f969f2,64,3646910,3884299,3886279,3650468,1980,239369,237389,0,0,0
3887763,b8ec8273-c1ea-d204-83f1-0a09610af755,32,3648350,3884882,3887763,3650554,2881,239413,236532,0,0,0
3887823,dd61e0f9-aa36-ac97-6475-0b11d49c5df4,32,3647976,3884882,3887808,3650556,2926,239832,236906,0,0,0
3889646,161b45a8-8ae0-6c7a-0a0d-e2ebfc3ef5b9,64,3646909,3886279,3889646,3650571,3367,242737,239370,0,0,0
3891063,bf00b1e0-fedc-11f2-7ba1-22a07612e42b,64,3646221,3887763,3891063,3650673,3300,244842,241542,0,0,0
3893043,a1aa9a6d-d81d-255f-575d-49341d8e47b8,64,3648861,3891063,3893043,3650736,1980,244182,242202,0,0,0
3893370,4a58d20e-035d-855b-6850-17c604933fbd,64,3648862,3889646,3893370,3650677,3724,244508,240784,0,0,0
3895670,3b61c1d9-604c-50c3-bbdb-4036443e61a2,64,3646909,3893043,3895670,3650882,2627,248761,246134,0,0,0
3896280,05f547ba-9e1b-e230-c73d-1dcde0fa1a0d,32,3648550,3893370,3896280,3651024,2910,247730,244820,0,0,0
3896606,5ec5892d-bf61-c8f0-049b-e379af76fd36,64,3648547,3893370,3896606,3651546,3236,248059,244823,0,0,0
3899038,391d39d4-8a37-5205-a6f8-4523163bfb8f,64,3648548,3895670,3899038,3651922,3368,250490,247122,0,0,0
3899704,d6462d44-5d7a-cc37-a12b-1c11e54532d1,64,3647836,3896606,3899704,3652323,3098,251868,248770,0,0,0
3902853,5ef0d853-9ebd-f552-9ded-2282dd8b99ad,64,3647975,3899038,3902853,3652430,3815,254878,251063,0,0,0
3902925,83377469-7e54-e719-ce75-bf1014139aa8,64,3465901,3834720,3902925,3564847,68205,437024,368819,0,0,0
3903100,f07167be-b057-64ac-e6f4-3debdc009158,64,3648861,3899704,3903100,3652482,3396,254239,250843,0,0,0
3906704,10593602-b47f-e245-edff-75792ec694f6,64,3648862,3902853,3906704,3653345,3851,257842,253991,0,0,0
3910604,bdab28e0-92e6-75ff-2e26-f1ace6da6b46,64,3676345,3906704,3910604,3678465,3900,234259,230359,0,0,0
3914786,ac85ed4b-9d0a-717d-acd3-e0947c5d3ac4,64,3505256,3833956,3914786,3554385,80830,409530,328700,0,0,0
3915471,0c0833f2-7099-c082-0c48-a342f8a35ed8,64,3677398,3910604,3915471,3679787,4867,238073,233206,0,0,0
3916027,a2832988-08d9-4d08-9971-c025f028f993,64,3650747,3903100,3916027,3659302,12927,265280,252353,0,0,0
3917491,483f88b7-6d72-75c3-fb90-611386e031e7,64,3678255,3914786,3917491,3680958,2705,239236,236531,0,0,0
3917980,750d98b9-b8b4-748e-4c6c-3bd6cb7028ee,64,3678031,3915471,3917980,3681209,2509,239949,237440,0,0,0
3920132,2227a9b3-22ea-da73-a5ee-68fa7582bcb0,64,3624756,3902925,3920132,3655980,17207,295376,278169,0,0,0
3920192,8e20c39d-7110-2ad6-d2da-fc635240758e,64,3678030,3916027,3920171,3681275,4144,242141,237997,0,0,0
3920582,e0824b23-d64c-06f6-102e-d02eb198aae1,64,2800027,3643818,3920582,3175576,276764,1120555,843791,0,0,0
3920757,1644273a-0719-2436-3632-f0c0714ff1d7,64,3678255,3917491,3920757,3681742,3266,242502,239236,0,0,0
3921528,0aaccf5b-cba2-6317-424d-19ea48748186,64,3678360,3917980,3921528,3682293,3548,243168,239620,0,0,0
3922905,cb4f9770-8252-8bc1-c5ea-ece9ede5c338,64,3678360,3920192,3922905,3682451,2713,244545,241832,0,0,0
3924089,3ecf4897-6575-3163-b0e8-0213c2b533f4,64,3678255,3920757,3924089,3683408,3332,245834,242502,0,0,0
3924216,10c55a1b-f39b-be07-1f23-133d37de78b5,64,3677397,3920132,3924216,3682418,4084,246819,242735,0,0,0
3924318,a9582fca-fa60-7524-3c4e-3df4e0dfafcd,32,3678360,3920757,3924318,3683330,3561,245958,242397,0,0,0
3925562,cb86a0d8-8a6a-1b25-6a5c-456dc6b4ebbd,64,3678032,3921528,3925562,3683607,4034,247530,243496,0,0,0
3925622,d9369308-2f69-d88b-ef5b-740d4fa44ecb,64,3702326,3925562,3925604,3702695,42,223278,223236,0,0,0
3925682,396ef057-1cd9-4b33-4998-023b2b8eedae,64,3677397,3920582,3925676,3682518,5094,248279,243185,0,0,0
3925747,ff83457c-fde6-44af-180a-ec23fc43664e,64,3702880,3925682,3925747,3703563,65,222867,222802,0,0,0
3925983,1f70ed0e-a912-9448-a9e1-de608911e8dd,64,3703345,3925747,3925983,3703733,236,222638,222402,0,0,0
3926242,8f9e795e-095f-dbf2-5f42-00bf8fe3819d,64,3703115,3925983,3926242,3704448,259,223127,222868,0,0,0
3926302,f84beed3-f088-5fa0-527c-52ccf7f8acb9,64,3678254,3922905,3926268,3683903,3363,248014,244651,0,0,0
3926395,997119a8-162f-45ff-5404-465ac7f49955,64,3702576,3926242,3926395,3704687,153,223819,223666,0,0,0
3926455,4bdf3af0-4775-f014-7b36-12f079c2fe52,64,3706007,3926395,3926436,3706387,41,220429,220388,0,0,0
3926541,b543812c-a4b2-747e-b7a9-22a5cd7e6436,64,3705445,3926302,3926541,3706350,239,221096,220857,0,0,0
3926601,1e0c1752-d384-4b98-c81f-9cfe309c43cf,64,3702092,3925622,3926593,3703367,971,224501,223530,0,0,0
3926601,a69fb357-9cf1-5674-9a1e-36cc0a2fd3bb,64,3678360,3924089,3926600,3683963,2511,248240,245729,0,0,0
3926661,5ed8e959-56bd-ea85-9ca6-865991ed007e,64,3705674,3926455,3926606,3706979,151,220932,220781,0,0,0
3926721,ef37a2cd-8593-5429-1e74-2e8ea414bc6a,64,3705215,3926541,3926687,3706991,146,221472,221326,0,0,0
3926781,ed3b08d2-db21-3812-dcde-641fd02535b2,64,3706487,3926601,3926732,3707228,131,220245,220114,0,0,0
3926841,d2d601d5-521e-140f-dba6-45aa9d78ffe0,64,3721874,3926781,3926823,3722785,42,204949,204907,0,0,0
3927079,313161a5-5a15-1fff-52ad-93457c7d8b97,64,3722359,3926841,3927079,3722966,238,204720,204482,0,0,0
3927173,db1731e2-0ff4-cf29-4f10-e8a08b13dd5e,64,3706255,3926601,3927173,3708421,572,220918,220346,0,0,0
3927256,3aacfca3-6fe8-6bb4-7fd2-5d5dd1b6f1fe,64,3721636,3927079,3927256,3723205,177,205620,205443,0,0,0
3927424,b0cc1e5c-534c-8ff1-0471-14eb38f7fe24,64,3722854,3927256,3927424,3723676,168,204570,204402,0,0,0
3927484,9d31dbfe-59c8-097e-32b1-bc1d020e6a2a,64,3722115,3927173,3927439,3723275,266,205324,205058,0,0,0
3927690,4f6f6714-3816-bb69-addc-3496c78ba0c2,64,3724085,3927484,3927690,3724649,206,203605,203399,0,0,0
3927981,b71e8196-c1e8-aceb-a5d3-270cc2f5c149,64,3722595,3927424,3927981,3723846,557,205386,204829,0,0,0
3928090,74809230-f151-2495-f9ea-114d1540ea69,64,3724582,3927981,3928090,3725380,109,203508,203399,0,0,0
3928175,095afe4b-55b4-8912-ff84-4773bf1b5a01,64,3723848,3927690,3928175,3725167,485,204327,203842,0,0,0
3928242,a46faead-3ff7-6d26-fade-884fafea561a,64,3724349,3928090,3928242,3725567,152,203893,203741,0,0,0
3928307,65f7f7c3-0746-7ece-b6d3-573dcc6c7bc2,64,3725050,3928242,3928307,3725753,65,203257,203192,0,0,0
3928467,5f2fea66-ac89-6a12-c117-5223adcdb75b,64,3678030,3924216,3928467,3684099,4251,250437,246186,0,0,0
3928566,166c0589-99e7-c87f-7699-0c195e436d81,64,3724815,3928175,3928566,3725591,391,203751,203360,0,0,0
3942793,3cac2f91-e6be-34ac-234b-70066c6de969,64,3706679,3928467,3942793,3729025,14326,236114,221788,0,0,0
3946295,31328dd6-d3bf-c935-2c49-68ad625f239a,64,3526445,3863446,3946295,3608652,82849,419850,337001,0,0,0
3975050,223556e1-ba82-7d2f-e8df-b52314a7fd2f,64,3055938,3748601,3975050,3235551,226449,919112,692663,0,0,0
3975892,8be7652d-9c57-ae6d-dfee-5f3dc2252f75,64,3669088,3926661,3975892,3710413,49231,306804,257573,0,0,0
3986975,6f827037-2d38-5be1-012b-30ccafe99476,64,3629723,3926721,3986975,3719509,60254,357252,296998,0,0,0
4006228,52c52159-be91-d140-4a74-b5e15da7f4f0,64,3637087,3946295,4006228,3789449,59933,369141,309208,0,0,0
4007267,1ca020d2-18cc-6931-d175-196c5ebe6c65,64,3830878,4006228,4007267,3831699,1039,176389,175350,0,0,0
4007820,e1e218b4-b42f-a4fa-9049-361ef6663e93,64,3830920,4007267,4007820,3831830,553,176900,176347,0,0,0
4008345,92d0471e-ffef-d385-3858-02f1f08ad2ba,64,3715819,3975892,4008345,3800539,32453,292526,260073,0,0,0
4015199,96e1ee24-d631-d1cb-5833-60522b99b45d,64,3715861,3975050,4015199,3796467,40149,299338,259189,0,0,0
4016257,63ca7157-ab2a-b4d1-acad-4c0803429bdd,64,3830795,4008345,4016257,3847648,7912,185462,177550,0,0,0
4019221,8029ccbd-d920-a6f6-4a35-a78b9b4a6594,64,3830843,4007820,4019221,3837382,11401,188378,176977,0,0,0
4026540,28d95f8d-891d-7aeb-f4e7-df5b7a89a65c,64,3658675,3928307,4026540,3728699,98233,367865,269632,0,0,0
4042059,8b0c287c-c9a7-2019-76ac-0e84e3d79e8b,64,3578297,3928566,4042059,3739861,113493,463762,350269,0,0,0
4042393,e58220fb-44c0-4650-039c-d30e9b32c18a,64,3839948,4026540,4042393,3878732,15853,202445,186592,0,0,0
4042781,dd79c4ab-d0bd-5160-cdec-728dc967c613,64,3839960,4019221,4042781,3871986,23560,202821,179261,0,0,0
4043020,e1ae4875-5c41-dfd1-d713-bdaf16c5d15d,64,3923906,4042059,4043020,3927528,961,119114,118153,0,0,0
4045979,6c06fc1c-1103-7ce4-5f27-ba2cd892bfe5,64,3923885,4042393,4045979,3929227,3586,122094,118508,0,0,0
4046124,ec359559-8882-2c16-9ffd-8b3ab6b10378,32,3968329,4045979,4046124,3968773,145,77795,77650,0,0,0
4046285,167a6bb9-0538-22d6-ee54-0acd82809828,32,3968101,4046124,4046285,3969345,161,78184,78023,0,0,0
4047561,9b52fdc7-04df-cf14-f538-a3d8a69bb8e7,64,3447199,3869337,4047561,3645471,178224,600362,422138,0,0,0
4047621,c6880773-e646-d57c-462b-cdde9b65a4a8,32,3968969,4047561,4047612,3969797,51,78643,78592,0,0,0
4047874,96136479-d739-f904-3d1c-dbc889f0d60a,32,3969529,4047621,4047874,3969895,253,78345,78092,0,0,0
4048181,491dff05-51a3-3e02-ec39-228b5f59083c,32,3968631,4047874,4048181,3969966,307,79550,79243,0,0,0
4048494,fd491137-2867-9cc1-606d-7b610c33c21f,32,3969233,4048181,4048494,3970611,313,79261,78948,0,0,0
4049223,1b7820bf-c746-3641-e191-6fcd4dfd2468,32,3978811,4048494,4049223,3979819,729,70412,69683,0,0,0
4049326,423a4ed2-6a2e-e9e8-f8c9-82587deb51fd,32,3979365,4049223,4049326,3981015,103,69961,69858,0,0,0
4049614,7ca495a8-0894-76fe-ca08-d6cf570da7fa,32,3979858,4049326,4049603,3981183,277,69745,69468,0,0,0
4050362,55fac683-d062-0b87-73b1-519df3940f4e,32,3987228,4049614,4050362,3991130,748,63134,62386,0,0,0
4051044,21a1a72e-e8c6-2479-4517-1b06e75818bf,64,3716126,3942793,4051044,3769059,108251,334918,226667,0,0,0
4051452,a9b4adc1-7d88-8e18-310a-dbd81bed09ca,64,3992037,4050362,4051452,3995910,1090,59415,58325,0,0,0
4051877,bccf4d6f-5ccf-634f-1e13-7ab3b82374a0,64,3991659,4051044,4051877,3996767,833,60218,59385,0,0,0
4053150,f16f74a0-587e-70e0-c542-07b09b0fb8ce,64,3995893,4051452,4053150,3998247,1698,57257,55559,0,0,0
4053470,67b5c84f-525c-f77e-ba18-717c337f2ee2,64,3995716,4051877,4053470,4001892,1593,57754,56161,0,0,0
4054842,f82d1334-6af0-501c-c3a3-74d264cccf09,64,3923929,4043020,4054842,3953202,11822,130913,119091,0,0,0
4059989,311ec4ee-25b1-9030-dffc-df009ae577c2,64,3991088,4053470,4059989,4003537,6519,68901,62382,0,0,0
4065340,23aa1a48-f1d8-072a-8b84-4ffe1b312cfb,64,3762908,4016257,4065340,3865268,49083,302432,253349,0,0,0
4068606,e9404300-2152-f3fa-1791-b7a1a3017eea,64,3987343,4054842,4068606,4003675,13764,81263,67499,0,0,0
4069238,471b024a-39d3-12d5-c4bb-95d1960b0c5e,64,3925309,4046285,4069238,3969586,22953,143929,120976,0,0,0
4069874,c623e20c-a246-4b49-2fe6-733bd2ae7cc2,64,4007598,4069238,4069874,4011388,636,62276,61640,0,0,0
4071655,1717097d-fc89-4f1b-4677-ab327a99b57d,64,3716020,4015199,4071655,3849551,56456,355635,299179,0,0,0
4075334,244b23b1-a131-18d0-1392-e109d3228db7,32,3710488,4008345,4075334,3841966,66989,364846,297857,0,0,0
4076015,b7a8c8b8-68c8-fdcc-10a9-78f999778706,64,3992943,4068606,4076015,4010128,7409,83072,75663,0,0,0
4076214,1836a0ed-b77e-7444-9e6d-5f7576dd888e,64,3965951,4053150,4076214,4002786,23064,110263,87199,0,0,0
4085642,9546a159-4c94-9e6e-6adf-32ecd37e3f70,64,4007597,4071655,4085642,4020432,13987,78045,64058,0,0,0
4089435,df0413d2-baa3-53b0-a141-d46c73be1b82,64,4007596,4075334,4089435,4024072,14101,81839,67738,0,0,0
4092313,aa4d15b3-9791-83a9-4afb-4e6a064aaec9,32,4032709,4089435,4092313,4036636,2878,59604,56726,0,0,0
4092730,fc8f43c8-6bc7-b1ec-3392-93ecebc47619,64,3992996,4069874,4092730,4017266,22856,99734,76878,0,0,0
4095668,ddbc25fb-6903-a86c-fdcf-5de322cbc84e,64,3981992,4059989,4095668,4004577,35679,113676,77997,0,0,0
4096383,646c798e-cf3e-c3d2-ead6-5e0d1e0c8279,64,4033207,4092313,4096383,4038421,4070,63176,59106,0,0,0
4097386,80dd9dd3-0cc9-8544-f147-c79cc4ccc63f,64,4007597,4076214,4097352,4028343,21138,89755,68617,0,0,0
4101733,6ed9cce2-eb69-c6b6-2858-a3d49047fdea,64,4007597,4076015,4101733,4027638,25718,94136,68418,0,0,0
4102007,36f93156-9a19-9bd0-6c2b-45cac04ab710,32,4050517,4101733,4102007,4051224,274,51490,51216,0,0,0
4102237,218986b0-ffe6-b62c-64dc-618a8022588d,32,4049554,4102007,4102237,4051448,230,52683,52453,0,0,0
4102368,54cb5255-8c4c-912f-83d8-aac926fa4004,32,4050044,4102237,4102368,4051643,131,52324,52193,0,0,0
4102790,3161e145-8cf5-7a05-9284-9b75745d82b8,32,4051073,4102368,4102790,4051967,422,51717,51295,0,0,0
4103529,28211305-f224-23ef-4a7f-7de7cb27f84b,32,4051545,4102790,4103529,4052268,739,51984,51245,0,0,0
4103866,f849bb62-c650-1492-6e1a-dca0a177ccf2,32,3925410,4065340,4103866,4007559,38526,178456,139930,0,0,0
4104311,87d802a1-42e7-6bef-8b95-700a5f4761c9,64,4052025,4103529,4104311,4053891,782,52286,51504,0,0,0
4104455,ab51703e-0433-d40a-6c70-007d0778cbaf,64,4053693,4104311,4104455,4055436,144,50762,50618,0,0,0
4104536,e3e70980-95b4-505d-a0ed-1c10e0a341c6,64,4054639,4104455,4104536,4055642,81,49897,49816,0,0,0
4104683,d8087935-2da1-94d3-e783-b0bd695c3f04,64,4054163,4104536,4104683,4056022,147,50520,50373,0,0,0
4105650,b4d4377b-b00b-e074-4dfe-a1ada5cd488d,64,4053913,4104683,4105650,4057127,967,51737,50770,0,0,0
4111189,a56d9b90-5a58-1486-ea02-96cda1781dd4,64,4041560,4096383,4111189,4049135,14806,69629,54823,0,0,0
4112102,255355e8-667d-4fc7-0b3b-924620c05333,64,4061953,4111189,4112102,4063707,913,50149,49236,0,0,0
4113376,b187fe2b-6449-d7f9-7017-361ea378a70f,64,4061922,4112102,4113376,4064425,1274,51454,50180,0,0,0
4114978,807d705e-bdbe-f28e-bd56-841ef8378d0c,64,4007597,4092730,4114978,4039051,22248,107381,85133,0,0,0
4116048,1d930b9b-de70-7c0e-a6ea-2cc22c138751,64,4061847,4114978,4116048,4065787,1070,54201,53131,0,0,0
4117562,2d2b8c57-8eda-a3db-df15-7669dadc7e13,64,4060607,4116048,4117562,4067111,1514,56955,55441,0,0,0
4117879,34e02dfe-0176-1649-2792-10b5648f5a06,64,4064813,4117562,4117879,4070552,317,53066,52749,0,0,0
4118785,c2f42d84-e898-41e3-4aad-d895d304c821,64,4066335,4117879,4118785,4070751,906,52450,51544,0,0,0
4119343,6f2b2cb6-8590-7a37-4ebd-d2b2b2781d12,64,4064811,4118785,4119343,4070908,558,54532,53974,0,0,0
4120984,addfe2fe-d209-ba62-4b9f-c93eae11f1f3,64,4048710,4113376,4120984,4065070,7608,72274,64666,0,0,0
4121745,e2e8348e-b386-1760-df05-ec3b97444cca,64,4066540,4119343,4121745,4071327,2402,55205,52803,0,0,0
4122092,9efc2c49-9144-853d-f6b1-38da40b0700e,64,3993260,4085642,4122092,4030183,36450,128832,92382,0,0,0
4123006,66b25584-53af-ba26-07a8-25f01e4dde00,64,4066145,4121745,4123006,4072293,1261,56861,55600,0,0,0
4123803,8c707eec-ee94-50b8-c663-f8e550a6c888,64,4082149,4123006,4123803,4084466,797,41654,40857,0,0,0
4125580,d4904d12-8e32-476e-243e-9f39d2829d85,64,4082116,4123803,4125580,4084672,1777,43464,41687,0,0,0
4125640,12eb426c-fb15-e056-1c61-23a7c3b64f94,64,4019740,4105650,4125636,4062491,19986,105896,85910,0,0,0
4126409,ed1e65f8-1031-5497-e039-736cf0027678,64,4080805,4125640,4126409,4087043,769,45604,44835,0,0,0
4127568,3e163fe0-0f89-e259-c2e7-e8f668bd92a9,64,4080523,4126409,4127568,4087273,1159,47045,45886,0,0,0
4132161,561632a7-945d-bd0b-01c2-8464bb47cb83,64,4080776,4127568,4132161,4087878,4593,51385,46792,0,0,0
4133448,f9c4dc6c-d42e-b4c3-89c1-54c4b1e08ece,64,4080691,4125580,4133448,4086951,7868,52757,44889,0,0,0
4134225,2e232d29-3783-4910-ac19-41f1afb37ab5,64,4080466,4132161,4134225,4089550,2064,53759,51695,0,0,0
4137848,8b947bc0-8eaf-28da-9d57-4da6836a106a,64,4080550,4133448,4137848,4089762,4400,57298,52898,0,0,0
4138521,db750dbf-2e7b-6f7b-076a-6545dc46a0fa,64,4080435,4134225,4138521,4090788,4296,58086,53790,0,0,0
4139241,1437a6f8-5d56-4ec9-d074-3d6c9db92a1e,64,3903462,4042781,4139241,3945117,96460,235779,139319,0,0,0
4141314,48f99917-b5cd-113a-613c-fcebac89ba55,64,4080494,4139241,4141314,4092185,2073,60820,58747,0,0,0
4142429,f5487ad8-8da7-aad8-a7e9-a3771490b828,64,4079459,4138521,4142382,4091945,3861,62923,59062,0,0,0
4143036,2a428b22-bf49-22b7-a60b-ee793f819771,64,4080403,4137848,4143036,4091621,5188,62633,57445,0,0,0
4144513,9a1e373b-3c60-9cd5-2395-e4926de9026b,64,3993792,4095668,4144513,4048832,48845,150721,101876,0,0,0
4145484,86db08be-b97e-b5b7-4ad9-530a48fe1af6,32,4080633,4144513,4145484,4096133,971,64851,63880,0,0,0
4145544,8268166a-ed48-adf1-2cc8-5993913a6a1f,32,4080376,4143036,4145500,4093572,2464,65124,62660,0,0,0
4149160,9a3d2895-cf80-b12e-5b30-0fb139f6af79,64,4080719,4141314,4149160,4092653,7846,68441,60595,0,0,0
4149926,10514bf7-54ca-f1ae-11db-eede84a43af7,64,4080605,4145484,4149926,4096911,4442,69321,64879,0,0,0
4150628,315edbdd-f558-a8d1-dcb6-0a2748a406ad,64,4080661,4143036,4150628,4094742,7592,69967,62375,0,0,0
4151172,5fe7890e-193d-787d-fa1b-241f462dc7ce,64,4096903,4149926,4151117,4104178,1191,54214,53023,0,0,0
4151690,0f680963-185a-f2f0-d2ff-d2f3f322d11a,32,4080746,4149160,4151690,4097410,2530,70944,68414,0,0,0
4151791,ee90951e-37d6-5cc2-6c40-be2046cdf031,64,4065946,4142429,4151791,4092806,9362,85845,76483,0,0,0
4153805,68dc8a83-de7e-fc0a-79c0-e8adbbbe43a1,64,3987451,4097386,4153805,4049961,56419,166354,109935,0,0,0
4154138,9bf7bdfd-b4d0-0b4f-c8d4-3002fed2b9ef,64,4065753,4150628,4154138,4106991,3510,88385,84875,0,0,0
4154629,eeb01a1f-c802-7db8-1a33-856a7bb50b6e,64,4139376,4154138,4154629,4140083,491,15253,14762,0,0,0
4154689,80bcaf93-294a-8df0-45bb-7f89bc64b4c1,64,4128466,4153805,4154678,4135636,873,26212,25339,0,0,0
4154854,c9f3396c-d241-2bab-06cc-1022d15141af,64,4139922,4154629,4154854,4140649,225,14932,14707,0,0,0
4154936,33bf8a61-cc3e-4481-5238-8f11216f07c2,64,4142079,4154854,4154936,4143141,82,12857,12775,0,0,0
4155065,dc87f0b8-1706-85b4-e0a9-598860365ae2,64,4141595,4154936,4155065,4143465,129,13470,13341,0,0,0
4155147,15f52c22-81db-641f-fa30-bab981d13b68,64,4142743,4155065,4155147,4143692,82,12404,12322,0,0,0
4155207,14625b2e-0e4f-e9d8-458b-ece8d0532808,64,4138903,4154689,4155174,4140684,485,16271,15786,0,0,0
4155813,ad013daf-e4ac-1f54-3d94-dbc167164911,64,4143940,4155147,4155813,4146037,666,11873,11207,0,0,0
4155873,a09e64ed-b2d7-7243-17f6-70d8add982b4,64,4142369,4155207,4155854,4149872,647,13485,12838,0,0,0
4156208,30595b9b-3835-b4d1-aa7b-025744ce5acf,32,4141947,4155147,4156208,4145078,1061,14261,13200,0,0,0
4158631,8d7a3812-9c4e-e68e-e453-6ee5832abcee,64,4149828,4155873,4158631,4154396,2758,8803,6045,0,0,0
4158899,435d1fc2-d424-64b1-dd0a-be61c19f73ed,64,4149943,4155813,4158899,4154381,3086,8956,5870,0,0,0
4159145,481036b7-c6b1-798d-592c-ef590b77db92,64,4153222,4158631,4159145,4158496,514,5923,5409,0,0,0
4160960,e2579733-eb4c-966d-1dce-9759e3d44ecc,64,4151362,4158899,4160960,4159041,2061,9598,7537,0,0,0
4161020,544f7542-d0da-7618-647e-8d639bd4a173,64,4149712,4159145,4161019,4160015,1874,11307,9433,0,0,0
4161080,60232a3a-0e3c-bd62-db81-bdb248822857,64,4159402,4161020,4161073,4160566,53,1671,1618,0,0,0
4161286,d9b3d2bd-ce9c-0fb0-0b2e-6ca6e3272dbb,64,4159884,4161080,4161286,4160725,206,1402,1196,0,0,0
4161415,e3e254fc-803d-59ff-aacd-93a355c61f20,64,4160363,4161286,4161415,4161101,129,1052,923,0,0,0
4162105,12fd4b1a-267a-be05-7da3-58c874622dd2,64,4159646,4161415,4162066,4161185,651,2420,1769,0,0,0
4162257,04a8b114-c07b-8191-36b1-b9ed24ec8ee8,64,4159172,4162105,4162257,4161220,152,3085,2933,0,0,0
4163161,5fa02c68-bedb-cde9-df91-53e11c45a939,64,4160129,4162257,4163161,4162947,904,3032,2128,0,0,0
4164818,4664a837-a430-774c-0599-96dd8a24ac9f,64,4151239,4160960,4164818,4160171,3858,13579,9721,0,0,0
4165454,5c56095b-dee9-5304-8d6e-0616970648ef,32,4165304,4165304,4165454,4166115,150,150,0,0,0,0
4165514,a235adfd-8576-a368-0b20-d1f1d92bd9c0,32,4165173,4165173,4165474,4166465,301,301,0,0,0,0
4166305,d980ff40-cfff-aa9c-1c04-00c447ac1bb1,32,4165776,4165776,4166257,4166205,481,481,0,0,0,0
4166579,ad2493b0-a36c-c3a5-1c78-4e9218b17214,32,4165891,4166305,4166579,4166606,274,688,414,0,0,0
4167332,6bd3ca24-69f1-43bb-a483-c971beddf4d4,64,4159924,4163161,4167332,4166027,4171,7408,3237,0,0,0
4167392,8cc08da3-da71-3c69-0333-44eb09895a27,64,4151479,4164818,4167355,4166786,2537,15876,13339,0,0,0
4167615,a67b8364-fb0a-b511-ecc5-bedd593cc40e,32,4166359,4167392,4167615,4167177,223,1256,1033,0,0,0
4167675,f861a05e-7326-483e-c7be-75b13f9a3b13,64,4166245,4167332,4167672,4166877,340,1427,1087,0,0,0
4168896,dd8b0599-252c-46fd-ebc1-7e0d380b15ec,64,4165546,4167615,4168896,4168177,1281,3350,2069,0,0,0
4169984,4b307c7c-f07b-e8d5-6cc6-cdc9015b4a38,32,4160320,4168896,4169984,4168917,1088,9664,8576,0,0,0
4170600,8953365f-e8b3-ff8f-29fb-0d5d349c1aa4,32,4166008,4169984,4170600,4170192,616,4592,3976,0,0,0
4171248,ee8767e5-1900-d472-4497-0210c5113e11,32,4165061,4170600,4171248,4170373,648,6187,5539,0,0,0
4175495,7e7ba65b-dc9e-1eac-fd73-2526348ff692,32,4164605,4171248,4175495,4174433,4247,10890,6643,0,0,0
4176532,e95af5b5-a888-47af-60a7-5a5a50b4f4fa,64,4065566,4149160,4176532,4098302,27372,110966,83594,0,0,0
4178150,11e2c398-1191-6202-4dc2-6314cb9c09ef,32,4138164,4163161,4178150,4165344,14989,39986,24997,0,0,0
4178942,1701817a-0760-391a-21b2-0e6fa2e7b4b3,64,4161982,4176532,4178942,4174872,2410,16960,14550,0,0,0
4181257,2f5b8b8e-99c0-d0a1-9cb4-fc29b686cb74,64,4156693,4178942,4181239,4176180,2297,24546,22249,0,0,0
4192472,921faeb1-75a7-26f0-68a6-4ff3d2d7ac79,64,4149481,4181257,4192472,4176193,11215,42991,31776,0,0,0
4197171,955399df-a14f-f917-c5b6-02ae4f3b22be,64,4161209,4192472,4197171,4176992,4699,35962,31263,0,0,0
4197412,819ca655-f6fe-7b14-cbcf-85a2788a41fe,64,4097326,4175495,4197412,4174723,21917,100086,78169,0,0,0
4200910,03a3f80f-51e0-7ae2-30a6-4f2cdc413634,64,4162069,4197412,4200910,4178950,3498,38841,35343,0,0,0
4202662,60bb9203-0e4d-b42d-9b7e-363bffffdbc7,64,4179439,4200910,4202662,4182222,1752,23223,21471,0,0,0
4212400,997f6bc6-c649-78f4-c0df-13f2cc4e6312,64,4162038,4197171,4212400,4178292,15229,50362,35133,0,0,0
4221825,0be82159-e00b-da93-ecad-c1ec29858626,64,4099022,4167675,4221825,4168311,54150,122803,68653,0,0,0
4223222,297f2c38-22e8-65e8-12b0-71bbb8948faf,64,4161925,4202662,4223222,4184316,20560,61297,40737,0,0,0
4226384,60a36663-f984-b02f-89e0-e95f344e6140,64,4181672,4223222,4226384,4186431,3162,44712,41550,0,0,0
4229596,ef0392d4-0b3e-06d4-e3f0-6a8d0fc56ed0,64,4162008,4226384,4229596,4187548,3212,67588,64376,0,0,0
4230655,086f9e86-f69a-02b5-af00-cf30cba3b54c,64,4164681,4221825,4230655,4185684,8830,65974,57144,0,0,0
4231233,2e255050-9397-d7a1-5ebf-6bc881cdc6c5,64,4150814,4212400,4231233,4184323,18833,80419,61586,0,0,0
4231494,2dd964a7-ca5a-cf33-a98f-aac1fffe609c,64,4017803,4151172,4231494,4109823,80322,213691,133369,0,0,0
4232724,6ef37c42-30c2-6404-7eaa-3643b49e0e3b,64,4181580,4229596,4232724,4188633,3128,51144,48016,0,0,0
4233499,08728b55-c2e5-52c5-c732-ece82c2be64b,64,4161954,4231494,4233499,4200720,2005,71545,69540,0,0,0
4238665,e72fa7e9-e30c-70fd-8349-c174ab0be280,64,3648673,3986975,4238665,3830474,251690,589992,338302,0,0,0
4240589,b0b5453d-fea2-0d85-2364-81fb62bf819e,64,4149598,4230655,4240589,4190037,9934,90991,81057,0,0,0
4242155,829e617f-74e1-a99f-5651-2c86d5b1beb4,64,4181371,4238665,4242155,4213646,3490,60784,57294,0,0,0
4243265,7381912a-93a6-723d-28ea-818b806f429c,64,3995497,4151791,4243265,4120259,91474,247768,156294,0,0,0
4246364,d281cce2-9482-7280-8aaf-b54b0158572b,64,4181227,4240589,4246364,4214921,5775,65137,59362,0,0,0
4248267,1e30552e-259b-3d54-7639-10cbe40d47ef,64,4181256,4242155,4248267,4214935,6112,67011,60899,0,0,0
4256786,c5e17dc9-1f92-9420-5ab4-8d44cfc449f9,64,4183413,4243265,4256786,4216106,13521,73373,59852,0,0,0
4258361,786b5570-2caa-4761-a982-384b0cfb3279,64,4183445,4233499,4258361,4213182,24862,74916,50054,0,0,0
4260218,b1adb6d6-5e1a-12b8-f36c-86e2137f1d47,64,4221431,4258361,4260218,4224180,1857,38787,36930,0,0,0
4260350,f5354157-8efa-4ccd-e657-f24166f92293,32,4224170,4260218,4260350,4224670,132,36180,36048,0,0,0
4262126,c6e316fa-7bcb-db5d-5d75-122ae119d089,64,4149365,4248267,4262126,4224088,13859,112761,98902,0,0,0
4262241,94e0f8d0-9c35-144e-5b45-eb213bcf8fdf,64,4224630,4262126,4262241,4225607,115,37611,37496,0,0,0
4262549,b71a57b0-fe50-de00-471b-51bfc0a62a72,64,4224402,4262241,4262549,4225628,308,38147,37839,0,0,0
4263522,baf9d5d9-e477-3c21-7330-a4046394fbea,64,4183502,4246364,4263522,4217732,17158,80020,62862,0,0,0
4263634,35e0bd49-1f50-9cf3-e2d7-7296580486aa,64,4225132,4263522,4263634,4225863,112,38502,38390,0,0,0
4263943,99872c6f-3562-e906-6721-6cf63db1d06f,64,4224893,4263634,4263943,4225884,309,39050,38741,0,0,0
4264230,fb59dcc6-b45f-53b7-ded4-b790ddea2048,64,4225725,4263943,4264230,4226174,287,38505,38218,0,0,0
4264290,c5951e02-eb12-6636-721d-09d29ed9e494,64,4226193,4264230,4264271,4226825,41,38078,38037,0,0,0
4264439,98870e28-1222-1f30-332a-f278625c082d,64,4181339,4260218,4264439,4225242,4221,83100,78879,0,0,0
4264548,18c253bc-2c43-52d6-9262-540a538bc925,64,4226650,4264439,4264548,4227192,109,37898,37789,0,0,0
4264608,bdcdda32-690b-a4e2-e9ea-34b0d36630f8,64,4150972,4232724,4264587,4207313,31863,113615,81752,0,0,0
4264782,e69728df-12f1-bfeb-7fd6-c3d422ecc266,64,4225948,4264290,4264782,4226971,492,38834,38342,0,0,0
4264842,63c8db5f-42e3-9c29-6973-156d9acbf074,64,4225480,4264548,4264804,4227568,256,39324,39068,0,0,0
4265094,966de295-93e9-9835-01d4-897d6b79d8e7,32,4226421,4264782,4265094,4228025,312,38673,38361,0,0,0
4265257,1b67fde9-0946-d055-fb9a-08e4501e2f04,64,4221389,4264782,4265257,4228301,475,43868,43393,0,0,0
4265317,d7419240-c6aa-acc9-ae25-7b18e9b6087f,64,4223940,4264608,4265301,4228015,693,41361,40668,0,0,0
4267188,6c60d910-e317-912e-d1b8-ab65ceaee4b8,32,4231532,4265317,4267188,4235699,1871,35656,33785,0,0,0
4267253,c1796dea-e8e9-27be-b2e3-2e7630ab60ce,64,4181197,4256786,4267253,4224156,10467,86056,75589,0,0,0
4270545,1e8ae976-4da9-29b6-c936-34cf108c0e80,64,4151112,4264842,4270545,4231178,5703,119433,113730,0,0,0
4270937,36a41b76-e6c9-d6f6-75d1-b6f1641e6cdd,64,4183474,4267188,4270937,4236151,3749,87463,83714,0,0,0
4271985,3048da08-3bb4-08b4-ec63-a409e1534ad2,64,4234753,4270545,4271985,4238498,1440,37232,35792,0,0,0
4272192,a065ee5e-3bec-9070-c0de-c40bdb16aaa8,64,4183355,4267253,4272192,4237364,4939,88837,83898,0,0,0
4272482,8a430d37-3b9c-77fc-59ea-d309ff918cba,64,4214264,4265257,4272482,4231514,7225,58218,50993,0,0,0
4273620,93c65d83-9de7-1a28-beb5-6b7746047630,64,4232950,4271985,4273620,4240070,1635,40670,39035,0,0,0
4274491,bf3423f9-7887-2fc5-d0bc-7099957c6306,32,4233860,4272192,4274491,4244862,2299,40631,38332,0,0,0
4275629,b671eb6c-29d1-bb83-2086-04d8296a440f,64,4098968,4231233,4275629,4198771,44396,176661,132265,0,0,0
4276291,02439714-beee-75f4-86f9-f246bafa0fc3,64,4246125,4275629,4276291,4249578,662,30166,29504,0,0,0
4276736,f05b483f-2e23-ec84-0829-22a5ec83f4f8,64,4236657,4272482,4276736,4247931,4254,40079,35825,0,0,0
4277925,df615d48-30ed-1598-6574-a3febe8b065c,64,4214353,4270937,4277925,4239776,6988,63572,56584,0,0,0
4278493,ef18da80-7edd-b12b-154a-aecd38de3f1c,64,4236559,4276291,4278493,4250905,2202,41934,39732,0,0,0
4279066,66b3195f-2c54-cbcb-6179-8dd51136ab41,32,4183274,4265317,4279066,4235147,13749,95792,82043,0,0,0
4279307,b55aaef0-87aa-a9c0-5c37-44de7c1ba147,32,4252611,4279066,4279307,4255034,241,26696,26455,0,0,0
4279826,027f2467-860a-50a6-9d46-c8145688998c,32,4252590,4279307,4279826,4256006,519,27236,26717,0,0,0
4280194,9e78a0c0-5717-b6a4-35ed-7c0eff5eaff8,64,4233911,4277925,4280194,4253717,2269,46283,44014,0,0,0
4281091,7c2c6735-cc06-701e-260c-e93b7a3ba7d6,32,4270958,4280194,4281091,4275347,897,10133,9236,0,0,0
4281652,94d84190-3248-2331-8db3-ba52da7f0a7b,64,4271022,4279826,4281652,4274366,1826,10630,8804,0,0,0
4283400,431cbdae-9739-d988-c341-35ed3caa9046,32,4181398,4272482,4283400,4245341,10918,102002,91084,0,0,0
4289507,74f709e1-7393-8cc3-2bfa-b74119500d0e,64,4183322,4281652,4289507,4277296,7855,106185,98330,0,0,0
4292066,ea8151f0-543a-d853-cd3d-8bd47cd9d081,64,4181284,4276736,4292066,4251974,15330,110782,95452,0,0,0
4303381,ac99571e-fb8f-2a6e-4074-cb943b823984,64,4183385,4289507,4303381,4280973,13874,119996,106122,0,0,0
4309818,17f3ffe2-9c45-11a1-2315-d76ad01849b0,64,4181312,4281091,4309818,4275476,28727,128506,99779,0,0,0
4312434,896a075f-0ae8-bfed-8e3a-41136203af07,64,4301558,4309818,4312434,4308073,2616,10876,8260,0,0,0
4317348,38fe0392-d62d-4ee2-6daf-a9f421583a9c,64,4225015,4292066,4317348,4283343,25282,92333,67051,0,0,0
4317652,824522e6-fe4a-5f5a-0cc4-eab1fe465a33,64,4306864,4317348,4317652,4310597,304,10788,10484,0,0,0
4317871,a258dc7b-4837-3096-76ed-56fa910ace14,64,4304390,4312434,4317871,4309477,5437,13481,8044,0,0,0
4318591,65389475-9b82-0a68-093a-a4b27d4d2ba4,32,4309873,4317871,4318591,4313428,720,8718,7998,0,0,0
4320982,38ba9ec2-c61c-f3e8-173f-874a35dd245f,64,4307112,4317652,4320982,4310892,3330,13870,10540,0,0,0
4332726,b68af595-23fa-dfb0-6867-40beea7c446c,64,4330038,4330038,4332726,4335889,2688,2688,0,0,0,0
4352913,4102ebe4-0d44-14b3-9a4f-be8ae534a3f0,64,4308850,4317871,4352913,4333575,35042,44063,9021,0,0,0
4355610,8b78f7f7-19ee-469e-b5e2-6ccab0791007,64,4103717,4262549,4355610,4225741,93061,251893,158832,0,0,0
4376561,629f69fa-e419-2fd4-02ba-f6b8fa50810e,64,3641818,4122092,4376561,4074383,254469,734743,480274,0,0,0
4376916,2cf41d1a-8df9-57fd-d7dc-c3fc7c530f68,64,4354191,4376561,4376916,4357925,355,22725,22370,0,0,0
4398282,125ccc67-8df5-edcc-66fa-069d03a0b69c,64,4316651,4376916,4398282,4358399,21366,81631,60265,0,0,0
4402900,33eb26fb-3694-2bbb-8871-eb5240f4aab5,64,4316592,4352913,4402900,4346152,49987,86308,36321,0,0,0
4406183,aff97113-2531-b75e-bab0-0a7af8fb0c64,64,4353951,4402900,4406183,4358945,3283,52232,48949,0,0,0
4408021,cc64f820-16bb-b94a-8a4b-0ea1a97a30bf,64,4103707,4278493,4408021,4254732,129528,304314,174786,0,0,0
4420264,23659101-da8e-22cc-d02f-4423077a2f03,64,4326409,4406183,4420264,4367765,14081,93855,79774,0,0,0
4429253,5ff6fbb3-c6e8-0bf7-6a54-8efd9f3032a7,64,4276101,4320982,4429253,4337923,108271,153152,44881,0,0,0
4431527,768241f8-a5da-e31d-80e2-893b0e998c6f,64,4316736,4398282,4431527,4358848,33245,114791,81546,0,0,0
4433041,3927a8c3-9be8-f86e-dce4-ffb593e78e24,64,4390932,4431527,4433041,4393107,1514,42109,40595,0,0,0
4434035,c51e0e93-9936-b869-7f23-8acdffce09fe,64,4391591,4433041,4434035,4395635,994,42444,41450,0,0,0
4435908,337c8af7-5864-97c7-dfb8-43aa935380d0,64,4391619,4434035,4435908,4396972,1873,44289,42416,0,0,0
4437097,cd10a024-f990-d104-3446-52663b2ba5dc,64,4397597,4435908,4437097,4400743,1189,39500,38311,0,0,0
4439154,a7cca24e-d0a5-82e9-9836-d8441b29b8b3,64,4398200,4437097,4439154,4401090,2057,40954,38897,0,0,0
4440161,88c56655-3a6e-29ee-d30f-f658b6ee94ad,64,4404417,4439154,4440161,4407918,1007,35744,34737,0,0,0
4441334,1fd77b31-4441-1fb4-1a0f-6a467254a1d5,64,4416837,4440161,4441334,4417586,1173,24497,23324,0,0,0
4444089,95ae9fb2-6eba-4271-26be-24228fbb7b4b,64,4416823,4441334,4444089,4418784,2755,27266,24511,0,0,0
4448885,41655ea2-421a-b24b-3069-e444fb6fde4c,64,4416821,4444089,4448885,4422189,4796,32064,27268,0,0,0
4455326,0e5cf402-96e0-cf68-b0bc-733aac3ae219,32,4416830,4448885,4455326,4422507,6441,38496,32055,0,0,0
4456199,f62abb20-a82e-82de-26eb-50279cea3670,32,4416840,4448885,4456199,4423491,7314,39359,32045,0,0,0
4467328,408aac29-d276-dad1-ab35-b9d2c674d18b,64,4316696,4429253,4467328,4386627,38075,150632,112557,0,0,0
4469312,981fe99e-f818-915e-3b5b-438417a5a428,64,4416825,4455326,4469312,4424110,13986,52487,38501,0,0,0
4471913,fcc80669-c038-7bd8-503a-e31ff3ab4b8d,64,4316034,4408021,4471913,4372917,63892,155879,91987,0,0,0
4473931,f7d101c5-986b-efbb-d5a0-29a4b68b3b3d,64,4416847,4467328,4473931,4424753,6603,57084,50481,0,0,0
4474381,beee1e89-45df-de4f-78db-52b1f4abf34a,64,4095859,4273620,4474381,4248393,200761,378522,177761,0,0,0
4477701,2cb2ee58-7676-25ac-7110-b6d4c89dc9be,64,4416852,4471913,4477701,4427549,5788,60849,55061,0,0,0
4478242,f7b17fdd-b4be-db6e-455b-4c7861a2318e,64,4416840,4469312,4478242,4426175,8930,61402,52472,0,0,0
4481289,87ffb4f1-77dd-f012-584e-a28a2f3d5046,64,4416828,4474381,4481289,4428674,6908,64461,57553,0,0,0
4488502,ec909bc8-e2c8-cce0-c5f2-f2300b4370e8,32,4416821,4477701,4488502,4429961,10801,71681,60880,0,0,0
4489966,02033bfb-fbca-c8e6-b2c6-ead30facb8eb,64,4158411,4355610,4489966,4357783,134356,331555,197199,0,0,0
4490220,3ee87a9c-8ed9-7435-29ed-24f640f3b32d,64,4243325,4420264,4490220,4379731,69956,246895,176939,0,0,0
4492722,d739c59a-26e9-4041-29a2-61f97713f2f0,64,4416835,4473931,4492722,4428366,18791,75887,57096,0,0,0
4500282,c8d772d1-b4f6-d2ae-7cb7-b7b2e75d17b4,64,4416856,4478242,4500282,4431744,22040,83426,61386,0,0,0
4503629,94f04d02-e7a5-04d2-2822-56782510d4b5,64,4097155,4303381,4503629,4296534,200248,406474,206226,0,0,0
4505883,838582e2-1bd4-d120-b73c-5769c20e8172,64,4416822,4489966,4505883,4433109,15917,89061,73144,0,0,0
4509109,7ffa26b6-7a68-7413-17bf-c78e8b1fe1db,64,4416832,4500282,4509109,4436183,8827,92277,83450,0,0,0
4509281,8188d883-54a1-47a8-f08e-6565870713a7,64,3665345,4120984,4509281,4071636,388297,843936,455639,0,0,0
4512408,7afc1461-ecc0-71b4-7bea-a8ea6908843f,64,4416860,4481289,4512408,4432167,31119,95548,64429,0,0,0
4512657,554e5f40-cc07-5825-69b0-353feca39912,32,4439591,4512408,4512657,4441480,249,73066,72817,0,0,0
4516724,20a030f6-1b69-4827-87fd-bf4c6a576195,64,4416833,4492722,4516724,4435909,24002,99891,75889,0,0,0
4523177,0032ef19-3a16-7059-3d21-a6c80891807e,64,4416836,4490220,4523177,4434653,32957,106341,73384,0,0,0
4523571,e10ace91-e060-3f84-6036-8028da19a07b,64,4416833,4503629,4523571,4437687,19942,106738,86796,0,0,0
4525926,4d7a3b1d-9187-62c2-e07b-8ff50fcd3fd9,64,4416848,4505883,4525926,4438222,20043,109078,89035,0,0,0
4529092,c8fa91ce-4a6e-4641-034b-e7cfeef2ab60,64,4416849,4509281,4529092,4439915,19811,112243,92432,0,0,0
4529297,c8b83f66-e962-ba27-fca7-275ef7d58edd,32,4416840,4512408,4529297,4440526,16889,112457,95568,0,0,0
4532328,1693824f-f647-dd59-faba-415b3b613c2c,64,4416843,4512657,4532328,4441743,19671,115485,95814,0,0,0
4532703,aed05163-62dc-1736-4afa-e9a9f89205d7,64,4416837,4516724,4532703,4442848,15979,115866,99887,0,0,0
4533204,6f13ea7e-6f1c-7ed8-a0af-b92de7eaa238,64,4442535,4532328,4533204,4445667,876,90669,89793,0,0,0
4537297,4a94e9ec-80db-e18d-bab5-858aefa469d7,64,4416818,4523177,4537297,4443547,14120,120479,106359,0,0,0
4539357,683ba8dc-8a35-3ee8-12d5-56e1d6155abe,64,4443799,4537297,4539357,4446734,2060,95558,93498,0,0,0
4541392,3aa548dd-c2e0-143b-70bf-714ea2134956,64,4416850,4523571,4541392,4443645,17821,124542,106721,0,0,0
4544477,9a27f594-becb-9785-6924-b9b647dc75da,64,4416819,4529092,4544477,4444845,15385,127658,112273,0,0,0
4546291,5bd4ba2f-0c08-39e4-36d9-d6db6f3f351e,64,4416823,4525926,4546291,4443914,20365,129468,109103,0,0,0
4553062,3d160a1d-da5d-b295-1faf-2e432f26f59b,64,4416819,4509109,4553062,4439846,43953,136243,92290,0,0,0
4556374,c33b4ed8-7391-4b3b-6035-b3d5c436e648,64,4416858,4533204,4556374,4446250,23170,139516,116346,0,0,0
4563050,0ac91e13-1070-4dcc-68d7-b656c0795f7b,64,4416824,4546291,4563050,4448920,16759,146226,129467,0,0,0
4563143,a0fb6a0d-36e4-e2e0-55c4-cad7f31d81a7,64,4416848,4532703,4563143,4445910,30440,146295,115855,0,0,0
4564230,75151435-cd01-ab44-2282-80207460aba0,32,4416863,4539357,4564230,4447243,24873,147367,122494,0,0,0
4565220,b373e393-b6a5-a0f7-fe4f-1bd4f3d5a4ee,64,4416854,4539357,4565220,4447617,25863,148366,122503,0,0,0
4565578,7e14a4f9-a7c7-0d48-1106-42d9288bfeb6,64,4416848,4544477,4565578,4448838,21101,148730,127629,0,0,0
4570056,2fca9013-812b-9528-ed18-f9035961be8b,64,4416855,4541392,4570056,4448825,28664,153201,124537,0,0,0
4571368,a17f0299-7284-bedf-71a8-a02448d08dd9,64,4416837,4553062,4571368,4448966,18306,154531,136225,0,0,0
4578243,cc5bb2d1-1fc3-a419-25f8-699daf9ea8e0,32,4416859,4556374,4578243,4449495,21869,161384,139515,0,0,0
4579423,278859d7-a3db-fcac-ac91-8dc0f02faad2,32,4473262,4578243,4579423,4477172,1180,106161,104981,0,0,0
4581966,d3c0f8b2-0348-31a7-be2c-2beb0a41d593,64,4416851,4563050,4581966,4449858,18916,165115,146199,0,0,0
4582185,8707806c-2291-23b1-b94d-8e0910f4026f,32,4481578,4581966,4582185,4482468,219,100607,100388,0,0,0
4582269,8397b92c-7eb5-1015-1035-5671e1d3e779,64,4416828,4570056,4582269,4463752,12213,165441,153228,0,0,0
4582539,8a18f553-16b2-d432-a295-baf51187a8a8,32,4482539,4582269,4582539,4484383,270,100000,99730,0,0,0
4582643,75bb16db-dc4c-44a0-ca4f-fb7c24486381,32,4483697,4582539,4582643,4484792,104,98946,98842,0,0,0
4582786,b056d431-09b6-5742-01e2-9b8ac2a4062a,32,4484185,4582643,4582786,4485779,143,98601,98458,0,0,0
4582868,a546fa89-79b1-54bd-7912-2746ba61730b,64,4416841,4565220,4582868,4452172,17648,166027,148379,0,0,0
4582972,477c5c1e-97c3-6d09-237a-84ebf75646bc,32,4485763,4582868,4582972,4487367,104,97209,97105,0,0,0
4583032,32968e18-7484-6fbc-98d9-e0c8c022e203,64,4484664,4582786,4583011,4485811,225,98347,98122,0,0,0
4583032,a9710c9b-2299-d0d8-ed2a-3dfb98f42a8e,64,4482058,4582185,4583022,4483625,837,100964,100127,0,0,0
4583232,8dbae5d1-214f-fcb9-c302-7332329ba54b,32,4416824,4564230,4583232,4452087,19002,166408,147406,0,0,0
4583366,53f1dda7-af2b-657b-d812-b47e777e2de9,64,4486238,4583032,4583366,4488086,334,97128,96794,0,0,0
4584192,b2c45cce-75a4-37c5-4243-913ef14be73b,64,4484471,4583366,4584192,4488142,826,99721,98895,0,0,0
4584282,1dd217d3-1fe9-9077-c6a5-4047693e0fba,64,4485100,4582972,4584282,4488029,1310,99182,97872,0,0,0
4584342,094b8e96-769f-5cec-5f45-54258915c54d,64,4485341,4583032,4584308,4488101,1276,98967,97691,0,0,0
4584758,bbf02c2b-1922-8703-96ed-7b0092508d82,64,4486713,4584342,4584758,4488490,416,98045,97629,0,0,0
4584818,71e63d02-3bbb-d9f3-4a34-aa5be353afe6,64,4487284,4584282,4584770,4488214,488,97486,96998,0,0,0
4584878,0881bab0-72f4-aa27-82da-b635a9e83409,64,4484063,4584192,4584833,4488197,641,100770,100129,0,0,0
4585180,c1f82302-1836-c403-7d5a-d5c56131e49d,64,4487763,4584758,4585180,4488962,422,97417,96995,0,0,0
4585240,ea6029f6-2bf9-8b9b-f676-68953ded87f8,64,4491231,4584878,4585228,4495094,350,93997,93647,0,0,0
4585300,b4140163-9f87-3ed2-2935-ed70c3362f45,64,4488258,4584818,4585292,4489085,474,97034,96560,0,0,0
4586019,66a917c7-77d9-bf69-9ffb-d74f8d2fef1b,64,4496930,4585240,4586019,4499051,779,89089,88310,0,0,0
4586079,b0b128f0-39d2-797b-3284-48492a1675a1,32,4496817,4585300,4586033,4499806,733,89216,88483,0,0,0
4586079,57b919a4-fbbc-198b-210f-214cb9f8d477,64,4490791,4585180,4586038,4496862,858,95247,94389,0,0,0
4586210,0afc3e93-1042-ab3b-1622-1861926eaf69,64,4501094,4586079,4586210,4501849,131,85116,84985,0,0,0
4586362,f6c30e77-2456-ed12-aebb-ea7f39421121,64,4500615,4586019,4586362,4501611,343,85747,85404,0,0,0
4586876,a5362ac1-876a-49bb-848b-61928feb1bdb,32,4502735,4586362,4586876,4505776,514,84141,83627,0,0,0
4586936,8e1168da-a711-5cc4-8dbe-5a906b83539e,64,4500150,4586079,4586894,4502052,815,86744,85929,0,0,0
4588030,29d213dc-4687-a57e-c4e3-03b6e2c775f9,32,4502805,4586936,4588030,4506891,1094,85225,84131,0,0,0
4588362,79ab0ee0-d355-2a29-d951-301ccf4fffdb,32,4502857,4588030,4588362,4506984,332,85505,85173,0,0,0
4588425,534deacf-6caf-e9a4-789f-76981f5630fd,64,4502739,4586210,4588425,4505420,2215,85686,83471,0,0,0
4594641,e6ab61fc-e2f8-9ab9-cb96-a045a57440cb,64,4416860,4563143,4594641,4451908,31498,177781,146283,0,0,0
4594997,bdf034c0-7b19-6c51-289f-162eb0c65abe,32,4559918,4594641,4594997,4562434,356,35079,34723,0,0,0
4595369,f019d98d-b590-2d58-1f5d-27e9e18253b1,32,4560306,4594997,4595369,4563122,372,35063,34691,0,0,0
4595735,95ec65b8-06a4-b9db-54c7-f626a22634b5,32,4560472,4595369,4595735,4563584,366,35263,34897,0,0,0
4596413,072d680a-1fed-984b-2c27-65da4d42578b,32,4560472,4595735,4596413,4564889,678,35941,35263,0,0,0
4597434,fa5ea6b5-0a69-8790-9c2e-1a912e38f17c,32,4560337,4596413,4597434,4564890,1021,37097,36076,0,0,0
4599257,35b893f7-5986-dca2-1820-852cba16b978,32,4560064,4597434,4599257,4565007,1823,39193,37370,0,0,0
4599671,3d42add0-31c1-1fe4-d09b-3f65430ac42e,32,4567227,4599257,4599639,4567885,382,32412,32030,0,0,0
4600176,0272982a-e653-7d69-1355-9f817aab1070,32,4568235,4599671,4600176,4569287,505,31941,31436,0,0,0
4600561,82c68c0e-b837-f621-11a7-2645831b4361,32,4567715,4600176,4600561,4569382,385,32846,32461,0,0,0
4601930,b184e328-9fc0-63b5-eda2-62774092790d,32,4567530,4600561,4601930,4569999,1369,34400,33031,0,0,0
4602074,76069880-c69d-1370-9cd1-a6a64d15d38b,32,4569471,4601930,4602074,4570338,144,32603,32459,0,0,0
4602352,f3efd63e-0273-1821-1b2c-a06bc2f653a4,32,4568943,4602074,4602333,4570755,259,33390,33131,0,0,0
4602457,f3d98139-fc35-dc5e-5601-dc5f9bc1bee5,32,4569944,4602352,4602457,4571325,105,32513,32408,0,0,0
4603197,fe1df6e2-0df0-ea72-352e-3f169da13fb2,32,4570563,4602457,4603197,4571522,740,32634,31894,0,0,0
4603364,2d860ff1-b265-2039-6734-eb6a6a1c6ba2,32,4571053,4603197,4603364,4571803,167,32311,32144,0,0,0
4604755,c915b1d4-5374-4b5a-8d3b-b15bfc284016,32,4569628,4603364,4604755,4572039,1391,35127,33736,0,0,0
4605035,9300c466-d0ab-c2f7-1acc-ec2284c03f8e,32,4571569,4604755,4605035,4572298,280,33466,33186,0,0,0
4606033,03446200-9ae5-5786-45f0-bdea95ddf0bb,32,4571460,4605035,4606033,4575657,998,34573,33575,0,0,0
4606093,20f3027e-049b-e71a-f85c-8d55161f1751,64,4416853,4565578,4606050,4452592,40472,189197,148725,0,0,0
4606264,9feb7f70-2cb6-afa5-1bb6-43569a8c3437,64,4578711,4606033,4606264,4583427,231,27553,27322,0,0,0
4606367,dce48c87-ee59-e4ff-7789-43edb89d7310,32,4588798,4606264,4606367,4589471,103,17569,17466,0,0,0
4606535,f214b3a1-5b41-0d97-23af-3aa66b698bc7,64,4583265,4606093,4606535,4585492,442,23270,22828,0,0,0
4606616,fe0129cb-a835-11b5-f0e8-025f82985eac,64,4589768,4606535,4606616,4591419,81,16848,16767,0,0,0
4606676,5539af03-31ca-374b-6dfd-0eb2c5092507,32,4589286,4606367,4606636,4590206,269,17350,17081,0,0,0
4606915,79334b0d-4fbc-a9a2-8643-a1bf8eca5a2e,64,4589183,4606616,4606915,4591903,299,17732,17433,0,0,0
4607432,2db07db6-5524-3ed3-45d3-32bfa383da5c,32,4589220,4606915,4607432,4593836,517,18212,17695,0,0,0
4607492,f460bfc9-733e-d6d5-c997-3c42eeb3dae4,64,4589295,4606676,4607456,4592453,780,18161,17381,0,0,0
4608443,9e7fd43f-c69f-e531-1049-d5c62784376c,32,4598651,4607492,4608443,4603741,951,9792,8841,0,0,0
4608765,f8563880-a7f3-6fe3-da73-f6a1c17e09cb,64,4589049,4607432,4608765,4595502,1333,19716,18383,0,0,0
4609162,fa0c3ded-7f1b-b110-f97e-4c8f627f1fb9,64,4416820,4571368,4609162,4472038,37794,192342,154548,0,0,0
4613872,73693ec6-beb1-07de-91b7-059cadee8e72,32,4596978,4608765,4613872,4606974,5107,16894,11787,0,0,0
4636104,ff205932-b52d-13a4-c099-f0794bf1be8e,32,4415564,4584878,4636104,4494368,51226,220540,169314,0,0,0
4651036,926042fc-d9ca-be7d-a282-84faa0ab3e0b,64,4593637,4613872,4651036,4621312,37164,57399,20235,0,0,0
4654318,221f5888-785e-55c1-0896-6cbb4c221f54,64,4622719,4651036,4654318,4625523,3282,31599,28317,0,0,0
4658151,0a6052a8-0067-a623-f77f-34ff763b4dcb,64,4616139,4654318,4658151,4629072,3833,42012,38179,0,0,0
4668342,f7cb5f6d-690a-21b0-1ee3-7481d275dd36,64,4415565,4588425,4668342,4557236,79917,252777,172860,0,0,0
4679596,e2970c5b-6eea-d93d-816c-5b72c1a4b3c6,64,4594069,4658151,4679564,4637258,21413,85495,64082,0,0,0
4686354,2a8bbb69-316a-c24e-c2aa-78bd960cb0c1,64,4251751,4579423,4686354,4478961,106931,434603,327672,0,0,0
4686463,ee0c8608-a95a-29d8-d28d-2fb2814f513e,64,4415569,4609162,4686463,4618252,77301,270894,193593,0,0,0
4686652,2faa069d-1dfd-1b1c-a7a8-afb2dcc6e16c,64,4644987,4686354,4686652,4646653,298,41665,41367,0,0,0
4686942,2a7c908b-2147-a915-a708-c634bf9bdeb5,64,4645209,4686463,4686942,4648375,479,41733,41254,0,0,0
4687646,f7294fdd-bdb4-1c19-a8c3-e7feb69fed2a,64,4644774,4686652,4687646,4648844,994,42872,41878,0,0,0
4688056,8e23f880-a964-b0f1-5537-9e643985e732,64,4644910,4686942,4688056,4649378,1114,43146,42032,0,0,0
4688526,d6cc377e-bcfa-c962-ff43-b5a055d808d5,64,4651658,4688056,4688526,4652749,470,36868,36398,0,0,0
4688994,b8bc6453-6623-90ff-81dd-c9452f1f8d6c,64,4652736,4688526,4688994,4653772,468,36258,35790,0,0,0
4689212,3339ce51-7c22-b404-ed2f-28be07ec55bc,64,4645218,4687646,4689212,4650964,1566,43994,42428,0,0,0
4689272,a9e04d5e-fe83-aedb-deb6-f8b7b2fe4734,32,4652177,4688994,4689262,4654084,268,37085,36817,0,0,0
4690013,d42d5943-792e-5da7-d47e-7d2158d70124,64,4658872,4688994,4690013,4661379,1019,31141,30122,0,0,0
4690527,282a90b3-fb5a-1a92-e81c-9eceb3a03796,64,4665002,4690013,4690527,4669686,514,25525,25011,0,0,0
4693951,4bea44b7-ce90-fea6-0e13-f55e42312753,64,4664761,4690527,4693951,4671044,3424,29190,25766,0,0,0
4695807,1919fc29-dd6d-a9b5-7840-2141b0a7ae2b,64,4415568,4608443,4695807,4606808,87364,280239,192875,0,0,0
4697384,aef7e02d-c5c2-d80a-6212-e8387a5568c9,64,4664333,4693951,4697384,4671452,3433,33051,29618,0,0,0
4697912,9b9f64ae-f5d1-0858-dbbb-a542a5e9c13d,64,4668672,4695807,4697912,4672700,2105,29240,27135,0,0,0
4698172,1e06c08f-f2f7-0da4-9d32-fb8a9578843b,64,4672971,4697384,4698172,4674234,788,25201,24413,0,0,0
4698852,a8233b0a-5d0f-1116-7100-a86193d3478b,64,4674957,4698172,4698852,4679113,680,23895,23215,0,0,0
4699609,516c8225-7eac-608e-c9a4-34c91ef2b337,64,4615265,4679596,4699609,4642481,20013,84344,64331,0,0,0
4700527,bb2f3234-5b26-1fb4-3178-9e918cf7b28b,64,4673935,4699609,4700527,4680202,918,26592,25674,0,0,0
4701093,791f496d-28f9-3876-f433-b0718cd5cf85,64,4678278,4700527,4701093,4680919,566,22815,22249,0,0,0
4702943,b749a96e-ab6a-6e6f-d320-5f0a9bb376e8,64,4678162,4701093,4702943,4681292,1850,24781,22931,0,0,0
4703682,dc9b1ace-0761-da3f-f4f5-53220249e04c,64,4679543,4702943,4703682,4682018,739,24139,23400,0,0,0
4704580,473b16ec-da26-e317-00e6-2d3138347d9a,64,4673936,4703682,4704580,4682064,898,30644,29746,0,0,0
4741587,99376821-d5df-a2bf-a313-cf146b134ac1,64,4415565,4588362,4741587,4520993,153225,326022,172797,0,0,0
4742658,b556f426-aa7a-f008-7612-3d89c90f8e69,64,4679536,4741587,4742616,4682629,1029,63080,62051,0,0,0
4743594,09fd1928-cd8e-c8d5-a351-092721235164,64,4679586,4742658,4743594,4682942,936,64008,63072,0,0,0
4743895,99b79630-feec-16b8-c8fa-449224116f73,64,4679668,4743594,4743895,4684099,301,64227,63926,0,0,0
4744816,1f5f8523-649d-824e-a81f-1ada19f9445e,64,4679710,4743895,4744816,4684515,921,65106,64185,0,0,0
4745956,5ccbc965-144d-f4aa-144e-2297398b08dc,64,4683503,4744816,4745956,4685096,1140,62453,61313,0,0,0
4746993,e48ced3b-19e8-3b67-6d41-9f1cc502ca4f,32,4689952,4745956,4746993,4691565,1037,57041,56004,0,0,0
4750448,e08e2fcf-01b0-40b4-3b7d-f7a582d4052a,64,4415564,4586876,4750423,4506280,163547,334859,171312,0,0,0
4752159,1e77dfe3-b713-1d43-13bf-8eced57bf281,64,4415568,4668342,4752159,4637344,83817,336591,252774,0,0,0
4757315,00532bba-afc5-8bb4-5d4d-07d8beb9c6e7,64,4061744,4477701,4757315,4431463,279614,695571,415957,0,0,0
4757569,6f477c45-1163-7ce7-5d27-666ac69128ed,32,4733160,4757315,4757569,4735175,254,24409,24155,0,0,0
4757891,8b3f6c94-48a8-72ec-ce82-580269c475b4,32,4733818,4757569,4757891,4737177,322,24073,23751,0,0,0
4758447,7edd2adc-60a1-cac0-a215-3c9a3f127937,32,4733251,4757891,4758447,4737418,556,25196,24640,0,0,0
4758837,f8e4621d-c7a7-d45d-b0e0-de41d6f0269a,32,4740949,4758447,4758837,4742877,390,17888,17498,0,0,0
4758981,d7790189-6c54-4ae0-68c1-646a42885c09,32,4741923,4758837,4758981,4742905,144,17058,16914,0,0,0
4759213,92811d91-c6a6-6ec2-dd91-d67b3f64b49e,32,4741447,4758981,4759213,4743237,232,17766,17534,0,0,0
4759319,95cb6169-4d29-83dd-b019-2cf2fd9e4520,32,4743428,4759213,4759319,4743761,106,15891,15785,0,0,0
4759547,d44cceb3-5055-cb9b-7d0f-236c1bb6b098,32,4742944,4759319,4759547,4743905,228,16603,16375,0,0,0
4759872,3413fdca-c6c9-dbf1-17b9-91e84e625a5b,32,4742708,4759547,4759872,4744000,325,17164,16839,0,0,0
4760996,5ccfadcd-a9de-3b5d-a9c8-ec82cead2e4e,32,4741346,4759872,4760996,4744518,1124,19650,18526,0,0,0
4761167,ae10c52b-de8f-c21f-fed7-9c724315cf47,32,4743187,4760996,4761167,4744613,171,17980,17809,0,0,0
4761395,eff0dccb-0ed0-653c-2a84-6ba7179cdfbc,32,4744075,4761167,4761395,4744892,228,17320,17092,0,0,0
4761801,450c339f-327d-1901-f4e3-65108c00db61,32,4743272,4761395,4761801,4745055,406,18529,18123,0,0,0
4762302,49793f32-7fc7-4402-4ada-c4b2a9b1345d,32,4743745,4761801,4762302,4745183,501,18557,18056,0,0,0
4764159,5cc62a30-c2e6-f058-9c69-32b64caef27a,32,4741484,4762302,4764159,4745938,1857,22675,20818,0,0,0
4764826,fb5498c8-a5ba-2edd-3f9a-2833d320d3b2,32,4741730,4764159,4764826,4746364,667,23096,22429,0,0,0
4765668,e643692c-ab1f-7fd2-5be8-ebee52550548,32,4746569,4764826,4765656,4748257,830,19087,18257,0,0,0
4765745,e437e45d-ad73-4c4b-9918-91125e1b4741,32,4749207,4765668,4765745,4750110,77,16538,16461,0,0,0
4766008,5f69844a-93bd-cc24-bbb7-391cbeb4d61d,32,4749449,4765745,4766008,4750673,263,16559,16296,0,0,0
4766289,ddf2a4f4-d43f-3ee2-7964-ef475a0cfe30,32,4749667,4766008,4766289,4750862,281,16622,16341,0,0,0
4766589,3a3b63c7-1048-3ff8-a8cf-d0ab4bec31ac,32,4749662,4766289,4766589,4750878,300,16927,16627,0,0,0
4766823,8cffbbb8-b9f7-b0af-9a32-bb791ebed4d6,64,4602292,4704580,4766823,4682135,62243,164531,102288,0,0,0
4766823,e7238a83-0e24-1b24-fe15-e939006f96de,32,4749540,4766589,4766823,4750968,234,17283,17049,0,0,0
4767034,e1a3ee4f-2b40-04c2-a946-4c3433e43d2a,32,4749876,4766823,4767034,4751015,211,17158,16947,0,0,0
4767245,806147ab-6b75-7970-36c3-e23294019349,32,4750062,4767034,4767245,4751136,211,17183,16972,0,0,0
4767401,bfc3965a-984e-0613-ec20-6c6b3a7527f8,64,4749906,4766823,4767401,4751014,578,17495,16917,0,0,0
4767687,cafe77fe-5302-6467-17d2-cf2661d2549e,32,4749873,4767245,4767687,4751171,442,17814,17372,0,0,0
4768035,ef6ee4b4-dbdc-2460-4e59-09d7880753ad,64,4749628,4767401,4768035,4751201,634,18407,17773,0,0,0
4768262,12dc1332-870e-1c13-f5e3-62eb6c17f962,32,4749538,4768035,4768262,4751244,227,18724,18497,0,0,0
4768532,aaf3cecc-12bc-819a-73b8-a7c723570a5e,32,4749598,4768262,4768532,4751255,270,18934,18664,0,0,0
4768592,9adc0718-9f12-e5b3-9fc2-02eb7a4b93f6,64,4749653,4767687,4768563,4751219,876,18910,18034,0,0,0
4769007,8cccaeb3-e9b5-0986-43fa-985925dc1309,32,4749658,4768592,4769007,4751390,415,19349,18934,0,0,0
4769229,717fddbb-68a4-1bbb-33f1-0d0a0a05fc8d,64,4750125,4768532,4769229,4751286,697,19104,18407,0,0,0
4769289,16a3baaa-7263-694e-f569-a8375ea07e79,64,4750116,4769007,4769245,4751398,238,19129,18891,0,0,0
4769443,ea2babf3-e23a-380b-5593-4c5f00f52497,64,4750388,4769229,4769443,4751427,214,19055,18841,0,0,0
4769537,0a1030ab-5dc0-8438-539d-2ee85cb085e1,64,4684217,4746993,4769537,4696121,22544,85320,62776,0,0,0
4769828,a543e0c0-5fec-8ac7-365a-b019a3d6caf2,64,4749877,4769443,4769828,4751502,385,19951,19566,0,0,0
4769919,19d0cc8d-38be-52c8-99b7-8f1ca8e4bedd,64,4749997,4769289,4769919,4751461,630,19922,19292,0,0,0
4769979,b8c0ca16-f2cb-1572-772b-1ed93fce3160,64,4749970,4769537,4769952,4751505,415,19982,19567,0,0,0
4770076,dcb01fcd-f2e0-a882-ce63-3c1f0579dfc8,64,4749878,4769828,4770076,4751519,248,20198,19950,0,0,0
4770286,ed5da46b-d9ec-1044-0f8e-d8194e2de2f4,64,4749952,4769919,4770286,4751614,367,20334,19967,0,0,0
4770380,57bcd50c-6c7f-15c5-3ea4-178c775ba4fe,64,4750171,4769979,4770380,4751628,401,20209,19808,0,0,0
4770449,23bd7e5d-4748-b74c-a1d8-aab3b57731b0,64,4750092,4770076,4770449,4751710,373,20357,19984,0,0,0
4770647,b240e64b-96e5-8e4d-42ce-cb1995326af8,32,4749849,4770449,4770647,4751762,198,20798,20600,0,0,0
4770748,70bce799-308c-78c0-ec1d-b8710dcabd8a,64,4750256,4770380,4770748,4751761,368,20492,20124,0,0,0
4771096,c961397f-7da0-dddf-ec89-bae126ffa74c,64,4749911,4770286,4771096,4751712,810,21185,20375,0,0,0
4771390,fe5d75b3-7892-bd2c-760e-08b2764f8365,64,4749667,4770647,4771390,4751907,743,21723,20980,0,0,0
4771592,adf05a76-b8ce-78f6-31f6-d1de8122e7f6,32,4749629,4771096,4771592,4751970,496,21963,21467,0,0,0
4771654,f6b9bc93-0bf3-6d4f-6e1f-6ba536d38c50,64,4749449,4770748,4771654,4751930,906,22205,21299,0,0,0
4772014,2513673b-d189-d6b5-d542-a1efe0911435,64,4749815,4771592,4772014,4752060,422,22199,21777,0,0,0
4772074,2902a38c-9747-332f-acda-df811dab372e,64,4749815,4771654,4772030,4752063,376,22215,21839,0,0,0
4772145,3e5d9f2a-366e-b52b-65bf-a0d1037d94a7,64,4749508,4771390,4772145,4751975,755,22637,21882,0,0,0
4772291,c21df960-992e-eba3-9997-2e5d89d8afdd,64,4749880,4772074,4772291,4752076,217,22411,22194,0,0,0
4772364,9429c892-1f06-9cfe-4786-c6680e033c96,64,4749414,4772145,4772364,4752157,219,22950,22731,0,0,0
4772431,ffe2ed74-cb20-b628-806e-930089bf4761,32,4749820,4772014,4772431,4752066,417,22611,22194,0,0,0
4772696,1d83787d-c547-af49-e2ec-6e0fea235272,32,4750055,4772431,4772696,4752457,265,22641,22376,0,0,0
4772799,a2046bf6-c4ee-69aa-fd88-7093be48da6b,64,4749873,4772291,4772799,4752200,508,22926,22418,0,0,0
4773173,63d33f97-b5ae-be64-cfc8-993dd9d4ba45,64,4749328,4772696,4773173,4752480,477,23845,23368,0,0,0
4773233,1d89ebf2-f32f-f41a-782b-1af1fa4501b3,64,4749547,4772364,4773205,4752365,841,23658,22817,0,0,0
4773233,6378c2ed-b810-4910-9e21-09d720e56c13,64,4750090,4772799,4773231,4752546,432,23141,22709,0,0,0
4773951,354defdb-6778-375d-a11f-bb68359b1c91,64,4749876,4773233,4773951,4752824,718,24075,23357,0,0,0
4774021,b52ab533-bc9a-2e3d-f757-29ce52cf0820,64,4750124,4773233,4774021,4752883,788,23897,23109,0,0,0
4774081,4e507f13-bbb1-32cf-45fb-78a748bba2df,64,4750228,4773173,4774027,4752572,854,23799,22945,0,0,0
4774840,7bf5312e-02bb-3a79-07f0-b657e85704a2,64,4749844,4773951,4774840,4752930,889,24996,24107,0,0,0
4774840,bc5ab867-232f-0d4f-6465-73f13dc76892,64,4751504,4774021,4774840,4752940,819,23336,22517,0,0,0
4775020,c4b94828-e717-1cc1-0228-da311a2e6e37,64,4749861,4774081,4775005,4752987,924,25144,24220,0,0,0
4775231,cc320c0f-7e27-b1e1-8752-3f42c03d3135,64,4749878,4774840,4775231,4753105,391,25353,24962,0,0,0
4775308,80913daa-3da5-63ef-d2d4-7e27277242a3,64,4750033,4774840,4775308,4753024,468,25275,24807,0,0,0
4775481,7701a54f-6fa8-2c71-92f4-329f8c94ff05,32,4751233,4775020,4775481,4753382,461,24248,23787,0,0,0
4775720,1860af78-8362-e8b7-903a-99046674406b,32,4750412,4775231,4775720,4753577,489,25308,24819,0,0,0
4775780,7285f284-82b1-e684-e2ab-7d7caccc2cbb,64,4752291,4775308,4775734,4754060,426,23443,23017,0,0,0
4776039,8339cc52-4ff8-ab63-ade5-5a0820848038,64,4750174,4775231,4776002,4753658,771,25828,25057,0,0,0
4776219,b41e70e8-5a1a-3a61-5e1e-20171e43d2b9,64,4752346,4775720,4776201,4754079,481,23855,23374,0,0,0
4776279,1ea32b82-33be-f092-0490-c96e8d0d0d29,64,4751419,4775780,4776220,4754127,440,24801,24361,0,0,0
4776339,7d9d3b89-f07a-7145-6dd5-26df3127b938,64,4752099,4776039,4776309,4754304,270,24210,23940,0,0,0
4777011,e5713717-bc25-6aeb-c415-3cabef513789,64,4753149,4776219,4776971,4754366,752,23822,23070,0,0,0
4777181,b3ddb61e-cd77-bf7e-af68-bf0aa1544001,64,4751373,4776339,4777181,4754975,842,25808,24966,0,0,0
4777282,c053b8d4-a6cc-a9a5-4d39-aa69776132d8,64,4751422,4776279,4777282,4754641,1003,25860,24857,0,0,0
4777402,24bb3725-181e-d207-fbcf-5ed737eedff1,64,4752594,4777181,4777359,4755464,178,24765,24587,0,0,0
4777505,583f3332-0fd3-8dbf-8dd9-29e0fba8a311,64,4752994,4777011,4777505,4755458,494,24511,24017,0,0,0
4777655,eed42657-f6c1-1c46-3822-3dfca7096316,64,4756342,4777505,4777655,4757226,150,21313,21163,0,0,0
4777785,34638d3f-8444-c17d-b031-af0be6a5ca4d,32,4752505,4777282,4777785,4756033,503,25280,24777,0,0,0
4777931,6dd96ec9-4e4e-1ebf-6428-0da5e6d46bad,32,4756867,4777785,4777931,4757676,146,21064,20918,0,0,0
4778053,191cea20-cc4d-d8a8-8e05-4fdc7e1e2994,64,4756594,4777655,4778053,4757277,398,21459,21061,0,0,0
4778113,7c62f2ee-cf31-be3d-a80e-2a1c51580bd3,64,4755782,4777931,4778075,4757702,144,22293,22149,0,0,0
4778438,79ef1c2c-f308-f8b2-91c4-f38446234365,32,4762799,4778113,4778438,4764043,325,15639,15314,0,0,0
4778498,c6b8e85d-3e62-d5a8-b2ea-828541ceeb37,64,4755335,4777402,4778443,4756675,1041,23108,22067,0,0,0
4778572,90390c2e-4d6f-6aa9-83c6-2bd2cecf01ab,32,4765144,4778498,4778572,4765627,74,13428,13354,0,0,0
4778632,4d831863-b33c-16ca-aa04-d16e05f3b33b,64,4763800,4778438,4778628,4765295,190,14828,14638,0,0,0
4778860,68659857-04d5-db92-63aa-6b823ef24b98,64,4765608,4778572,4778812,4766296,240,13204,12964,0,0,0
4779032,92cb11fd-319e-3394-5975-5f5e86b3374e,32,4764914,4778860,4779032,4766656,172,14118,13946,0,0,0
4779191,757c9d22-34b3-d86f-b012-358b41418e46,64,4765374,4778632,4779191,4766636,559,13817,13258,0,0,0
4779561,1da70d8b-d3d4-5ebd-6fda-3789d701d8a1,32,4766104,4779191,4779561,4766996,370,13457,13087,0,0,0
4779621,977b95d6-55d2-215d-562e-4c330b596674,64,4762789,4779032,4779617,4766976,585,16828,16243,0,0,0
4779877,4a598882-409e-f1d1-2750-f40a67ce92ba,64,4765872,4779561,4779877,4767071,316,14005,13689,0,0,0
4779974,e73871a1-7d13-a2a3-ee76-3cf40b55e9f3,64,4766119,4779621,4779974,4768466,353,13855,13502,0,0,0
4780142,087cf1ac-f8c1-d222-1a41-3ec73db6e6f7,64,4767706,4779877,4780142,4768676,265,12436,12171,0,0,0
4781091,cffce595-0a62-6589-9e9c-bd5ad5860c18,32,4771294,4780142,4781091,4775364,949,9797,8848,0,0,0
4781357,5f19a28b-f3a0-b0a7-a870-1dd1ae7fa7a0,32,4774903,4781091,4781357,4776115,266,6454,6188,0,0,0
4781778,99e235d4-a989-73f3-a34a-8573cb2428c2,32,4776263,4781357,4781778,4777258,421,5515,5094,0,0,0
4781986,b9d2c9f3-c473-3fd6-244c-c94267f5b865,32,4776050,4781778,4781986,4777268,208,5936,5728,0,0,0
4782158,de29e205-6d0d-6a98-a100-b8a2e4165c92,32,4776091,4781986,4782158,4777405,172,6067,5895,0,0,0
4782945,b1b7b542-a761-08d6-7059-c95818726379,32,4776130,4782158,4782945,4777578,787,6815,6028,0,0,0
4784288,dd9fd016-d6fd-9d6a-63c6-bb6420cf16bc,32,4776331,4782945,4784288,4777589,1343,7957,6614,0,0,0
4784925,5bfd9227-ff93-b853-f457-757145473973,32,4776264,4784288,4784925,4777592,637,8661,8024,0,0,0
4785644,d78a4011-748a-df61-c930-f724afa04cdd,32,4776086,4784925,4785644,4777666,719,9558,8839,0,0,0
4786081,a1caf1c2-3899-74cb-0336-8205feb182ea,32,4776122,4785644,4786081,4777681,437,9959,9522,0,0,0
4786462,6044f6b7-26d8-d73f-6f49-8cdb0c7952cb,32,4776053,4786081,4786462,4777695,381,10409,10028,0,0,0
4786960,c654d1d0-3ffa-592f-d75b-3c4d65d28869,32,4776096,4786462,4786960,4777742,498,10864,10366,0,0,0
4788081,0ee91a57-a19f-b679-96ac-5334887da902,32,4776054,4786960,4788081,4777775,1121,12027,10906,0,0,0
4788545,f700265c-4fec-59e9-c34f-880d73dbcd01,64,4742598,4779974,4788545,4771760,8571,45947,37376,0,0,0
4788740,74d503cd-d1e3-716c-1255-67bce837be9b,32,4776207,4788545,4788740,4777845,195,12533,12338,0,0,0
4788871,845394c3-6a91-2140-007a-5396dd8f0fb3,64,4776758,4788081,4788871,4777809,790,12113,11323,0,0,0
4789259,60f4c789-50be-6323-a33d-a8b1ffadfb0e,64,4776203,4788740,4789259,4777900,519,13056,12537,0,0,0
4789447,3ed0c514-514f-652f-854d-f41bd24d7603,32,4776050,4789259,4789447,4777936,188,13397,13209,0,0,0
4789605,bd6cd795-6399-398d-ba3e-2e3f8c5c913a,64,4776324,4788871,4789605,4777919,734,13281,12547,0,0,0
4790037,b481e163-4563-f943-cdcc-90154f8aa6f8,32,4776451,4789605,4790037,4777999,432,13586,13154,0,0,0
4790182,150218b1-0759-d3c1-a9ab-8f6968de035f,64,4776123,4789447,4790182,4777964,735,14059,13324,0,0,0
4790375,3b026fab-9c6a-ee67-2d1b-be3e9b2be183,64,4776206,4790037,4790375,4778042,338,14169,13831,0,0,0
4790435,99f2b80d-6ae1-0bed-2368-c5d3a30891e5,64,4776051,4790182,4790403,4778048,221,14352,14131,0,0,0
4791143,da0a4d13-834e-d2c5-5d83-04f5fb035a6d,64,4776144,4790375,4791143,4778076,768,14999,14231,0,0,0
4791634,8e7a5996-d495-ef8f-ef72-212480eaf3f5,32,4776123,4791143,4791634,4778252,491,15511,15020,0,0,0
4791800,c121ea55-2ebd-5f06-163c-b16c9a4363ad,32,4604690,4745956,4791800,4691219,45844,187110,141266,0,0,0
4791945,6cf036af-c71a-ae10-adf9-72a6ec34576e,64,4776087,4790435,4791945,4778241,1510,15858,14348,0,0,0
4792215,d6c803f5-deda-6570-cce1-2e8b0e81b96d,64,4776124,4791945,4792215,4778339,270,16091,15821,0,0,0
4793039,668b1d14-320f-5e32-c42f-b7eb485deadc,64,4776019,4792215,4793039,4778351,824,17020,16196,0,0,0
4793104,ddb3f3be-d265-3f9b-d97c-6cbca1f255c9,64,4776208,4791634,4793104,4778310,1470,16896,15426,0,0,0
4793296,c8bba5bd-0eec-c9c5-f348-e658441b2595,64,4776052,4793104,4793296,4778420,192,17244,17052,0,0,0
4793356,7d0b1599-0d6a-4835-3212-ee3b16198e74,64,4776207,4793039,4793306,4778408,267,17099,16832,0,0,0
4793499,f93ebbad-95c7-b4cf-4d4e-8d9a67bd2b2f,64,4776050,4793356,4793499,4778457,143,17449,17306,0,0,0
4793559,390a82ed-3e6b-6684-d2d6-9319504930fb,64,4776328,4793296,4793524,4778443,228,17196,16968,0,0,0
4793692,ce96dc3e-0405-d4b3-5e0c-cb8c24041592,64,4776130,4793559,4793692,4778498,133,17562,17429,0,0,0
4794077,754a9c92-0b23-6443-ce4a-b39a74615af8,64,4776332,4793692,4794077,4778506,385,17745,17360,0,0,0
4794137,a3a45b1f-65f6-f973-786d-33080cd3e357,64,4776022,4793499,4794110,4778468,611,18088,17477,0,0,0
4794284,63d7599d-9931-82bd-7058-b440050be25e,64,4776122,4794137,4794284,4778585,147,18162,18015,0,0,0
4794646,50e9636e-197d-e8b1-d61b-14dd45f11959,64,4776128,4794284,4794646,4778615,362,18518,18156,0,0,0
4794909,3671544c-5d79-514e-f78a-85e2057e0eb8,64,4776951,4794077,4794909,4778507,832,17958,17126,0,0,0
4795251,cb95e9d7-b05d-c47f-9367-c82a8b49c017,64,4776140,4794909,4795251,4778657,342,19111,18769,0,0,0
4795371,60d0f201-9d89-9652-be0f-d219b1d73ebb,64,4776050,4795251,4795371,4778659,120,19321,19201,0,0,0
4795431,b448f2c7-3629-e97f-5599-6c3f8e0bcc04,64,4776207,4794646,4795427,4778637,781,19220,18439,0,0,0
4795503,15dff492-c399-fc1b-0883-80216e6da80e,64,4776265,4795371,4795503,4778669,132,19238,19106,0,0,0
4795648,e5b6881f-de18-4422-b943-dd6d1c5465c2,64,4776264,4795431,4795648,4778727,217,19384,19167,0,0,0
4795889,14c0965a-1c0c-cce4-8094-2743fe9f9fd2,64,4776267,4795648,4795889,4778822,241,19622,19381,0,0,0
4796283,7738b5f2-7109-f31f-7116-4bdefdef397e,64,4776087,4795889,4796283,4778840,394,20196,19802,0,0,0
4796343,350eed08-0755-85d4-57b7-7db1329e3316,64,4776122,4795503,4796284,4778746,781,20162,19381,0,0,0
4796899,a05ce790-10fa-7403-f722-2f0a99c9808b,64,4776454,4796343,4796899,4779036,556,20445,19889,0,0,0
4797071,5c605c5e-7389-1a56-d7f7-c87171483cf3,64,4776208,4796283,4797071,4778915,788,20863,20075,0,0,0
4797904,7a49af78-5ab5-f2f2-08f0-a65c717528ab,64,4776513,4797071,4797904,4779087,833,21391,20558,0,0,0
4797964,ba5c614b-5142-1722-3b43-8b28b6e3c816,64,4776214,4796899,4797908,4779041,1009,21694,20685,0,0,0
4798190,f03c55e2-8537-6413-8a8c-7508c516e5e6,64,4776205,4797964,4798190,4779135,226,21985,21759,0,0,0
4798253,22e3495a-6deb-74ec-879f-73a656337eb8,64,4776204,4797904,4798253,4779126,349,22049,21700,0,0,0
4798656,ed3e7a7e-6e52-6f8d-4f97-21c6ae0ebf4c,64,4775979,4798253,4798656,4779209,403,22677,22274,0,0,0
4798901,44bbf740-af2c-45a5-b645-f77df0d56702,64,4776580,4798656,4798901,4779219,245,22321,22076,0,0,0
4799147,d63e5fab-6575-c645-d8f6-95890358ffa6,64,4776123,4798190,4799147,4779152,957,23024,22067,0,0,0
4799207,3ac49257-9492-a6b8-ac18-0269d764da5e,64,4776085,4798901,4799151,4779227,250,23066,22816,0,0,0
4799401,f62d6b3f-1af4-6a2c-fbbd-96633ea025bb,64,4776129,4799147,4799401,4779365,254,23272,23018,0,0,0
4799617,d2f33de9-abb2-e4e5-6d3e-341ae8a36565,64,4776264,4799207,4799617,4779394,410,23353,22943,0,0,0
4799697,22fdbe29-ffae-6e6f-72a2-4fd27eede4cd,64,4775623,4799401,4799697,4779512,296,24074,23778,0,0,0
4799979,3004c292-e610-4c9b-b5c9-2d182eecc8cd,64,4742308,4778053,4799979,4762412,21926,57671,35745,0,0,0
4800081,ec0016b9-948c-0aab-dbba-3ea0cadcee97,64,4776452,4799617,4800081,4779759,464,23629,23165,0,0,0
4800530,b7dc58e3-b698-0006-be52-2b178a553c09,64,4777313,4800081,4800530,4779994,449,23217,22768,0,0,0
4800688,79510b8d-6084-3163-51c8-22bc36841328,64,4777700,4799979,4800688,4779912,709,22988,22279,0,0,0
4800922,9da52d82-39b8-aa87-9963-7a7563e078dd,64,4776815,4800530,4800922,4779998,392,24107,23715,0,0,0
4801058,8d231692-5571-169d-e1ce-2805b8777b45,64,4778800,4800922,4801058,4780153,136,22258,22122,0,0,0
4801139,9d8ecce5-50de-6473-b019-16f21dc5eb1b,64,4776209,4800688,4801139,4780008,451,24930,24479,0,0,0
4801328,2c403d97-a7ee-8ec8-6aa0-4b1b26f205b3,64,4776205,4799697,4801328,4779855,1631,25123,23492,0,0,0
4826786,11b67738-43ed-0e83-30df-d90c0af6d6d5,32,4751659,4801328,4826786,4806634,25458,75127,49669,0,0,0
4857386,de35c890-7dc7-d8fd-a44b-a6e94e8920da,32,4775065,4826786,4857386,4808671,30600,82321,51721,0,0,0
4914615,6d50f3e7-26db-60fe-2353-b00ab55bea55,32,4617885,4801139,4914615,4796780,113476,296730,183254,0,0,0
4955029,72c33830-83c3-8cf5-c9d3-9b80f02bff35,64,4700406,4801139,4955029,4800494,153890,254623,100733,0,0,0
4960461,adaf21ac-a4c8-15c4-2dbb-d714b1b5033a,64,4599611,4801058,4960461,4783647,159403,360850,201447,0,0,0
4961503,7a7882f1-5814-8e5b-d6bd-53b9f93018d0,64,4820273,4960461,4961503,4824681,1042,141230,140188,0,0,0
4963258,d9daa6a6-f475-0a93-8f74-19fb3b15a807,64,4801745,4955029,4963258,4813970,8229,161513,153284,0,0,0
4963842,10bb65a3-f9ef-063f-ec66-0769f533bd9f,64,4825275,4963258,4963842,4826482,584,138567,137983,0,0,0
4964019,c65b8e2b-bf12-dc18-32e5-9782a023bda4,64,4825386,4963842,4964019,4826900,177,138633,138456,0,0,0
4965036,758919a8-8d0e-32c8-d17d-d36f78d340bd,64,4829245,4964019,4965036,4832598,1017,135791,134774,0,0,0
4965526,b6297262-b588-3b05-85d5-1a5f952a2422,64,4831600,4965036,4965526,4833451,490,133926,133436,0,0,0
4965795,9f250e59-ea67-dda8-1936-a2c97fd3c0b5,64,4832094,4965526,4965795,4833601,269,133701,133432,0,0,0
4965922,810d9c1a-a338-6467-2193-64d1fbd199c1,64,4832575,4965795,4965922,4833984,127,133347,133220,0,0,0
4966205,8bdf44cd-4979-142b-1b88-7fa4949110af,64,4833447,4965922,4966205,4834084,283,132758,132475,0,0,0
4966303,6d1eb6fb-d81f-899e-f0fd-3956b65c2f9b,64,4833204,4966205,4966303,4834349,98,133099,133001,0,0,0
4966363,357733f8-d92a-e797-5086-e2f313c7d8e9,64,4833974,4966303,4966344,4834381,41,132370,132329,0,0,0
4966681,bb2a9335-4a4c-c097-6802-14ac78c292dd,64,4833730,4966363,4966681,4834684,318,132951,132633,0,0,0
4966893,8d59a0ee-d0fd-576a-d9a2-b7c71ae41748,64,4834457,4966681,4966893,4835170,212,132436,132224,0,0,0
4976682,1f900fc4-eb0d-7f87-144f-69f632835376,64,4363702,4698852,4976682,4680162,277830,612980,335150,0,0,0
4976997,d20fe0b0-d789-02a2-78f1-762fb82b1903,64,4834218,4976682,4976997,4835898,315,142779,142464,0,0,0
4977826,d3588497-121e-aeea-9bef-b060f75b3a1f,64,4835151,4976997,4977826,4836884,829,142675,141846,0,0,0
4978188,eb3b1428-9add-db9f-edb8-6bc77cf6771a,64,4835748,4977826,4978188,4837985,362,142440,142078,0,0,0
4978614,97071445-e4ca-20f5-0e81-cbbd15e4486f,64,4837563,4978188,4978614,4838598,426,141051,140625,0,0,0
4979125,d9b775b5-a198-73a7-ba0e-0fbbf50759f5,64,4835343,4978614,4979125,4838709,511,143782,143271,0,0,0
4979781,00ea25f2-ccb4-1497-3382-73891902a7e6,64,4837634,4979125,4979781,4838764,656,142147,141491,0,0,0
4980230,4223cd4a-04c3-edf5-d417-eb6c0c81ab53,64,4837632,4979781,4980230,4838867,449,142598,142149,0,0,0
4980625,79f8573e-ea03-f1a5-4004-b62dde49a2e7,64,4837683,4980230,4980625,4838916,395,142942,142547,0,0,0
4980982,0f41c628-57f4-aba7-da90-d76cb9b3e516,64,4837899,4980625,4980982,4838976,357,143083,142726,0,0,0
4981195,01cad913-71e5-d9a2-a52b-0e5dcbdab212,64,4837746,4980982,4981195,4839024,213,143449,143236,0,0,0
4981568,37a00cb9-1efe-a670-cfbc-3ad1c0e8d057,32,4837743,4981195,4981568,4839182,373,143825,143452,0,0,0
4981628,c84044b3-3759-9cb4-c046-745aae9080db,32,4837633,4981195,4981626,4839053,431,143993,143562,0,0,0
4981725,da9d165b-89ee-7ca5-456c-27fd12bfe52d,64,4837684,4981568,4981725,4839216,157,144041,143884,0,0,0
4982125,876812a9-63f9-77b0-8fd4-c3463be903c4,64,4837899,4981725,4982125,4839259,400,144226,143826,0,0,0
4982254,a972e063-1a8d-393e-4295-ecbd1002767d,64,4837636,4982125,4982254,4839314,129,144618,144489,0,0,0
4983095,bc9548b7-ad65-4590-85db-e1f64d510fa8,64,4837848,4982254,4983095,4839329,841,145247,144406,0,0,0
4983360,d4d2db94-52ef-6d50-e330-27bb31b419a3,64,4837705,4983095,4983360,4839343,265,145655,145390,0,0,0
4983788,e239c528-cd1f-24fd-20c0-810ba8777322,64,4774890,4966893,4983788,4835724,16895,208898,192003,0,0,0
4984021,6069cd2e-eb3b-72f9-e980-ff949bfd62c7,64,4837713,4983788,4984021,4839415,233,146308,146075,0,0,0
4984143,637d85e0-7ed0-0d6b-80f2-fd0e2ddf3fd4,64,4838037,4983360,4984143,4839414,783,146106,145323,0,0,0
4984238,81a39dce-a488-008f-2c01-85b46324b423,64,4837742,4984021,4984238,4839473,217,146496,146279,0,0,0
4984367,422fdf53-1459-3ddf-790c-3b1b2a18539d,64,4837787,4984143,4984367,4839533,224,146580,146356,0,0,0
4984513,15b6a26b-9e1b-821a-cee7-948aefbfaa21,64,4397328,4750448,4984513,4699899,234065,587185,353120,0,0,0
4984573,99c13484-6c4f-f6be-336b-172e488bc5ed,32,4837680,4984143,4984543,4839491,400,146863,146463,0,0,0
4984856,7786054d-2f1d-2740-481c-f66719daed7b,32,4837900,4984367,4984856,4839589,489,146956,146467,0,0,0
4985059,eaa6cf47-8451-84eb-2365-ece51c4a6051,64,4837849,4984238,4985059,4839534,821,147210,146389,0,0,0
4985292,30b1c5c7-16c9-8b8a-7430-7002ad9271dd,64,4837817,4985059,4985292,4839676,233,147475,147242,0,0,0
4985438,7217ffcb-0835-172b-7f83-637ba144fc15,64,4837762,4984573,4985438,4839649,865,147676,146811,0,0,0
4985578,46c45c34-0533-9053-8274-a1629b6b18c7,64,4837701,4985438,4985578,4839781,140,147877,147737,0,0,0
4985919,2304af49-a898-fdd4-571d-bbbe33bf772a,64,4837680,4985578,4985919,4839799,341,148239,147898,0,0,0
4986064,895e4095-2a1e-cd8c-62fc-7ca524b5591c,64,4838110,4984513,4986064,4839589,1551,147954,146403,0,0,0
4986225,8680be8b-6e49-0e45-a8c2-6c1713a6671f,64,4837896,4985292,4986225,4839709,933,148329,147396,0,0,0
4986413,3a4a2c34-2199-94cb-a815-11432440bcf0,32,4838614,4985919,4986413,4839813,494,147799,147305,0,0,0
4986473,df470050-fe6e-362a-32db-6cd7ed0dc446,64,4837701,4985919,4986447,4839837,528,148746,148218,0,0,0
4986473,4801ced6-ab5e-d464-569c-82883add5c08,64,4837683,4986225,4986459,4839928,234,148776,148542,0,0,0
4986795,222218cc-e305-50cf-e47d-de08fbf664ef,64,4837742,4986064,4986795,4839905,731,149053,148322,0,0,0
4987023,4b2910bb-1b04-c1f3-abb9-a7ad14052ce5,64,4837833,4986795,4987023,4840037,228,149190,148962,0,0,0
4987245,3c14cbd7-8549-072c-87e8-0e539e8e9235,64,4837623,4987023,4987245,4840057,222,149622,149400,0,0,0
4987368,33d34051-92b5-b642-81b6-c680a69c503d,64,4837788,4986473,4987368,4840007,895,149580,148685,0,0,0
4987428,6ef0702e-01a4-89ac-510e-a0bbe9507945,64,4837673,4987245,4987369,4840060,124,149696,149572,0,0,0
4987428,f18d23be-1c14-6503-4ad9-1b8caaecb77e,64,4838041,4986473,4987386,4839933,913,149345,148432,0,0,0
4987685,86615979-3663-4a91-7aeb-dc73043e27f6,64,4838540,4987428,4987685,4840103,257,149145,148888,0,0,0
4987745,35f8eeb4-f9ce-d3c7-9d50-271aef79925c,64,4837848,4987368,4987739,4840062,371,149891,149520,0,0,0
4988090,28e2c3bf-cd5d-b9e1-71d2-676a2bf67532,64,4837670,4987745,4988090,4840228,345,150420,150075,0,0,0
4988215,da73ed50-cd35-85f4-488f-0afd71cf8582,64,4837533,4988090,4988215,4840229,125,150682,150557,0,0,0
4988454,b9b77653-1e7d-7e1b-4110-17d3a9b91dcd,64,4838340,4988215,4988454,4840264,239,150114,149875,0,0,0
4988514,295ea8bd-d387-24f1-2a60-f7a51b768a44,64,4837626,4987685,4988504,4840139,819,150878,150059,0,0,0
4988740,1b7810a0-58b3-60cf-1314-4c013b1d0b20,64,4837612,4987428,4988740,4840123,1312,151128,149816,0,0,0
4988834,69a58054-5c94-a47b-1bfb-d8309cb97eeb,64,4837932,4988454,4988834,4840266,380,150902,150522,0,0,0
4989135,3ef62670-c885-da14-4623-1597097f7eee,64,4837738,4988740,4989135,4840334,395,151397,151002,0,0,0
4989264,92db0257-9b73-afc3-572e-4a21fae113fe,64,4837762,4988514,4989264,4840276,750,151502,150752,0,0,0
4989421,47aedc16-a75c-1316-6ca6-60537b38b341,64,4838038,4988834,4989421,4840365,587,151383,150796,0,0,0
4989688,7b260f44-50ed-42d9-a857-e1e8e30bcc40,64,4837649,4989264,4989688,4840481,424,152039,151615,0,0,0
4989808,bd73563b-311d-a4ca-11aa-593b970283b3,64,4837623,4989135,4989808,4840454,673,152185,151512,0,0,0
4990305,214d641a-ede6-9ed8-1398-38cfa4f4dea6,64,4838037,4989421,4990305,4840522,884,152268,151384,0,0,0
4990546,07d6aa28-7372-0283-ac20-edfb5f3c873b,64,4837764,4989808,4990490,4840631,682,152726,152044,0,0,0
4990606,797d1620-c130-5618-5e59-1ecb260ec27e,64,4838738,4989688,4990587,4840544,899,151849,150950,0,0,0
4990699,78c3d137-448e-3ce8-ee56-d4e6384052af,64,4837818,4990546,4990699,4840654,153,152881,152728,0,0,0
4991093,7c060bd5-99fc-2623-2269-4a390d154bbd,64,4837741,4990305,4991093,4840636,788,153352,152564,0,0,0
4991153,1013fc17-5294-63bc-6bfd-db15b6799867,64,4839553,4990699,4991099,4840781,400,151546,151146,0,0,0
4991394,3e8be5a2-47e6-6f66-fa14-00e797b415cb,64,4837899,4990606,4991394,4840666,788,153495,152707,0,0,0
4991454,44ab18b2-ffef-3349-2c61-2bfc06ddb464,64,4837762,4991153,4991396,4840991,243,153634,153391,0,0,0
4991514,25d40d6c-921c-5ef6-c030-851925d459a0,64,4837710,4991093,4991484,4840907,391,153774,153383,0,0,0
4991724,a89c9be9-d38b-747b-21a6-ad89ae97360e,64,4837899,4991454,4991724,4841013,270,153825,153555,0,0,0
4991791,5d2c710b-27bc-843b-2edf-fe45404e3a13,64,4840437,4991724,4991791,4841311,67,151354,151287,0,0,0
4991936,b3858457-7afc-ceb2-8d0d-30c719e3e579,64,4837817,4991514,4991936,4841027,422,154119,153697,0,0,0
4992055,2caf6e3c-661b-6e7f-665e-f0bf2b0b73e5,64,4840196,4991791,4992055,4841336,264,151859,151595,0,0,0
4992153,1540a8d6-9f02-1c1f-fa6a-4d37b20ad916,64,4840919,4991936,4992153,4841445,217,151234,151017,0,0,0
4992226,a7dac1cc-f46f-77f0-84e1-26d154ac0e20,64,4837741,4991394,4992226,4840999,832,154485,153653,0,0,0
4992286,79a3fb91-7340-ba2b-59a8-d3fe5f00cbc7,64,4839032,4992055,4992272,4841538,217,153240,153023,0,0,0
4992400,bc6558ba-3936-da1c-622b-1decb620c543,64,4841403,4992286,4992400,4841789,114,150997,150883,0,0,0
4992569,73569ad9-9397-06b4-fa2c-54355920ba77,64,4837973,4992153,4992569,4841545,416,154596,154180,0,0,0
4992639,629d7ad5-1714-2b68-7c6d-4e851c415135,64,4838610,4992400,4992639,4842015,239,154029,153790,0,0,0
4992699,a5eb3263-2524-7025-5e3a-a1b8c445eca6,64,4841163,4992569,4992665,4842127,96,151502,151406,0,0,0
4992759,fe3ddd26-bf3c-731b-f86d-da0d1aed1a2b,64,4840679,4992639,4992735,4842607,96,152056,151960,0,0,0
4992826,1872d5cf-8027-6be6-a72b-f8c1242b6794,64,4852259,4992699,4992826,4852663,127,140567,140440,0,0,0
4992886,ef918813-145c-681e-a168-73c8ea42b696,64,4838259,4992226,4992858,4841752,632,154599,153967,0,0,0
4992946,015e597d-a427-7764-9b29-b1b50d4357aa,64,4852132,4992759,4992910,4852788,151,140778,140627,0,0,0
4993093,b05c8346-575f-ee90-5af9-13bcf3ba37a5,64,4852379,4992946,4993093,4852845,147,140714,140567,0,0,0
4993153,c94c24ba-ae70-dc07-4472-06954cbfb610,64,4852314,4992886,4993104,4852842,218,140790,140572,0,0,0
4993213,33f272ae-13e8-93e1-62de-6c83eea31ace,64,4852128,4992826,4993167,4852815,341,141039,140698,0,0,0
4993273,a7453a0d-a1de-1edb-c5be-4a9d2ab9adda,64,4852315,4993093,4993227,4852856,134,140912,140778,0,0,0
4993273,0a6fc2b3-0c72-c454-6cf5-0019236d9448,64,4852407,4993153,4993254,4852862,101,140847,140746,0,0,0
4993361,069a7125-12b6-6aa9-a2e6-2e2c867ae051,64,4852402,4993213,4993361,4852900,148,140959,140811,0,0,0
4993545,6966eec2-6fb9-3d10-4f76-88222446ee1a,64,4852315,4993273,4993545,4852918,272,141230,140958,0,0,0
4993629,e0c8b3bb-31d7-e4d6-2dcb-e90f3ea571b9,64,4852376,4993545,4993629,4852975,84,141253,141169,0,0,0
4993689,93d94562-38d6-8760-8951-c5819106fd8b,64,4852189,4993273,4993662,4852958,389,141473,141084,0,0,0
4993749,90cf490d-7138-2bf7-3097-8128d165deb7,64,4852192,4993629,4993714,4853025,85,141522,141437,0,0,0
4993829,e89627fe-80d4-94f4-2c11-9758eadefee8,64,4852525,4993689,4993829,4853041,140,141304,141164,0,0,0
4993938,52a6a856-0a3b-34ab-63c9-041f22652519,64,4852287,4993361,4993938,4852968,577,141651,141074,0,0,0
4994035,cb85ad97-6efd-da4f-1069-b8274555d360,64,4852522,4993938,4994035,4853137,97,141513,141416,0,0,0
4994095,93960476-93a4-34cb-ecd5-bffd93358b01,64,4852198,4993749,4994068,4853046,319,141870,141551,0,0,0
4994155,df97a8f3-b359-4cdc-ea04-0e9047802044,64,4852254,4993829,4994131,4853103,302,141877,141575,0,0,0
4994215,ce40691a-3484-5369-98e6-c1b8a318fff6,64,4852375,4994095,4994182,4853158,87,141807,141720,0,0,0
4994307,eed59832-d326-2742-f038-627386ba84a1,32,4852522,4994215,4994307,4853209,92,141785,141693,0,0,0
4994367,0835db02-21de-43a9-20c9-8cfea7b4ccfd,64,4852254,4994035,4994311,4853158,276,142057,141781,0,0,0
4994367,ffe024f0-010e-86d1-78c1-d215466a64f0,32,4852403,4994155,4994360,4853169,205,141957,141752,0,0,0
4994427,36d772e2-39f1-e2cd-8a74-da99e036147c,64,4852317,4994307,4994369,4853226,62,142052,141990,0,0,0
4994427,322c1fac-ff86-0715-955f-62281146f764,64,4852313,4994155,4994427,4853171,272,142114,141842,0,0,0
4994509,4e404427-ed2b-9320-4c94-f0d7422e4c77,64,4852609,4994367,4994509,4853228,142,141900,141758,0,0,0
4994651,2edee587-0fb9-b382-464b-1fb835063c47,64,4852287,4994427,4994651,4853238,224,142364,142140,0,0,0
4994711,b343ede1-eff1-49b6-a463-f7cdf2411291,64,4852254,4994427,4994710,4853246,283,142456,142173,0,0,0
4994800,f6b8bc0b-122d-161b-ce82-b44d8348e6c3,64,4852403,4994509,4994800,4853249,291,142397,142106,0,0,0
4994860,a1f297b2-a21b-6a1a-640b-f74df4d93d69,64,4852433,4994651,4994808,4853263,157,142375,142218,0,0,0
4994920,3571d89e-7cfe-0a77-bd66-0abc06bda6e4,64,4852551,4994800,4994881,4853324,81,142330,142249,0,0,0
4994980,ef02b783-f9f3-44ad-53ee-436b1d07b06e,64,4852248,4994711,4994959,4853303,248,142711,142463,0,0,0
4995040,8b3fa229-db7e-4c62-3bc0-82e04439826d,64,4852245,4994920,4995000,4853349,80,142755,142675,0,0,0
4995100,dca58793-b6b6-7988-874c-edf67b17751e,64,4852252,4994980,4995078,4853351,98,142826,142728,0,0,0
4995100,208cbc85-0687-c963-13f2-18180fcdc561,64,4852681,4994860,4995085,4853333,225,142404,142179,0,0,0
4995190,01a386ce-6920-9cab-def1-76525acefe67,64,4852583,4995100,4995190,4853400,90,142607,142517,0,0,0
4995417,4ebdfd09-2ec9-1233-b091-69eb67109402,64,4852251,4995040,4995417,4853352,377,143166,142789,0,0,0
4995477,7f026c30-b762-9ec7-b190-17580c964dee,64,4852523,4995100,4995428,4853394,328,142905,142577,0,0,0
4995772,b77fff18-abb1-e341-c567-21f0f0cf2501,64,4852526,4995190,4995772,4853402,582,143246,142664,0,0,0
4995832,0bc7e023-4e84-f43d-3f87-cb22664fcd9f,64,4852411,4995477,4995791,4853428,314,143380,143066,0,0,0
4995961,7880c274-814b-c74b-5598-9ee1e0b07cce,32,4852676,4995772,4995961,4853443,189,143285,143096,0,0,0
4996021,57ea7c88-9c35-6966-b816-737081f35531,64,4852726,4995417,4995969,4853408,552,143243,142691,0,0,0
4996090,14797867-939d-b30d-eb20-88f196ce3a51,64,4852925,4995772,4996090,4853444,318,143165,142847,0,0,0
4996150,db7afca0-baa4-664c-d862-30e6c81e91db,64,4852250,4995832,4996138,4853500,306,143888,143582,0,0,0
4996210,ff032ea1-dc9d-64e7-fc2a-e503164e4780,64,4852396,4996021,4996204,4853500,183,143808,143625,0,0,0
4996270,168c6c0f-8a8b-b0a3-e62c-5ef0ee7edf1e,64,4852310,4996150,4996231,4853525,81,143921,143840,0,0,0
4996330,e6b50ee9-3195-a7e2-0e19-5d69cf5aebb8,64,4852975,4996090,4996315,4853510,225,143340,143115,0,0,0
4996390,65138c0e-aaa9-c59c-6259-cae3b46d065e,64,4852549,4996270,4996361,4853567,91,143812,143721,0,0,0
4996390,b39cf12f-8b09-90e9-2417-2bd1b1d2c204,32,4852405,4996210,4996390,4853562,180,143985,143805,0,0,0
4996575,e68cb1ba-b6eb-2780-c6e8-0197476d22bb,32,4852548,4996390,4996575,4853576,185,144027,143842,0,0,0
4996700,95bfaeb1-0190-119a-e08a-346b01286f4f,64,4852431,4996390,4996700,4853643,310,144269,143959,0,0,0
4996764,34eddad4-7907-7353-055d-f0ca3ff89cf7,64,4852524,4996210,4996764,4853567,554,144240,143686,0,0,0
4996877,73f7ec3b-c478-6e01-8eab-0fe8a4c21537,64,4853164,4996700,4996877,4853672,177,143713,143536,0,0,0
4996937,5ddf1634-bf6d-3117-6b66-977849a9128e,64,4852524,4996330,4996879,4853571,549,144355,143806,0,0,0
4996937,4c13b7ef-a43b-3073-809d-ad517abb5a4c,64,4852405,4996764,4996919,4853673,155,144514,144359,0,0,0
4996997,6246f491-50bb-c9bd-a40d-75160734d306,64,4852546,4996937,4996992,4853754,55,144446,144391,0,0,0
4997086,c325105c-a4a1-a661-2862-665584cfcb10,64,4852798,4996997,4997086,4853861,89,144288,144199,0,0,0
4997195,e61440c5-c9ea-78bf-fad1-6d50b7ac8c23,64,4852683,4996877,4997195,4853744,318,144512,144194,0,0,0
4997257,73c99dc1-3c10-f3b5-08e8-cacd0c008903,64,4852728,4997086,4997257,4853922,171,144529,144358,0,0,0
4997317,73a9c36c-db14-3a87-5ef6-5d1ff500c978,64,4852524,4996937,4997280,4853789,343,144756,144413,0,0,0
4997377,e3633352-7209-b6ed-5549-6b06eb328007,64,4852859,4997195,4997362,4854050,167,144503,144336,0,0,0
4997377,b94d8bfd-cff7-df41-d6f8-10b530755c55,64,4852862,4997317,4997373,4854126,56,144511,144455,0,0,0
4997599,dc531a9c-c5b1-5532-8103-9a29873ad8d6,64,4852722,4997257,4997599,4854065,342,144877,144535,0,0,0
4997684,53c7c650-7762-bf09-b6d1-5ee942b7a3f0,64,4854648,4997599,4997684,4855367,85,143036,142951,0,0,0
4997744,33b27ed0-dde2-bf3e-1803-dbaffe397b5b,64,4852862,4997377,4997724,4854143,347,144862,144515,0,0,0
4997808,e1b14543-8fb6-da13-b2e1-f0bf9c08a226,64,4854771,4997684,4997808,4855809,124,143037,142913,0,0,0
4998018,3a657200-fef7-1496-140d-754a32ad8a8e,64,4858455,4997808,4998018,4858777,210,139563,139353,0,0,0
4998078,6826d833-0e56-7e61-588c-0f3ae98acce5,64,4850589,4997377,4998054,4854917,677,147465,146788,0,0,0
4998138,ce9ed0bd-5196-dfc0-e90b-e69f1b874376,64,4858396,4998018,4998086,4858790,68,139690,139622,0,0,0
4998268,133ef97a-6981-906e-723f-b0ecb665cf8b,32,4858505,4998138,4998268,4858921,130,139763,139633,0,0,0
4998328,a1dd88d6-1ba7-e2f4-6761-d7f0c3d24f49,64,4858454,4998078,4998305,4858804,227,139851,139624,0,0,0
4998579,9c55df5b-5420-c2b6-0004-46b017824e0b,64,4858392,4998328,4998579,4858982,251,140187,139936,0,0,0
4998651,dd10bd28-fb4c-4e11-4608-7f6536deb37e,64,4855140,4998138,4998651,4858947,513,143511,142998,0,0,0
4998711,cccc464f-6a33-4a55-760b-52fe3809aa4f,64,4858567,4998579,4998662,4859003,83,140095,140012,0,0,0
4998821,34271647-bd59-5e37-5b34-600fc038356e,64,4858626,4998651,4998821,4859005,170,140195,140025,0,0,0
4998881,78434b4a-f4a0-f534-0d9f-f0a21da34249,64,4858520,4998711,4998845,4859032,134,140325,140191,0,0,0
4998941,ad0e30b3-5e5b-b2f4-9fdb-874f24098899,64,4858504,4998821,4998893,4859036,72,140389,140317,0,0,0
4999014,83046af1-84d5-abd2-e85b-9c8aefd2e8c9,64,4858568,4998881,4999014,4859036,133,140446,140313,0,0,0
4999074,f0cc4ae1-4537-5dab-5d81-c2d451f706f8,64,4858537,4998941,4999052,4859040,111,140515,140404,0,0,0
4999262,739b6824-8731-484e-589e-76b98ce7dc29,64,4858634,4999074,4999262,4859104,188,140628,140440,0,0,0
4999377,4d90d947-1c5f-4f89-5eb0-16ce469eaff5,64,4858570,4999262,4999377,4859141,115,140807,140692,0,0,0
4999437,4691a0b9-2ef3-376f-8342-8d044f50ff02,64,4858732,4999014,4999417,4859048,403,140685,140282,0,0,0
4999497,05907dbf-3a70-98c7-18cf-ca8604d8ae11,64,4858745,4999377,4999492,4859156,115,140747,140632,0,0,0
4999557,1ff3df05-bd49-7a0a-9279-e46ec3971224,64,4858453,4999437,4999500,4859188,63,141047,140984,0,0,0
4999622,bbbfec28-5e25-d30a-4b89-19fad47aaf73,64,4858335,4999557,4999622,4859235,65,141287,141222,0,0,0
4999682,98f35bb3-6a95-3392-3dfc-7b0de58c69fd,64,4858569,4999497,4999664,4859225,167,141095,140928,0,0,0
4999789,0a9e10d3-626b-2a8a-7c81-8c96a916f073,64,4858927,4999622,4999789,4859247,167,140862,140695,0,0,0
4999849,7cc696bd-529c-2e5c-fc15-d42de3b7ea90,64,4858453,4999682,4999795,4859269,113,141342,141229,0,0,0
4999909,78d2075b-f3a5-42f0-7360-05e5c76f8e2e,64,4858451,4999789,4999859,4859282,70,141408,141338,0,0,0
5000017,afda6a51-74e4-d750-fdc3-501d28465616,64,4858506,4999909,5000017,4859302,108,141511,141403,0,0,0
5000243,fde2c926-e780-525b-26f5-ed425f63d923,64,4858395,4999849,5000243,4859293,394,141848,141454,0,0,0
5000303,d536ba96-97f8-c3be-dd90-72f456b66dd7,64,4858456,5000017,5000250,4859309,233,141794,141561,0,0,0
5000363,5cc4f13d-c026-507a-76de-574589ce15a2,64,4858394,5000243,5000306,4859313,63,141912,141849,0,0,0
5000436,afd5827d-0d4e-c4b9-3181-4635af87b559,64,4858694,5000363,5000436,4859320,73,141742,141669,0,0,0
5000496,3f6a5166-9fe7-3fe2-eab4-324d3f18cb4f,64,4858688,5000303,5000467,4859313,164,141779,141615,0,0,0
5000562,20f2dd3b-87ed-8076-6633-cc7dbc50fa6c,64,4858984,5000496,5000562,4859333,66,141578,141512,0,0,0
5000684,ae8e3a06-e43f-d981-25dc-5206a2525c0a,64,4858395,5000436,5000684,4859321,248,142289,142041,0,0,0
5000840,e5e1e896-9268-6cba-4ae8-63d1702e36cb,64,4858745,5000562,5000840,4859343,278,142095,141817,0,0,0
5000981,911a32f4-9b5d-eb62-30ec-dbff59f56d0e,64,4858744,5000840,5000981,4859388,141,142237,142096,0,0,0
5001093,c553d3a0-fd14-f848-0ee6-04f00a22a776,64,4858690,5000684,5001093,4859363,409,142403,141994,0,0,0
5001158,7847ee34-01f7-1917-10fe-ed62f2a2a7b5,64,4858693,5000981,5001158,4859413,177,142465,142288,0,0,0
5001218,853473a3-cbb9-07ea-42af-aedea83f657c,64,4858506,5001093,5001206,4859415,113,142700,142587,0,0,0
5001284,69442644-faf7-f23f-9a2f-0e2f3d5b0dfd,64,4858865,5001218,5001284,4859446,66,142419,142353,0,0,0
5001448,145edab3-ddf7-9709-efa7-18719f7cdbe5,64,4858631,5001158,5001448,4859417,290,142817,142527,0,0,0
5001512,2a66d1bc-7a04-eeab-e64c-8a667b1c7842,64,4859106,5001448,5001512,4859510,64,142406,142342,0,0,0
5001572,46bede46-2987-9557-f2f5-c498d927dd48,64,4858871,5001284,5001513,4859475,229,142642,142413,0,0,0
5001720,e3408018-be2b-647a-332c-bcd0cbbbd89a,64,4858744,5001572,5001720,4859520,148,142976,142828,0,0,0
5001780,e728e109-ca0d-434a-3ae0-db32e8841d08,64,4858700,5001512,5001748,4859511,236,143048,142812,0,0,0
5001857,de56c467-cc1a-7159-69a6-976d443b3c25,32,4858689,5001720,5001857,4859536,137,143168,143031,0,0,0
5002112,ae8c8dea-a336-4b61-93e1-9a9791afc7d4,64,4858744,5001720,5002112,4859568,392,143368,142976,0,0,0
5002200,d77a17db-58cb-c209-46e1-5af883ad63ff,64,4858632,5001780,5002200,4859577,420,143568,143148,0,0,0
5002289,663637b9-a43e-8daf-3439-99edf60ea405,64,4858695,5002200,5002289,4859606,89,143594,143505,0,0,0
5002349,76c61e2e-1262-1ecb-5044-2f78cfdf88f8,64,4858924,5002112,5002346,4859604,234,143422,143188,0,0,0
5002422,a5480fff-9f40-8f8f-5c97-fd6d17f6a5d0,64,4858819,5002349,5002422,4859672,73,143603,143530,0,0,0
5002482,046ddac8-2c87-7b24-eed1-0941b5ff354c,64,4858864,5002422,5002482,4859672,60,143618,143558,0,0,0
5002547,9ea4c702-41cd-a75f-99f0-3efad987d0ac,64,4858688,5002289,5002547,4859638,258,143859,143601,0,0,0
5002652,7e10c75d-c123-71b1-5064-5e3be9fa3a5a,64,4858817,5002547,5002652,4859684,105,143835,143730,0,0,0
5002764,cba4aac2-1bf8-204f-380d-dae4756d4627,64,4858733,5002482,5002764,4859676,282,144031,143749,0,0,0
5002834,680fe235-122d-a786-eb89-64517e286939,64,4858924,5002764,5002834,4859745,70,143910,143840,0,0,0
5002894,76f1d068-e713-f71a-bc57-6cf6a693c652,64,4858866,5002652,5002880,4859724,228,144014,143786,0,0,0
5002964,f0fca3d3-723b-f128-fd69-1098d8ac188e,64,4859058,5002894,5002964,4859789,70,143906,143836,0,0,0
5003024,6b8c78d7-eadb-69d1-dc2a-0d5425246ba4,64,4858924,5002964,5003024,4859817,60,144100,144040,0,0,0
5003113,a7186dec-f0f4-9e60-f832-f963318f8cd8,64,4859381,5002834,5003113,4859747,279,143732,143453,0,0,0
5003257,94d722c6-0c07-82b4-18f4-3fd52c050a54,32,4858821,5003113,5003257,4859850,144,144436,144292,0,0,0
5003317,73bd7d0c-2577-cfa0-6afa-e4c567a09bda,64,4859310,5003024,5003308,4859820,284,143998,143714,0,0,0
5003508,9093610b-6315-597c-89ef-9a8e122f53cc,64,4858936,5003113,5003508,4859873,395,144572,144177,0,0,0
5003568,cdadd826-aa4e-037c-a6e4-7d4671adcc88,64,4859341,5003317,5003560,4859875,243,144219,143976,0,0,0
5003628,9bbba7a0-2cdb-879b-087d-3100811313f2,64,4859192,5003508,5003621,4860048,113,144429,144316,0,0,0
5003704,6237402d-36f7-4e30-ea30-bbf5226c304c,32,4860188,5003568,5003704,4861077,136,143516,143380,0,0,0
5003764,2c40b54e-4393-6550-ace0-e3b4210b1cff,64,4860802,5003628,5003741,4861183,113,142939,142826,0,0,0
5003824,4527efb4-d759-61a6-ee17-d954608c3eb5,64,4860742,5003568,5003795,4861120,227,143053,142826,0,0,0
5003884,f5cbb206-c402-2c24-03d7-ec4f079ace9e,64,4860686,5003824,5003865,4861280,41,143179,143138,0,0,0
5003884,4b823b51-5863-261c-0699-7342f5d75ee9,64,4860805,5003764,5003874,4861230,110,143069,142959,0,0,0
5003944,8e5e53c4-cf09-9562-eda7-5abcdf5a1bed,64,4860917,5003884,5003944,4861381,60,143027,142967,0,0,0
5004122,0daf2dae-8209-a8a7-0e7f-5bae16fb436a,64,4860871,5003884,5004122,4861305,238,143251,143013,0,0,0
5004182,62741766-a113-1d1b-f5b0-3148394de695,64,4860918,5003944,5004176,4861406,232,143258,143026,0,0,0
5004247,d5c2c640-dae7-a549-1acc-ff212fb4c5d7,64,4860748,5004182,5004247,4861463,65,143499,143434,0,0,0
5004325,e486dc39-4ab6-ed43-22fa-8cb546491860,64,4860802,5004122,5004325,4861418,203,143523,143320,0,0,0
5004451,bedf6b8d-9fd3-4760-aa1d-c4936b3dd738,64,4860990,5004247,5004451,4861472,204,143461,143257,0,0,0
5004566,d906e756-54ba-81f9-4191-17555c56b2f2,32,4860870,5004451,5004566,4861531,115,143696,143581,0,0,0
5004626,9d87522f-ec95-99ed-2a87-1982224939ce,32,4860689,5004451,5004579,4861524,128,143890,143762,0,0,0
5004626,8c4fd3c9-dddb-5f3d-6ce2-77328e5faa59,64,4860867,5004325,5004604,4861496,279,143737,143458,0,0,0
5004626,4fca5001-9815-e108-bc3b-39c3c52478f5,32,4860865,5004566,5004617,4861542,51,143752,143701,0,0,0
5004691,b6f2c84e-72e7-270b-0428-7b5e6f7666c4,64,4860872,5004626,5004691,4861591,65,143819,143754,0,0,0
5004824,043edb27-2c4b-55c2-cbea-3167c63fe9cd,64,4861280,5004691,5004824,4861622,133,143544,143411,0,0,0
5004884,a93d86c7-9f6f-be5a-fd1a-cb8ffbcba2e4,64,4860806,5004626,5004844,4861592,218,144038,143820,0,0,0
5004951,7973a413-8330-5c57-b6ff-68376faeabba,64,4860748,5004884,5004951,4861710,67,144203,144136,0,0,0
5005046,39437052-f589-06b9-2acc-21d93643c274,64,4860990,5004824,5005046,4861637,222,144056,143834,0,0,0
5005186,b49d97a2-9506-e77d-ea3a-55fcdc6d68ba,64,4861167,5004951,5005186,4861726,235,144019,143784,0,0,0
5005246,63f6c0d8-d28d-66aa-618b-47ed5cffd12f,64,4860870,5005046,5005204,4861743,158,144334,144176,0,0,0
5005311,7c557465-6dbc-dfd2-7931-d814821fc47c,64,4861166,5005186,5005311,4861752,125,144145,144020,0,0,0
5005511,94d99412-f03e-556a-bc80-e303b6288795,64,4861278,5005246,5005511,4861761,265,144233,143968,0,0,0
5005648,2b755765-2943-4eeb-e3df-5415a0d4a78d,64,4860806,5005511,5005648,4861785,137,144842,144705,0,0,0
5005722,c81af4aa-279a-c811-08a2-9c645bd792c6,64,4860912,5005648,5005722,4861809,74,144810,144736,0,0,0
5005956,d3958ffe-e2b3-68b5-e18a-d81d1e215b9b,64,4861170,5005722,5005956,4861813,234,144786,144552,0,0,0
5006210,3e748545-bed7-4860-36ed-644a4c88f420,64,4861169,5005956,5006210,4861816,254,145041,144787,0,0,0
5006433,a14943e2-f990-f46f-2eeb-731c9fab5713,64,4861053,5006210,5006433,4861840,223,145380,145157,0,0,0
5006831,6863778e-51d9-4f78-462c-10667843d846,64,4860990,5006433,5006831,4861865,398,145841,145443,0,0,0
5006937,06d4ce8d-912d-f322-f5da-4ea5b2b53b1f,64,4861114,5006831,5006937,4861881,106,145823,145717,0,0,0
5007075,2eacf23a-ebfc-7e6e-b388-df84f1b3871e,64,4861164,5006937,5007075,4861902,138,145911,145773,0,0,0
5007276,b3abaf81-7ed4-9f42-896f-3475a212ea3c,64,4861053,5007075,5007276,4861914,201,146223,146022,0,0,0
5007408,a4f54a39-3a52-bcdd-438e-2dbf4e576062,64,4861164,5007276,5007408,4861936,132,146244,146112,0,0,0
5007537,7a45b2b6-0e3f-1cd0-b3a9-3b0e95a4fefc,64,4861166,5007408,5007537,4861950,129,146371,146242,0,0,0
5007610,4cd46fc3-aace-95a3-4b66-285f05e3da32,64,4861169,5007537,5007610,4861959,73,146441,146368,0,0,0
5007681,71d65ce5-6cf6-a1af-c30b-df3ae15ecc55,64,4861651,5007610,5007681,4861970,71,146030,145959,0,0,0
5007812,9bcd1427-6157-cb13-7d82-7cd6e7b70c61,64,4861176,5007681,5007812,4861976,131,146636,146505,0,0,0
5008232,21e094fc-15db-a69e-591a-86896626978d,64,4861347,5007812,5008232,4862012,420,146885,146465,0,0,0
5008341,2d2ac30c-a1c2-b23d-303c-24578c0d4213,64,4861163,5008232,5008341,4862023,109,147178,147069,0,0,0
5008446,b6610e64-34f2-304b-f2af-32b3a1939c98,64,4861714,5008341,5008446,4862040,105,146732,146627,0,0,0
5008506,7e337fb1-6c07-2da8-b63f-ace7e8af5d90,64,4861165,5008446,5008486,4862043,40,147321,147281,0,0,0
5008742,4f3228b6-d20f-3062-2ba7-466cf9681b8d,64,4861407,5008506,5008742,4862072,236,147335,147099,0,0,0
5008802,b0dfd7b9-fa66-f2c0-9c4c-532de2999e1a,64,4697563,4857386,5008797,4810954,151411,311234,159823,0,0,0
5008932,05fd3611-fb53-ab5c-788c-bda715b9a6f1,64,4861517,5008802,5008932,4862152,130,147415,147285,0,0,0
5008992,70da8b7c-3ea0-489a-5d03-61daa0f4a095,64,4861398,5008742,5008949,4862127,207,147551,147344,0,0,0
5009057,86a95175-3524-a3e3-a654-95ca94f45431,64,4861415,5008992,5009057,4862161,65,147642,147577,0,0,0
5009222,6324de68-68fc-7139-3945-040674ef6537,64,4861707,5009057,5009222,4862184,165,147515,147350,0,0,0
5009328,2409259a-9ad2-2ea9-49bb-a5649bbaeeac,64,4861254,5008932,5009328,4862158,396,148074,147678,0,0,0
5009388,d7ca6a43-c82e-fb43-c08c-c4d6cf176b01,64,4861588,5009222,5009329,4862222,107,147741,147634,0,0,0
5009462,47af63ee-5f3d-5f8f-97cb-fff8047a7b9e,64,4861471,5009388,5009462,4862423,74,147991,147917,0,0,0
5009570,681bfbd7-a480-9ac1-95ab-15d0e43c5ea5,64,4861988,5009462,5009570,4862497,108,147582,147474,0,0,0
5009699,f3427703-8c29-e99e-9e2a-615efe8cad92,32,4862116,5009570,5009699,4863010,129,147583,147454,0,0,0
5009759,879d53fc-df38-e1dc-2b52-1e37c6de38b9,64,4862623,5009570,5009711,4863405,141,147088,146947,0,0,0
5009759,7c4bc4cf-294d-66a0-d571-098a6de4cd2d,64,4861590,5009328,5009734,4862336,406,148144,147738,0,0,0
5010700,34c9aa64-86dd-3417-b695-3b262f859ef3,64,4863312,5009759,5010700,4865537,941,147388,146447,0,0,0
5011106,070d269e-e6ac-03a8-0736-ffb5522a230e,64,4863090,5010700,5011106,4867544,406,148016,147610,0,0,0
5012113,974d2610-0f0c-503d-9e68-8afce80a8bff,64,4859712,5009759,5012113,4864339,2354,152401,150047,0,0,0
5012229,d67ff9ea-e9de-2024-645b-52edf379026f,64,4863421,5011106,5012229,4867899,1123,148808,147685,0,0,0
5012457,5f19287a-cdb2-18f1-82b9-da38073372c0,64,4870547,5012113,5012457,4873494,344,141910,141566,0,0,0
5012539,3c22610f-88d8-804e-8500-e11621623fe0,64,4870582,5012229,5012539,4874939,310,141957,141647,0,0,0
5012735,77ba732b-0271-3dda-0f9d-92b5295969df,64,4870956,5012457,5012735,4875093,278,141779,141501,0,0,0
5017167,423f023e-666c-aee8-5cfc-664da485a68b,64,4852119,5012735,5017167,4884996,4432,165048,160616,0,0,0
5049980,0ba268e7-d230-38f4-b6a6-67f7a4209f7f,64,4427917,4689212,5049980,4666643,360768,622063,261295,0,0,0
5055557,c7b33617-8990-1f14-2159-c0a24879818f,64,4158420,4697912,5055557,4677075,357645,897137,539492,0,0,0
5070113,d5537a58-2756-e9b1-bc95-63f2a78effe7,64,4826180,5017167,5070113,4887245,52946,243933,190987,0,0,0
5088410,cc101a07-06e1-d1dc-480d-ca27ce486033,64,4588170,5012539,5088373,4878450,75834,500203,424369,0,0,0
5090103,fa369cd1-8aee-4564-fe21-4e82bbd8ca7b,32,4906075,5088410,5090103,4907908,1693,184028,182335,0,0,0
5091797,d8c373f7-6c4b-1a3a-4d76-7f01fbae681d,32,4905454,5090103,5091797,4909636,1694,186343,184649,0,0,0
5092427,a03b1e61-5de6-3714-e20e-9c0b76b7edba,32,4911737,5091797,5092427,4914498,630,180690,180060,0,0,0
5092797,3717c437-71f7-ba33-0de8-9c570a81fa55,32,4911757,5092427,5092797,4914579,370,181040,180670,0,0,0
5093402,a7d946fc-6f28-8de4-0b68-39b34a98f39f,32,4912139,5092797,5093402,4914747,605,181263,180658,0,0,0
5093504,43aea0b4-f9cf-5cff-ae6e-0f66be49f556,32,4920314,5093402,5093504,4921216,102,173190,173088,0,0,0
5093631,5dfe0007-bb2e-6561-ea39-86ca021f13f2,32,4925791,5093504,5093631,4926541,127,167840,167713,0,0,0
5093748,25f0698e-5029-5140-f62c-ff1fca2710ec,32,4926209,5093631,5093748,4926546,117,167539,167422,0,0,0
5093881,aeb6c0a9-b534-b3bd-067b-1c889e4855bd,32,4925976,5093748,5093881,4926749,133,167905,167772,0,0,0
5094478,c265347e-2023-1644-d7b9-a0f1bec8cf46,32,4923128,5093881,5094478,4927537,597,171350,170753,0,0,0
5094784,0b1b8ee1-6d14-55c8-17da-2228b4c88180,32,4930078,5094478,5094784,4931409,306,164706,164400,0,0,0
5094994,08d08b34-0d1d-5736-b431-2eb65917a56f,32,4930533,5094784,5094994,4931422,210,164461,164251,0,0,0
5095492,ba942370-bb4c-ad3d-0a26-78497288cda9,32,4930506,5094994,5095492,4931432,498,164986,164488,0,0,0
5095676,9f76f452-4bce-01eb-e319-92512d5835f6,32,4930318,5095492,5095676,4931474,184,165358,165174,0,0,0
5096603,a89b2cc8-ac8b-7916-c677-d6d904ae0b41,32,4930690,5095676,5096603,4931716,927,165913,164986,0,0,0
5097141,3aaaad48-55c1-d6c8-d0d3-23499534a7e3,32,4930938,5096603,5097141,4931756,538,166203,165665,0,0,0
5097631,e5a14a80-ff3a-eb4a-6d1d-167278ec64b9,32,4930319,5097141,5097631,4931828,490,167312,166822,0,0,0
5097897,1d25dbc8-3730-7eb4-5474-40cb63af08fe,32,4931109,5097631,5097897,4932199,266,166788,166522,0,0,0
5098219,d4ac7e27-3205-d9c0-6945-3f8a1573e8d4,32,4930956,5097897,5098219,4932288,322,167263,166941,0,0,0
5098347,faa50bee-a124-8bd9-64d4-7b0789f85be6,32,4931474,5098219,5098347,4932301,128,166873,166745,0,0,0
5098621,8de1a16c-4d30-27bf-61cf-d0ad4fce8395,32,4930946,5098347,5098621,4932344,274,167675,167401,0,0,0
5099277,e6e8d299-ee91-a58f-b204-a3f15c14fe70,32,4930317,5098621,5099277,4932377,656,168960,168304,0,0,0
5099852,56b8d540-4b15-4543-a23e-e239eeb3da7a,32,4930445,5099277,5099852,4932384,575,169407,168832,0,0,0
5100745,8a193470-4bbc-9914-f824-fdd3cb34c0bb,32,4931291,5099852,5100745,4932389,893,169454,168561,0,0,0
5100869,794426ba-7961-f064-1763-086412952600,32,4930319,5100745,5100869,4932506,124,170550,170426,0,0,0
5101444,47dbfde0-2f05-58de-f820-dcf7e2a79d71,32,4930941,5100869,5101444,4932584,575,170503,169928,0,0,0
5101782,fd297fd3-5eaa-01f7-a493-c4e0d61a9a28,32,4931109,5101444,5101782,4932614,338,170673,170335,0,0,0
5102082,e6523c2c-2c8e-d2e8-bb27-182beb750a62,32,4930301,5101782,5102082,4932690,300,171781,171481,0,0,0
5102287,b2b47bd4-aac8-1bf8-b392-7bf280cd8aec,32,4931475,5102082,5102287,4932711,205,170812,170607,0,0,0
5102854,7067efaa-17bf-87ab-92ca-a7b7cb0065f0,32,4931601,5102287,5102854,4932924,567,171253,170686,0,0,0
5103200,0df665b9-8f25-d8a2-c415-9d77e0ca81c0,32,4930944,5102854,5103200,4932979,346,172256,171910,0,0,0
5103693,931cc76a-ca68-32ed-c27e-a023176b8970,32,4931657,5103200,5103693,4933002,493,172036,171543,0,0,0
5103877,d0f6a62d-93e0-53e4-ecf3-5c8348551330,32,4932137,5103693,5103877,4933027,184,171740,171556,0,0,0
5104818,1d39a1b7-a61a-467c-af9f-17ed8c6e9bdd,32,4932233,5103877,5104818,4933144,941,172585,171644,0,0,0
5104946,1b691c63-6c32-e305-049a-d3eab3c1e969,32,4931137,5104818,5104946,4933157,128,173809,173681,0,0,0
5105162,e790f312-2abb-866b-b56c-df1ac1e65202,32,4932072,5104946,5105162,4933299,216,173090,172874,0,0,0
5105497,725d41fc-03ff-2305-c754-3893335127d3,32,4932107,5105162,5105497,4933322,335,173390,173055,0,0,0
5106414,4d009e96-aa05-3a78-a2ee-acc4ab21974d,32,4931821,5105497,5106414,4933327,917,174593,173676,0,0,0
5106586,d96d6ad3-4924-9710-9123-810267406ac3,32,4932233,5106414,5106586,4933360,172,174353,174181,0,0,0
5106860,ebbe1cf4-4496-f518-5e19-ad54514fe370,32,4931490,5106586,5106860,4933377,274,175370,175096,0,0,0
5107156,ee27756a-0127-7f82-d97f-49237f8e4d86,32,4931029,5106860,5107156,4933434,296,176127,175831,0,0,0
5107479,a6dbf2e9-8287-a94d-814c-fad77426032f,32,4931267,5107156,5107479,4933566,323,176212,175889,0,0,0
5107844,7916f2e6-de08-24b8-ec73-6a754d19dbfb,32,4931954,5107479,5107844,4933670,365,175890,175525,0,0,0
5108342,d6bcb21c-454c-0b79-b59b-a5a14b335b12,32,4932137,5107844,5108342,4933727,498,176205,175707,0,0,0
5108598,6d861a6f-c8e9-05bd-4d57-21e96cff1fb2,32,4931890,5108342,5108598,4933856,256,176708,176452,0,0,0
5109247,afb0e4ab-c143-5eb5-23de-6d28cb65a302,32,4932571,5108598,5109247,4933970,649,176676,176027,0,0,0
5109576,05b39b1f-1a13-7fea-38c9-cadf18be8987,32,4932381,5109247,5109576,4933976,329,177195,176866,0,0,0
5110512,445baf7a-402a-f48c-ada4-bbf00307c652,32,4932375,5109576,5110512,4934069,936,178137,177201,0,0,0
5110680,4f168d97-4ffb-96db-657d-b5bf3b48557e,32,4932500,5110512,5110680,4934081,168,178180,178012,0,0,0
5111247,0c9a830f-f02a-83bc-5a8f-4f3f663864aa,32,4932923,5110680,5111247,4934090,567,178324,177757,0,0,0
5111838,8ec84514-a200-588b-ff24-ecbdec97182e,32,4932072,5111247,5111838,4934286,591,179766,179175,0,0,0
5112072,82cc0143-c03d-49fb-b8ca-45373384e5a8,32,4932210,5111838,5112072,4934296,234,179862,179628,0,0,0
5112281,bf1abfb6-8acc-686a-bb98-55cee5c6d198,32,4932464,5112072,5112281,4934326,209,179817,179608,0,0,0
5112557,1b87b57c-85b5-caa8-b253-a0bcf6e9a7ca,32,4932107,5112281,5112557,4934332,276,180450,180174,0,0,0
5113214,3b71f750-44cd-00be-f890-92fed957fbc5,32,4932793,5112557,5113214,4934525,657,180421,179764,0,0,0
5113698,f9f04a1f-1d10-6f91-1368-5e0dd6d34231,32,4932628,5113214,5113698,4934689,484,181070,180586,0,0,0
5114353,5b7a9f8e-6faf-1657-e266-e604ddbc71c7,32,4932320,5113698,5114353,4934715,655,182033,181378,0,0,0
5114655,75b7b71a-8bfd-5515-8ab9-974cffa95b70,32,4932915,5114353,5114655,4934788,302,181740,181438,0,0,0
5114786,1c072ca1-32c6-8276-f419-a267074f1df4,32,4934253,5114655,5114786,4935099,131,180533,180402,0,0,0
5115330,26f2f44d-eb12-992c-2dd5-ef494658398e,32,4934205,5114786,5115330,4935141,544,181125,180581,0,0,0
5115662,8f8aac4c-6de0-4e75-f440-fa6f5010052f,32,4934867,5115330,5115662,4935761,332,180795,180463,0,0,0
5115795,79bf2c8d-1a52-b567-f9b2-46f917cf71dc,32,4934260,5115662,5115795,4935920,133,181535,181402,0,0,0
5115945,f198709c-7b5a-94e4-0351-71515898ef62,64,4850552,5049980,5115945,4887935,65965,265393,199428,0,0,0
5116132,73f83905-dae0-9130-8276-5f029c4eae5f,32,4934538,5115945,5116132,4936156,187,181594,181407,0,0,0
5116313,085bd297-d306-ec5b-71a4-98c21e73352c,64,4934786,5115795,5116313,4936081,518,181527,181009,0,0,0
5116441,cd84eede-aed8-360d-07e5-94f97391aea0,32,4935087,5116313,5116441,4936341,128,181354,181226,0,0,0
5116623,81ebe9de-0d62-61f3-8a33-3fd3096894b6,64,4935004,5116132,5116623,4936334,491,181619,181128,0,0,0
5117034,60f732d2-a1fc-5751-2899-b1be3c6e3484,64,4934319,5116441,5117034,4936687,593,182715,182122,0,0,0
5117200,21d73c7c-1f5d-cfee-1b05-100d00dafbb8,64,4935087,5116623,5117200,4936703,577,182113,181536,0,0,0
5117260,79cedeb8-10a6-6fe0-de20-a426c3f93fbd,64,4935087,5117034,5117202,4936770,168,182115,181947,0,0,0
5117586,a7187ea6-e411-783a-4729-49ff7d858820,32,4935266,5117260,5117586,4937469,326,182320,181994,0,0,0
5117714,5cb72055-5db8-c311-744c-8e181279c075,32,4936094,5117586,5117714,4937515,128,181620,181492,0,0,0
5117774,604814ce-5bb7-22bc-0fa5-5a77fd3d867a,64,4935881,5117200,5117719,4936994,519,181838,181319,0,0,0
5118108,32753963-8b4b-6b42-a068-de8abeea0c6c,32,4937997,5117774,5118108,4939315,334,180111,179777,0,0,0
5118298,4566114c-5752-4673-879b-7fcc91471e2a,64,4935749,5117714,5118298,4937959,584,182549,181965,0,0,0
5120398,318dd793-7384-2e66-f0fd-249a9546099a,64,4756896,5055557,5120398,4904080,64841,363502,298661,0,0,0
5122259,cec25fdc-ccdd-f721-641c-3afc40bd82b7,64,4940662,5118108,5122259,4944948,4151,181597,177446,0,0,0
5122536,9e78bc4b-a70f-ba18-b631-ba811edfb542,32,4957086,5122259,5122536,4958332,277,165450,165173,0,0,0
5122820,9620a685-0768-ec54-d7bf-12b2ec64eda6,32,4957265,5122536,5122820,4958654,284,165555,165271,0,0,0
5123561,45787a44-fa51-e27c-7726-2aa06ddcafbe,32,4957085,5122820,5123561,4958819,741,166476,165735,0,0,0
5124060,b72a92df-c583-971c-0756-0efe892362cb,32,4957454,5123561,5124060,4959324,499,166606,166107,0,0,0
5126419,3a715a67-7796-ea87-a0c7-4724a06071f0,64,4937042,5118298,5126419,4946800,8121,189377,181256,0,0,0
5126945,ead49335-5df9-2a00-42a9-4d3259af0320,32,4957265,5126419,5126945,4959592,526,169680,169154,0,0,0
5127471,1194807d-697b-b898-1525-f9757e3bc0c1,32,4957087,5126945,5127471,4959616,526,170384,169858,0,0,0
5127799,c8b3c540-c2d6-f7d9-e7fd-dfdeeb1ad0a0,32,4957080,5127471,5127799,4959617,328,170719,170391,0,0,0
5128304,7018fa03-b339-01c0-e466-df1c95a1bd47,32,4958174,5127799,5128304,4959644,505,170130,169625,0,0,0
5128408,b4896bcc-e767-d0f3-682a-599ae2184809,64,4938034,5120398,5128408,4952779,8010,190374,182364,0,0,0
5128506,2250a9ae-a624-306c-a34c-1731bec2294e,64,4957331,5128304,5128506,4959653,202,171175,170973,0,0,0
5128708,67e062e0-6561-353f-130a-50a063808063,32,4957019,5128506,5128708,4959764,202,171689,171487,0,0,0
5129301,b1578bc8-4a68-e290-1055-7be76914cd7b,64,4958191,5128408,5129301,4959673,893,171110,170217,0,0,0
5129809,410ad23d-cc73-fd16-8a6c-3a1605acb90f,64,4958116,5128708,5129809,4959781,1101,171693,170592,0,0,0
5129936,0d5d17d6-224f-854e-6341-d5ec3bdb75c0,64,4958236,5129301,5129925,4959908,624,171689,171065,0,0,0
5130377,232a5c56-2933-db77-5ed9-39547e05f554,32,4957384,5129936,5130377,4959986,441,172993,172552,0,0,0
5130738,9035717c-e59a-c8c4-27f3-b5fea7e00a21,32,4957516,5130377,5130738,4960041,361,173222,172861,0,0,0
5130816,7c49dcfe-f127-5feb-78c7-a2fdf5009e6d,64,4957213,5129809,5130816,4959950,1007,173603,172596,0,0,0
5131431,3547baeb-6dfb-afc2-0f13-42475ff7debf,64,4957015,5130738,5131431,4960055,693,174416,173723,0,0,0
5132218,2759137f-c12d-25ab-6731-b419d7fef411,32,4957332,5131431,5132218,4960177,787,174886,174099,0,0,0
5132391,6936de4a-e5dd-4475-ee09-56e23793b566,64,4958064,5130816,5132391,4960063,1575,174327,172752,0,0,0
5133361,de091db6-30c3-2d22-0251-2f180c19ceb8,64,4957626,5132218,5133361,4960223,1143,175735,174592,0,0,0
5133481,aabc08ee-c9b9-7158-2213-eb62c43a9143,64,4958332,5132391,5133481,4960395,1090,175149,174059,0,0,0
5133918,d461c611-9e90-401a-5fc2-f8f4cb985c44,32,4958653,5133361,5133918,4960465,557,175265,174708,0,0,0
5133978,487ff5ba-fcfe-2bf1-33f8-8cc0421b1f6a,64,4958709,5133481,5133933,4960547,452,175224,174772,0,0,0
5134263,8474dcb7-dad8-a801-00fa-b01a6e3a6262,32,4957513,5133978,5134263,4960593,285,176750,176465,0,0,0
5134825,23334a14-2c0c-6db5-0945-e2e651234ad4,32,4958650,5134263,5134825,4960600,562,176175,175613,0,0,0
5135053,e85b2eea-19ea-d8f8-7bea-060c74cb96c9,32,4957455,5134825,5135053,4960649,228,177598,177370,0,0,0
5135122,e71b2098-2a8a-c31d-3527-cef0746a43f3,64,4958842,5133918,5135122,4960561,1204,176280,175076,0,0,0
5135746,183e4993-96e2-3f3f-9dd1-2d2b7056c0c8,64,4959023,5135053,5135744,4960665,691,176721,176030,0,0,0
5136255,1cdf8892-faec-4c9d-4b82-7a5e2ed22475,64,4957812,5135122,5136255,4960721,1133,178443,177310,0,0,0
5136817,1c4686c4-b81d-2f5e-6cdf-efcc68ebe249,32,4957697,5136255,5136817,4960826,562,179120,178558,0,0,0
5137372,d4ba1caf-17f2-31e8-0ca8-e68abeff8feb,32,4959248,5136817,5137372,4960849,555,178124,177569,0,0,0
5137432,3786ab40-711c-9516-2db8-245447f6afd7,64,4956923,5135746,5137390,4960745,1644,180467,178823,0,0,0
5137648,d796ae9f-a466-dd52-1875-7f6efb4087e6,64,4959144,5137372,5137648,4960948,276,178504,178228,0,0,0
5137982,0c0f52aa-f8fb-a4b0-6a3b-e92fea2efc22,64,4957627,5137432,5137982,4961006,550,180355,179805,0,0,0
5138198,4558a900-6e34-1ea1-7495-50cd165c1b39,32,4957214,5137982,5138198,4961155,216,180984,180768,0,0,0
5138763,fbc6e633-5b6f-09e0-26bc-35aaa34ac905,64,4957655,5137648,5138763,4961027,1115,181108,179993,0,0,0
5139322,d1f1b34e-2209-c3fc-eca6-a68c4319e0c4,32,4958394,5138763,5139322,4961205,559,180928,180369,0,0,0
5139910,886ceba3-ce16-648e-0dfe-4e16e066f392,32,4957851,5139322,5139910,4961361,588,182059,181471,0,0,0
5140120,bf307ca1-b8b1-c22f-2520-35cf0c27b835,64,4959202,5138198,5140120,4961204,1922,180918,178996,0,0,0
5140660,ddc50c27-ff9f-c57e-c7ab-a8312cddffae,32,4958396,5140120,5140660,4961431,540,182264,181724,0,0,0
5140788,9db77647-02a1-6d5f-4f0c-ead98995178b,64,4957384,5139910,5140788,4961410,878,183404,182526,0,0,0
5141133,d84d724c-d912-6391-1fd3-2aeb5467e91b,64,4957788,5140660,5141133,4961439,473,183345,182872,0,0,0
5141454,902e3b34-e9a4-f456-3094-92efa8fc2c6b,32,4959743,5141133,5141454,4961696,321,181711,181390,0,0,0
5141772,cac958d3-29e0-4ef9-302b-11fa8fe9554e,64,4958990,5140788,5141772,4961513,984,182782,181798,0,0,0
5141876,1cf8039c-d78a-8da4-2ebc-845e04d5ccf5,64,4958008,5141454,5141876,4961721,422,183868,183446,0,0,0
5142157,306bfcab-d626-011c-821c-83117ca41212,32,4960044,5141876,5142157,4961943,281,182113,181832,0,0,0
5142477,382353f6-2f86-740b-8004-ee586b816a43,32,4958846,5142157,5142477,4961996,320,183631,183311,0,0,0
5142690,ef5c095e-be95-595c-4fdd-c8a6dd16f116,64,4958605,5141772,5142690,4961784,918,184085,183167,0,0,0
5142759,6d3e3d29-b73a-54d7-972f-cb00018f19bb,64,4958891,5142477,5142759,4962009,282,183868,183586,0,0,0
5143304,5d13704a-42d5-6a06-21b2-b4e76d80056f,32,4959503,5142759,5143304,4962465,545,183801,183256,0,0,0
5144285,18e4dce4-bf0d-340a-ba93-2914b7b015a7,32,4958603,5143304,5144237,4962479,933,185634,184701,0,0,0
5144480,4e8fa241-45f0-7409-a955-3dcbee5c9916,64,4958371,5142690,5144480,4962197,1790,186109,184319,0,0,0
5144764,d248da85-3717-6dab-da5b-b9a504877642,32,4958614,5144480,5144764,4962567,284,186150,185866,0,0,0
5145459,29e207c2-6287-94e2-849f-2b6fac913e95,64,4959987,5144285,5145459,4962551,1174,185472,184298,0,0,0
5145721,77c29466-503d-07b0-cdac-28164a7bbd7c,64,4959018,5144764,5145721,4962586,957,186703,185746,0,0,0
5146176,1fe26dde-6bc1-c348-bcd5-a88b3cf9f583,32,4959248,5145721,5146176,4962803,455,186928,186473,0,0,0
5146341,62e0e21e-c27c-9845-bd9d-e2d92d8b8b44,64,4959872,5145459,5146341,4962705,882,186469,185587,0,0,0
5146519,7eac5aa6-ae3c-0f81-7f73-ab5528a48c72,64,4916612,5124060,5146519,4959369,22459,229907,207448,0,0,0
5146828,039a3a5a-b3c9-3829-5250-871b7e4f91c8,32,4959250,5146519,5146828,4963245,309,187578,187269,0,0,0
5147205,a9d7aa10-6c97-2c45-e21d-53f7d3af213d,64,4959246,5146176,5147205,4963086,1029,187959,186930,0,0,0
5148117,82abcdc5-ebb6-16fe-8598-228bb23c1a5b,32,4960976,5147205,5148117,4963258,912,187141,186229,0,0,0
5148177,276e89bd-35a5-86c3-4b3d-b8e5a1b3e828,64,4959899,5146341,5148138,4963180,1797,188239,186442,0,0,0
5148394,bc8bcc8e-2517-78dc-3529-773fd1fc35a4,64,4961418,5148117,5148394,4963495,277,186976,186699,0,0,0
5148490,120cd858-5e49-e4e5-80e7-6be8108c7685,64,4961206,5148177,5148490,4963561,313,187284,186971,0,0,0
5148550,64ee8b95-91f2-508b-1eb9-9729cc39ce1b,64,4959343,5146828,5148534,4963253,1706,189191,187485,0,0,0
5148677,1defb12c-74bb-9795-ddc7-60002e2b675e,64,4968844,5148394,5148677,4970147,283,179833,179550,0,0,0
5148737,c67be8e3-f9e7-5d75-deb4-fe37aa4cfa55,64,4968825,5148490,5148737,4970427,247,179912,179665,0,0,0
5149087,df4189f6-98a6-f490-c1f1-117b4fe0666c,64,4968883,5148677,5149087,4970576,410,180204,179794,0,0,0
5149226,29d64703-1ed2-d255-f353-ed33b93fa08f,32,4969125,5148737,5149226,4970603,489,180101,179612,0,0,0
5149415,cf53ed68-396e-6998-e68f-bae554220adf,32,4968957,5149226,5149415,4970638,189,180458,180269,0,0,0
5149682,ea902fcd-b85b-d1c9-54b7-dc81019bdc10,32,4968882,5149415,5149682,4970885,267,180800,180533,0,0,0
5149854,7db93260-0454-8551-c2d5-706ca34737f8,64,4968883,5149087,5149854,4970620,767,180971,180204,0,0,0
5150035,f1c91224-5286-d5d5-4a5b-3c0fdbc74ea1,64,4969015,5148550,5150035,4970550,1485,181020,179535,0,0,0
5150175,7eb17692-8557-4e06-e0de-dab1f58e3804,64,4969363,5149682,5150175,4971201,493,180812,180319,0,0,0
5150268,ec6a2607-6b2c-fa11-6c80-ed6b09be0e94,64,4968957,5149854,5150268,4971354,414,181311,180897,0,0,0
5150957,f27ccfc3-a532-d31a-f224-0e4b4c0e93af,64,4970143,5150175,5150957,4971525,782,180814,180032,0,0,0
5151072,c146db17-923f-3c9c-c9f1-640811e9dad3,64,4968728,5150268,5151072,4971548,804,182344,181540,0,0,0
5151192,571c4603-8a97-758a-7e19-ed393808d5ae,64,4969542,5150957,5151189,4971549,232,181647,181415,0,0,0
5151571,30563e0d-2a79-a3ee-b1d9-947ad835a834,64,4969319,5150035,5151571,4971487,1536,182252,180716,0,0,0
5151676,3301171d-51b3-b87f-d935-e72126b87fb9,64,4968824,5151072,5151676,4971581,604,182852,182248,0,0,0
5151986,bf22e6d5-4e00-090c-3823-466b3eb667ed,64,4969795,5151571,5151986,4971751,415,182191,181776,0,0,0
5152079,f8bee2ce-1553-e9f0-1f95-fd31a0b5ff79,64,4969991,5151676,5152079,4971836,403,182088,181685,0,0,0
5152620,317a3925-5716-363c-026c-02047bb9a558,64,4969320,5151986,5152620,4971846,634,183300,182666,0,0,0
5152696,70ecd609-3ba6-d077-e536-130d13fa791a,64,4969740,5151192,5152696,4971688,1504,182956,181452,0,0,0
5153217,a6fa6459-880d-c47f-7104-4742f8f1c559,64,4968825,5152620,5153217,4971955,597,184392,183795,0,0,0
5153598,6f3c1308-be0a-a197-a9ea-fe0c576cacea,32,4969916,5153217,5153598,4972074,381,183682,183301,0,0,0
5153718,8f87702e-cab7-8f43-6171-bbf00b3060d3,64,4969615,5152696,5153718,4972038,1022,184103,183081,0,0,0
5154210,a98112a3-94e1-90ac-0a1e-9f2c5f5806cd,32,4968839,5153718,5154210,4972205,492,185371,184879,0,0,0
5154535,b7208f9c-6d88-9408-7dab-868cf9fe9339,64,4969257,5153598,5154535,4972185,937,185278,184341,0,0,0
5154739,db4c4132-dca4-7da8-86be-d30e6ac5a03a,32,4968995,5154210,5154739,4972235,529,185744,185215,0,0,0
5155131,cc6ea4dc-0253-4f81-6a49-aa2cfe0f5393,32,4969916,5154739,5155131,4972261,392,185215,184823,0,0,0
5155331,3ca48bf1-3cd0-0c01-20bb-04fed8c618d3,64,4969449,5154535,5155331,4972259,796,185882,185086,0,0,0
5155549,20478556-d99a-4b6b-2cc9-66f1ff96677e,64,4969622,5155131,5155549,4972363,418,185927,185509,0,0,0
5155951,bb778692-7053-e667-fe00-3e5ceeb9c307,32,4969362,5155549,5155951,4972426,402,186589,186187,0,0,0
5156369,09876eda-7b83-a11c-326a-2092d75bf263,32,4969252,5155951,5156369,4972458,418,187117,186699,0,0,0
5156860,81f140e3-3c6f-bdfe-5ac9-42f4936bd4e5,64,4969188,5155331,5156860,4972405,1529,187672,186143,0,0,0
5157197,104123db-eb09-e05a-ab9a-81bc81990bd5,64,4969123,5156369,5157197,4972557,828,188074,187246,0,0,0
5157363,ad863ff7-a0ae-75e4-0e2d-69d6a3347990,32,4970049,5156860,5157363,4972579,503,187314,186811,0,0,0
5157609,ede310e9-90f6-63ba-dafd-db3b9c556721,64,4970056,5157197,5157609,4972632,412,187553,187141,0,0,0
5157769,08115ed2-17df-04ef-99ae-6f041b832b5b,64,4970728,5157363,5157769,4972652,406,187041,186635,0,0,0
5158040,e49702bb-fa7a-0532-6f1e-f3f7156193d6,64,4970051,5157609,5158040,4972660,431,187989,187558,0,0,0
5158230,3c7445d7-a984-f5b1-96ec-2553f51e0a20,32,4970087,5158040,5158230,4972841,190,188143,187953,0,0,0
5158659,60fa9827-5b10-ac4e-de34-e78d78ec5420,64,4969429,5157769,5158659,4972710,890,189230,188340,0,0,0
5159030,44a277b7-0b8b-b970-49f6-41ca5839fa97,64,4697830,4961503,5159030,4825358,197527,461200,263673,0,0,0
5159155,430bc915-8a6b-0ad3-cc1c-1eb757ab002b,64,4969615,5158659,5159155,4972886,496,189540,189044,0,0,0
5159215,33998952-327a-a3ec-c7c6-ec7552ab019f,64,4969542,5158230,5159215,4972882,985,189673,188688,0,0,0
5159319,b7dde8af-545b-3357-c1ba-d5f7fbc26cbf,64,4970184,5159030,5159319,4972909,289,189135,188846,0,0,0
5159802,544968c9-727d-ab20-98ac-cc08ec909933,64,4969553,5159155,5159802,4973015,647,190249,189602,0,0,0
5160131,fc8f0a6d-fd51-c6dd-295e-5388ee8f9986,64,4970400,5159215,5160131,4973162,916,189731,188815,0,0,0
5160191,c1804a52-f036-7b63-b9c9-b8673e150272,64,4971208,5159319,5160145,4973258,826,188937,188111,0,0,0
5160251,ecdf2959-9d68-f3d9-edb5-56bd6b5e36dd,64,4971110,5159802,5160216,4973436,414,189106,188692,0,0,0
5160624,14b53fb6-f629-21c3-c806-2af492fbbfd8,32,4971359,5160131,5160624,4973474,493,189265,188772,0,0,0
5160684,60e69aba-9522-fc4a-302b-1fe68f9d2bd9,64,4971521,5160251,5160675,4973522,424,189154,188730,0,0,0
5160865,598c94c7-5ae1-cb92-e4af-2b965cfe6ec1,64,4971252,5160624,5160865,4973579,241,189613,189372,0,0,0
5160976,1993a9dc-5ea8-65b5-6cfc-eb2a91e9a59f,64,4971359,5160191,5160976,4973506,785,189617,188832,0,0,0
5161268,f1b1392c-566d-3be2-9fb6-a0e128fcac04,64,4971571,5160865,5161268,4973899,403,189697,189294,0,0,0
5161558,b7c44b0f-1005-7dd9-b028-ce251b5db9c4,64,4970428,5160976,5161558,4973941,582,191130,190548,0,0,0
5161775,e3b9d4cc-aec8-a6c7-6f79-83b2266a1e93,32,4971522,5161268,5161775,4974000,507,190253,189746,0,0,0
5162176,3bd36481-8188-3da9-988d-ebb65b816907,32,4971503,5161775,5162176,4974095,401,190673,190272,0,0,0
5162236,ec32a447-0eb9-3657-9302-9b440ef57d33,64,4970915,5160684,5162225,4973785,1541,191310,189769,0,0,0
5162479,faa55f2f-3bee-059b-6c99-ba6a327b57f4,64,4971656,5161558,5162479,4974012,921,190823,189902,0,0,0
5162588,3cc8b74c-e2a8-72bd-99fe-d808beeb0422,64,4972271,5162176,5162588,4974178,412,190317,189905,0,0,0
5162648,5c49a668-68d5-400f-fc22-9a797be406f6,64,4971360,5162236,5162636,4974182,400,191276,190876,0,0,0
5162983,9de2ab2e-ec70-8454-4044-3dfda0e76b88,64,4971830,5162588,5162983,4974427,395,191153,190758,0,0,0
5163119,60942e28-8ede-e9d2-a94f-36f819056cd3,64,4971423,5162648,5163119,4974567,471,191696,191225,0,0,0
5163366,afd70d9e-a045-5766-bb71-086d9fb540d0,64,4971248,5162479,5163366,4974255,887,192118,191231,0,0,0
5163426,f35333c2-f9aa-0d30-ea38-dd49e7e96c17,64,4972626,5163119,5163387,4975741,268,190761,190493,0,0,0
5163486,67276f71-20f9-e3ab-9fd5-7acfff88c1cd,32,4971358,5162983,5163481,4974603,498,192123,191625,0,0,0
5163578,4205dca4-7ee4-ba9e-341e-f8e301d8fb45,64,4973065,5163426,5163578,4976240,152,190513,190361,0,0,0
5163643,9b9b4213-1fe3-86e7-e4ca-27449ea1c75f,64,4972559,5163366,5163643,4976024,277,191084,190807,0,0,0
5163971,55d0bf15-3b93-105c-d8f0-c9cc5645c2e5,32,4990486,5163643,5163971,4995207,328,173485,173157,0,0,0
5282489,9c9c2844-e579-aa75-f94b-c0d94594e2c4,64,4726110,5005311,5282489,4861770,277178,556379,279201,0,0,0
5282816,92dccbc7-474f-d709-944d-31d1957bce2f,32,4994704,5282489,5282816,4997887,327,288112,287785,0,0,0
5283179,ceb312a0-1056-9d08-f8a3-c268147a4262,32,4994351,5282816,5283179,4997890,363,288828,288465,0,0,0
5284351,09d7e0d4-977a-cb60-cdb2-506b56d639d2,32,5003981,5283179,5284351,5007646,1172,280370,279198,0,0,0
5285319,6582a48e-4d87-ebfd-b6db-9de7d67b2ef2,32,5009778,5284351,5285319,5012103,968,275541,274573,0,0,0
5285889,2ac570c0-da33-6eb6-84a9-a8f0865a34f1,32,5009961,5285319,5285889,5013765,570,275928,275358,0,0,0
5286557,468d0623-153e-9f52-d495-1de65e24a913,32,5009908,5285889,5286557,5014598,668,276649,275981,0,0,0
5289708,8e88eec1-b088-e8ce-4f6e-93bca6c38512,64,4754603,5070113,5289708,4904463,219595,535105,315510,0,0,0
5290559,1516e93b-3443-a23b-2baa-9f5f0bb7090b,32,5034008,5289708,5290559,5040195,851,256551,255700,0,0,0
5291461,9dbc55e3-068f-d0ed-a138-91b80799aef3,32,5033886,5290559,5291461,5042453,902,257575,256673,0,0,0
5292517,32b27bec-51e6-5866-f7b8-70c37b5c2074,64,4006871,4752159,5292517,4734690,540358,1285646,745288,0,0,0
5294001,6e8a00d0-cbf3-0ce4-51bb-655f19abce44,64,5033820,5291461,5294001,5046095,2540,260181,257641,0,0,0
5296435,1b3c5439-033b-d630-784b-d85d3fbaec62,64,5033951,5292517,5296435,5046653,3918,262484,258566,0,0,0
5297318,90f627ab-4bb5-cb8c-23f6-f74c33df2628,64,5033854,5294001,5297318,5047868,3317,263464,260147,0,0,0
5300449,ecc6e42b-f065-4454-0050-b10eec9fdc59,64,5034040,5296435,5300449,5049484,4014,266409,262395,0,0,0
5300513,b9b4c191-0c0e-f1da-dd14-f6dfe86ceeb2,64,5033918,5297318,5300513,5049634,3195,266595,263400,0,0,0
5302766,58bdb036-a1f2-e4b7-1e93-df2435e67875,32,5051020,5300513,5302766,5056282,2253,251746,249493,0,0,0
5304048,0d005182-3144-cec7-de08-ff93c257d3cf,64,5033446,5300449,5304048,5049814,3599,270602,267003,0,0,0
5304557,7b532071-2889-af18-f91d-5ba50293cc55,64,5050989,5302766,5304557,5057456,1791,253568,251777,0,0,0
5306403,6495fd6a-0fe3-f047-db14-2d73708ce69a,64,5051083,5304048,5306403,5058514,2355,255320,252965,0,0,0
5306466,f3d95893-9c0b-a5a8-d69e-f2b5273ea833,64,5051051,5304557,5306466,5059527,1909,255415,253506,0,0,0
5307830,b5f56bfb-d679-dc4e-b33c-f9d7e2f2809b,64,5046503,5306403,5307830,5059596,1427,261327,259900,0,0,0
5308904,303fe6b5-ad01-a254-031e-acd7e888ef39,32,5049423,5306466,5308904,5060068,2438,259481,257043,0,0,0
5313262,7968d7ed-7e93-7c6a-88f2-906ed0dc2b6c,32,5064335,5308904,5313262,5090390,4358,248927,244569,0,0,0
5313507,bb57db59-721d-26a2-db5d-526debc769a5,32,5088434,5313262,5313507,5091352,245,225073,224828,0,0,0
5316691,f19d0794-0371-ae58-31bd-b481d7aa4080,32,5064294,5313507,5316691,5092155,3184,252397,249213,0,0,0
5317190,0e5d3732-69b2-d940-fa28-7c6a7e52d77c,32,5086658,5316691,5317190,5093526,499,230532,230033,0,0,0
5317608,82ca0555-f0f5-24f0-81c9-938b6e89b1f5,32,5088350,5317190,5317608,5093532,418,229258,228840,0,0,0
5319909,0d6a88ee-17d5-4882-d91f-c938647f09c5,32,5062674,5317608,5319909,5094053,2301,257235,254934,0,0,0
5320456,e639987e-14fc-c4d4-eb6b-e136d6096b02,32,5088411,5319909,5320456,5094135,547,232045,231498,0,0,0
5321120,4e212285-8686-6e49-ef93-77219e49f4b1,32,5088237,5320456,5321120,5095544,664,232883,232219,0,0,0
5332428,524e01d5-1324-4a2e-4d02-f44ce4484af9,64,5048607,5307830,5332428,5085283,24598,283821,259223,0,0,0
5337368,f63a43a4-ebd4-9442-869f-58a6d021e97a,64,5062716,5321120,5337368,5098023,16248,274652,258404,0,0,0
5337593,c862d11d-0e2b-88e3-0b97-7561cbb42479,32,5098984,5337368,5337593,5100137,225,238609,238384,0,0,0
5337817,101181e7-f669-14e4-9869-437985fc862f,32,5099119,5337593,5337817,5101041,224,238698,238474,0,0,0
5338006,4b358e49-08cd-1201-7b8a-23a5251deaf6,32,5099109,5337817,5338006,5101494,189,238897,238708,0,0,0
5342170,6a88aec7-5cf5-ed5c-cdaf-b798c2ea6bf8,64,5050862,5332428,5342170,5098499,9742,291308,281566,0,0,0
5356322,c0758b44-ce35-befc-c424-ccc4de431418,64,4705572,5163486,5356322,4985352,192836,650750,457914,0,0,0
5366053,6cfc78a6-0b98-ae6b-a834-81b9f4bc3def,64,5049330,5342170,5366053,5103642,23883,316723,292840,0,0,0
5366640,058bc608-5287-26d1-798e-5fe23a0c867a,64,4826080,5152079,5366640,4971874,214561,540560,325999,0,0,0
5369674,a67a33b2-e0f1-2e78-5cd8-f495dc54abbf,64,5049456,5356322,5369674,5104006,13352,320218,306866,0,0,0
5374085,382edc11-ea7a-c5d5-24cf-fe3b82d3f21c,64,5048643,5366053,5374085,5105090,8032,325442,317410,0,0,0
5382012,30aff761-7856-3be6-0a18-8e357ecb52f6,64,4726110,5163971,5382012,4997645,218041,655902,437861,0,0,0
5383680,eafa0f6e-fdc0-949d-b921-643e27ff70a8,64,5049234,5366640,5383680,5105772,17040,334446,317406,0,0,0
5387352,85f4cbc3-eb23-70ae-8664-92607255a8c6,64,5050894,5369674,5387352,5107858,17678,336458,318780,0,0,0
5387761,bbf662e4-5b40-d366-6fe6-c12e5bb033d5,64,5049389,5374085,5387761,5110757,13676,338372,324696,0,0,0
5397467,cb71266f-d6df-9f18-1361-2ff6061e4a06,64,5049488,5387352,5397467,5117573,10115,347979,337864,0,0,0
5397824,8c63f503-49b2-748c-615e-729e102925ea,64,5048675,5383680,5397824,5116486,14144,349149,335005,0,0,0
5401356,0198bf4a-06e1-0612-c466-b6570f38ff0d,64,5048706,5397467,5401356,5123303,3889,352650,348761,0,0,0
5404380,d041bfbc-0718-2cc2-5dae-b8abf25bce3f,64,5048836,5338006,5404380,5102993,66374,355544,289170,0,0,0
5406189,5f9b2e48-69dc-1246-31fd-2a50aa90d814,64,5046622,5387761,5406189,5119396,18428,359567,341139,0,0,0
5407353,ff295623-b5ac-db83-9305-bcc7be67a988,64,5050924,5401356,5407353,5135184,5997,356429,350432,0,0,0
5408875,607fba83-540a-ce34-bfeb-59aa0b0706ca,32,5129876,5406189,5408875,5143084,2686,278999,276313,0,0,0
5411060,56e6f05c-94aa-c293-d8dd-62f3d2a8c74c,64,5019597,5404380,5411060,5137003,6680,391463,384783,0,0,0
5413861,00cb9ca8-7490-13bb-4824-d06c00e970b5,64,5049298,5407353,5413861,5146775,6508,364563,358055,0,0,0
5416986,691bb5ed-68ba-8665-616a-858feeb2610b,64,5145958,5411060,5416986,5163853,5926,271028,265102,0,0,0
5419868,46bf67c2-5908-f91f-1ba7-87a71a4000fb,64,5048803,5382012,5419868,5115532,37856,371065,333209,0,0,0
5419928,56ca8ab2-ab73-8d8b-77b6-b01bed120bde,64,4726110,5163578,5419917,4995137,256339,693807,437468,0,0,0
5421383,6bca8bff-1067-cc73-bf77-a359fcad595b,64,5145990,5416986,5421383,5167058,4397,275393,270996,0,0,0
5422270,0fd5b701-bf93-c05b-b425-5262ea1910fb,64,5050956,5397824,5422270,5128322,24446,371314,346868,0,0,0
5422480,0715f7b9-6173-0972-27fe-61a45200372d,32,5168402,5422270,5422480,5169652,210,254078,253868,0,0,0
5423248,25816faa-19da-ac66-6719-5825baf1f71c,32,5168464,5422480,5423248,5170446,768,254784,254016,0,0,0
5430145,44ba505c-09db-a2bb-313b-897c0c88a547,64,5146022,5419868,5430145,5167930,10277,284123,273846,0,0,0
5431082,56b75a37-a4df-69f8-d696-3fff1d17a05d,64,5147720,5419928,5431082,5168820,11154,283362,272208,0,0,0
5437396,33e0db2a-f04b-04ff-0930-43f372b0e713,32,5144225,5431082,5437396,5176102,6314,293171,286857,0,0,0
5445009,932aff00-1ec5-bd54-091c-719507015ccc,32,4360969,5055557,5445009,4890717,389452,1084040,694588,0,0,0
5445604,4e9f6791-d091-6613-d88e-ac42c11be750,64,5135807,5423248,5445604,5172528,22356,309797,287441,0,0,0
5448418,abe4d36b-45a8-61a1-ae89-55b74e21e25a,64,5135625,5437396,5448418,5176806,11022,312793,301771,0,0,0
5451374,b81505d0-42c8-cb7e-e961-16419eb65e43,32,5151127,5448418,5451374,5189345,2956,300247,297291,0,0,0
5451687,d26f8ad2-3e14-8ddb-1dd6-a3901aba5cff,64,5135686,5445604,5451687,5177259,6083,316001,309918,0,0,0
5455848,e2c00373-d6a0-b874-2606-f7350c37ef93,32,5135745,5448418,5455848,5188441,7430,320103,312673,0,0,0
5456850,3273833c-a1c5-90f6-4cc0-6006ed0b5013,64,5048771,5430145,5456850,5173938,26705,408079,381374,0,0,0
5465311,280b3fa0-e5dd-745e-072c-05f041516913,64,4761478,5286557,5465311,5017719,178754,703833,525079,0,0,0
5471294,3c58eaf8-5fad-8791-82cd-7427ce7b8cb6,64,5057163,5456850,5471294,5243717,14444,414131,399687,0,0,0
5475290,f4f0bdf9-fd65-3071-be49-86c4cd3fd77c,64,5049266,5408875,5475290,5160305,66415,426024,359609,0,0,0
5480744,875a3cf1-96e3-3429-a418-161eb08fd85a,64,5132222,5451374,5480744,5195157,29370,348522,319152,0,0,0
5582308,acdf2af6-fc74-da51-a46e-b335a2cc3129,64,4608517,4997744,5582308,4856689,584564,973791,389227,0,0,0
5667957,332e3b74-e22a-2629-901c-4135ee9340bb,64,4679609,5451687,5667957,5210826,216270,988348,772078,0,0,0
5688250,109b9d83-64af-7bf1-230a-46be20b1f589,64,4851821,5413861,5688250,5164688,274389,836429,562040,0,0,0
5784414,7be928c5-e4ca-f2a2-11ed-2087d9c12f8d,64,4835615,5465311,5784414,5277042,319103,948799,629696,0,0,0
5926371,7b4b5ace-a265-d63d-53dc-42cdb35651f8,64,4606662,5421383,5926371,5169208,504988,1319709,814721,0,0,0
