time,job_id,num_gpu,submit_time,start_time,end_time,ddl,executed_time,JCT,pending_time,preempt,promote,best_effort_job
14581,f238bb58-d7b1-1fd7-18b0-8e2d5c11434f,8,12010,12010,14581,14335,2571,2571,0,0,0,0
15854,56e636a4-b989-7050-a0ed-474e3707a3ac,8,10944,10944,15854,16849,4910,4910,0,0,0,0
17744,37b9491b-7d09-8dc1-fe78-97fadae20e52,8,14858,14858,17744,17774,2886,2886,0,0,0,0
17764,c360e99e-4ee6-60ec-3f4b-9506690190da,8,15377,15377,17764,18269,2387,2387,0,0,0,0
20965,d611eab8-5045-f270-46bb-7fc7957f8096,8,10991,11004,20965,21222,9961,9974,13,0,0,0
22299,ba63f893-e314-dce1-f0ff-606eaa2cd9c9,8,11191,11191,22299,23856,11108,11108,0,0,0,0
25497,fc549e41-b492-8641-2c42-33669e1e7568,8,18694,18694,25497,28627,6803,6803,0,0,0,0
28438,16882d81-ea36-139a-467f-9ae1e8597efb,8,11052,11064,28438,22577,17374,17386,12,0,0,0
39220,e61d14c6-f6e3-8919-6745-f82d51e453fa,8,37745,37745,39220,38899,1475,1475,0,0,0,0
47508,b4b80eec-9640-4f3c-77d1-ea9cd79190c6,8,40426,40442,47508,44748,7066,7082,16,0,0,0
63867,ee956a3a-9686-7dcf-0c22-8b723f5f7fdc,8,11108,11124,63867,86367,52743,52759,16,0,0,0
68213,048c238d-46eb-0138-10ee-358ef791645d,8,11237,11251,68213,64753,56962,56976,14,0,0,0
68486,20a14880-c09d-1a5d-37ce-f3b904ba3313,8,67499,67499,68486,68658,987,987,0,0,0,0
68564,e87c4905-c09d-62be-9fce-91c380e428e6,8,67555,67559,68564,68657,1005,1009,4,0,0,0
89384,437956f8-eb8a-cd15-1f2d-3573cfea9738,8,53696,53735,89384,99378,35649,35688,39,0,0,0
91766,777042d2-845d-f425-86a6-d4ba753ebae7,8,53675,53675,91766,108104,38091,38091,0,0,0,0
92129,fcbf0e8a-2f76-5277-a823-22267e459ab7,8,53717,53735,92129,96181,38394,38412,18,0,0,0
93429,77009e43-7af3-1f44-7a03-d8a09f5b4ced,8,22951,22951,93429,102271,70478,70478,0,0,0,0
98818,4565e77f-f7f2-7d96-c823-bd8aefd18b7b,8,97739,97739,98818,99067,1079,1079,0,0,0,0
103389,a8b62ca9-a0c1-908c-0aa0-177aeaa31841,8,33532,33532,103389,117948,69857,69857,0,0,0,0
105391,7915533a-2f10-5655-153a-331e7c841363,32,55357,55396,105391,114313,49995,50034,39,0,0,0
109661,865634e3-da21-6cf7-d897-de9a8b626ce4,16,108927,108927,109661,109786,734,734,0,0,0,0
115255,57cb90a8-bd59-0275-403d-2d9fb5e2ec2d,8,40298,40310,115255,118597,74945,74957,12,0,0,0
120366,c577cbb7-59da-d47f-0942-941d9d32fceb,8,40250,40250,120366,92222,80116,80116,0,0,0,0
120367,2d37f9ba-67be-34ab-6bc2-4e093236c39b,8,40382,40382,120367,94422,79985,79985,0,0,0,0
124037,7f59be37-a981-cfc5-3222-fab3d5d2d13b,32,52897,52897,124037,99023,71140,71140,0,0,0,0
126310,77339180-ca8d-373d-9bac-88c790a4354f,8,11291,11311,126310,74762,114999,115019,20,0,0,0
147271,8bae04ed-39d0-f832-1d72-b0e54c51669b,8,139468,139468,147271,149443,7803,7803,0,0,0,0
150630,50926491-582f-78cc-29ee-915371c50017,8,70070,70070,150630,121591,80560,80560,0,0,0,0
153500,aff0e0a8-b7e2-126e-48e2-741334322572,8,139633,139633,153500,151288,13867,13867,0,0,0,0
156927,cf2df4a6-c972-0c70-8561-88e7566b8b3a,8,139891,139900,156927,161855,17027,17036,9,0,0,0
162162,d7d3b79e-040c-fc63-be7f-449467ed805d,8,139780,139780,162162,161868,22382,22382,0,0,0,0
166461,74cc7889-ca55-6921-bc8e-2ed7a52bdb1c,8,132792,132792,166461,171742,33669,33669,0,0,0,0
170333,ad3970d1-125d-f3d8-e465-2ac74b06dd1d,8,24927,24927,170333,113688,145406,145406,0,0,0,0
171905,eeb226f2-a49a-b750-c22b-2c5a1477ba83,8,69241,69241,171905,215787,102664,102664,0,0,0,0
179074,5b7aae49-f5c8-e52d-98c7-9f9c3b65c1be,8,32798,32798,179074,206131,146276,146276,0,0,0,0
186009,0d0147b0-d342-b587-2bba-374c46992fb4,8,157172,157212,186009,197549,28797,28837,40,0,0,0
186195,88dba487-8203-2ecd-7def-181800ab5064,8,157200,157212,186195,174110,28983,28995,12,0,0,0
186259,cd03e267-178e-c3e5-28db-b62e88046d28,8,157180,157212,186259,178646,29047,29079,32,0,0,0
186327,d7b44659-4b98-4523-43f8-a27529bcca3d,8,157190,157212,186327,178542,29115,29137,22,0,0,0
186343,48486346-877d-2b8c-7bab-4ee4f10adbca,8,157164,157212,186343,173206,29131,29179,48,0,0,0
186446,afdbc05b-fca5-97de-0adb-b96870a13c89,8,157152,157152,186446,187715,29294,29294,0,0,0,0
187016,9c8b3eee-fd5c-e523-fbce-836bdf847873,8,185529,185529,187016,186818,1487,1487,0,0,0,0
189498,e41b87bb-cbe7-a835-366a-2438c946a8ab,32,94941,94950,189498,188639,94548,94557,9,0,0,0
191892,4333fe5a-ec68-08bc-0ca3-71413ae8d359,16,134405,134405,191892,178871,57487,57487,0,0,0,0
193065,4b9c80b5-8c49-767d-9dfa-37afb3b755ca,16,134420,134465,193065,178592,58600,58645,45,0,0,0
193902,959c0ce9-01bc-4c82-ff20-68e8647aab28,8,139834,139840,193902,187715,54062,54068,6,0,0,0
194654,a3dc3b5a-91d4-0d13-d5a8-38fa953ba84b,1,191621,191621,194654,194370,3033,3033,0,0,0,0
194687,3be67049-56fe-51c2-8a77-a76040a92e54,1,191624,191681,194687,194492,3006,3063,57,0,0,0
199552,adde1b86-f82e-d407-f910-ae91f2e51838,8,170611,170634,199552,207534,28918,28941,23,0,0,0
199600,ac21a335-e93c-8172-4300-6a4d353b597d,8,170574,170574,199600,209183,29026,29026,0,0,0,0
199628,4f261681-bebe-ea42-b1c3-26c01841305e,8,170582,170634,199628,211779,28994,29046,52,0,0,0
199716,8706741a-16ae-2932-5a31-45cfbbde30b8,8,170602,170634,199716,193730,29082,29114,32,0,0,0
199799,305e9f5b-7920-a373-724b-6827cff692bf,8,170592,170634,199799,198788,29165,29207,42,0,0,0
200076,fcc584be-3d4a-5466-f3ac-ca685d5ffefd,8,170620,170634,200076,203807,29442,29456,14,0,0,0
210438,9cd4a286-5452-b711-0443-b76669e8d3a4,8,208858,208858,210438,210204,1580,1580,0,0,0,0
210753,ad50dfe2-b7cb-05a0-b72d-c42160671542,16,210078,210078,210753,210667,675,675,0,0,0,0
212265,43b368c5-797b-4275-9e8c-7c4b92042eee,8,210433,210433,212265,212358,1832,1832,0,0,0,0
212353,97a6e2bc-ec7c-c6e6-7e6d-39b86364d40f,16,211675,211675,212353,212628,678,678,0,0,0,0
213106,5d63e77a-5339-d570-b14c-2e0f1c1c9d60,16,212422,212422,213106,213169,684,684,0,0,0,0
213729,943b1745-2d35-3a8c-3788-881c598c0a9c,32,93762,93762,213729,154072,119967,119967,0,0,0,0
214674,ff597c4d-a586-bd7a-9233-02e5d435b914,32,95698,95698,214674,175376,118976,118976,0,0,0,0
215188,392d920f-421f-89e2-fea9-446a196fc2ec,16,214443,214496,215188,215366,692,745,53,0,0,0
215754,85d438ce-9a87-aebf-946b-6e101d2f82d1,8,139942,139960,215754,192570,75794,75812,18,0,0,0
216042,af058480-d06f-c1bf-7f87-dd85371d1ce4,16,215252,215252,216042,216239,790,790,0,0,0,0
216683,3445b47c-8079-e2ec-ebdc-2c9daef7c60b,32,94469,94469,216683,275018,122214,122214,0,0,0,0
219428,04ba16cc-e5d1-da78-9e01-9bfea0cd173d,32,96175,96179,219428,172897,123249,123253,4,0,0,0
223815,54ce894d-6db3-a232-589a-15bdf61962af,1,216748,216799,223815,226378,7016,7067,51,0,0,0
223824,5b97f442-e813-5b18-144f-5955dfff1aa0,1,216739,216739,223824,220759,7085,7085,0,0,0,0
223862,13fa0b22-3597-1f2f-6497-2ae136a5ddd5,1,216740,216799,223862,223646,7063,7122,59,0,0,0
223863,2d91bd7c-dbee-1e63-0d6e-7885ab7af4cf,1,216740,216799,223863,226120,7064,7123,59,0,0,0
223840,ebac3a24-40ee-43bb-fc8c-1b53726e0a16,1,216741,216799,223840,226676,7041,7099,58,0,0,0
223839,dfa896db-18a5-d9f5-5036-ba69a66db249,1,216744,216799,223839,223361,7040,7095,55,0,0,0
223863,fc44347f-33cc-0e85-3ec6-0206fe0ccfed,1,216744,216799,223863,224334,7064,7119,55,0,0,0
223863,a2dbcc0b-aa6f-7e94-3a80-2e71ec679415,1,216744,216799,223863,222958,7064,7119,55,0,0,0
223855,9bdd9bc7-4160-e5cf-aede-eb37f8c422f9,1,216745,216799,223855,226216,7056,7110,54,0,0,0
223856,f3150cf7-8237-7592-8cec-2d0722e96c15,1,216746,216799,223856,224118,7057,7110,53,0,0,0
223850,7a5e3d52-3694-1aa7-d3ac-082bfdf56e9f,1,216748,216799,223850,221622,7051,7102,51,0,0,0
223849,947a2d8e-0116-f6ca-36e0-8a0d530527ea,1,216748,216799,223849,226554,7050,7101,51,0,0,0
223925,a449f39f-c7e3-62e9-01e7-ec523c0c9cca,1,216740,216799,223925,221215,7126,7185,59,0,0,0
223915,3fd9d7e7-7d15-da16-07f0-53808c1f3cfb,1,216742,216799,223915,221875,7116,7173,57,0,0,0
223916,b7e94075-1156-bbed-6c52-c5f9ead7dce2,1,216744,216799,223916,220371,7117,7172,55,0,0,0
223896,865f3f8f-defe-a65d-3c47-909331c152d2,1,216746,216799,223896,223667,7097,7150,53,0,0,0
223896,d4b27037-bfac-fdfc-8819-fdd70c017077,1,216747,216799,223896,225703,7097,7149,52,0,0,0
223881,5a4d6a5f-c1c6-9f79-f1ea-44de4bb38a82,1,216748,216799,223881,225089,7082,7133,51,0,0,0
223893,c2464175-cd99-8628-1c85-510c79cebed1,1,216751,216799,223893,225113,7094,7142,48,0,0,0
223937,998b6dd0-acf7-d36b-5683-0bf8cb79dcb5,1,216740,216799,223937,223975,7138,7197,59,0,0,0
223937,4a8cd2e9-c608-301b-814f-d9bac71c41f8,1,216740,216799,223937,224855,7138,7197,59,0,0,0
223938,8e9a911d-9aa8-561d-ecb7-6586eac2bf6c,1,216740,216799,223938,222143,7139,7198,59,0,0,0
223948,3e22c222-7af7-796a-5e47-ca1bb4489b2d,1,216742,216799,223948,226543,7149,7206,57,0,0,0
223949,55705d78-70ff-6ae5-eaa1-9c1af64a4a5d,1,216744,216799,223949,226169,7150,7205,55,0,0,0
223953,ad1e8be8-2a9d-a558-0843-69644dd2519a,1,216747,216799,223953,220559,7154,7206,52,0,0,0
226526,03962951-9704-ac60-24f7-a71d42ab7894,32,93775,93822,226526,276198,132704,132751,47,0,0,0
230644,a21a28bb-c981-5489-558d-fdfa2e46c7f1,1,221321,221335,230644,232996,9309,9323,14,0,0,0
230703,f6e0a26e-39bc-e100-5167-a3df29d2680a,1,221275,221275,230703,235007,9428,9428,0,0,0,0
230678,a24015d1-c30b-2db6-2095-8a6968607a49,1,221279,221335,230678,227879,9343,9399,56,0,0,0
230671,b1600dd3-e492-3e6f-c394-7d86786a2e77,1,221319,221335,230671,227651,9336,9352,16,0,0,0
230738,c189c9f2-38d5-d872-62b1-d31f05c75509,1,221429,221481,230738,227734,9257,9309,52,0,0,0
230804,ee576a97-0ddd-7c45-9cb4-e742de1657e2,1,221421,221421,230804,227517,9383,9383,0,0,0,0
230811,fff12088-a824-c9bf-64c1-e751d1061f9b,1,221487,221541,230811,235028,9270,9324,54,0,0,0
230865,20f41f0b-2401-9b6a-84f1-4a20bd7cff65,1,221425,221481,230865,232322,9384,9440,56,0,0,0
230865,708292e7-c14a-81a5-b0a5-94afe3893cdb,1,221550,221601,230865,227636,9264,9315,51,0,0,0
230923,03a7712a-422c-3797-f6ee-23437dcc57c5,1,221545,221601,230923,227444,9322,9378,56,0,0,0
231022,6bbb8d0e-f46e-c77e-937b-d589e4e805bd,1,221554,221601,231022,231023,9421,9468,47,0,0,0
231893,89da9d78-5a20-9e04-5e00-2e3b0f7c1a7b,8,213965,213982,231893,230937,17911,17928,17,0,0,0
233066,20e2da14-ff08-862c-bc66-d391069cd309,32,96548,96548,233066,187196,136518,136518,0,0,0,0
237315,97711705-9154-90f6-807a-2c52990cf751,8,213922,213922,237315,244309,23393,23393,0,0,0,0
239986,0fa4255f-04f9-98bc-f8a3-7953cbe54314,8,216081,216102,239986,239699,23884,23905,21,0,0,0
240127,fc05ffa6-a176-1dbb-cdd9-203d3392f492,8,216294,216294,240127,245566,23833,23833,0,0,0,0
243833,fc158826-33a6-53ab-bb5b-7ded6d2e6d15,1,216696,216739,243833,230727,27094,27137,43,0,0,0
244046,4be9e5d7-b3d9-16f2-d7aa-abb2637b510c,1,216688,216739,244046,248429,27307,27358,51,0,0,0
244121,d4c45e2e-6868-ad71-c588-43a747d73519,1,216691,216739,244121,236089,27382,27430,48,0,0,0
244121,3c316398-4415-428a-1800-cb2a33b8ae5d,1,216691,216739,244121,231200,27382,27430,48,0,0,0
244135,50f30807-982d-91ca-2b8b-bd4a0e277ff4,1,216687,216739,244135,230704,27396,27448,52,0,0,0
244137,c37beeab-1d23-dfce-0c1f-dc0ab29c6d64,1,216687,216739,244137,237735,27398,27450,52,0,0,0
244179,b3996db3-c73c-8a02-2573-ed568d51dfb4,1,216687,216739,244179,236672,27440,27492,52,0,0,0
244180,4239433a-4a87-e802-e6cb-1d280d92736a,1,216688,216739,244180,245809,27441,27492,51,0,0,0
244137,2faa2bc3-feef-e7f1-332c-d7780621e9e2,1,216688,216739,244137,244993,27398,27449,51,0,0,0
244127,c12fea40-f492-2364-f3d5-c6e4549a7bed,1,216688,216739,244127,240501,27388,27439,51,0,0,0
244145,ee03f18e-b4dc-fd71-05e7-c959a47c25e7,1,216692,216739,244145,242269,27406,27453,47,0,0,0
244122,ced36e66-4523-3269-20a2-2ec985a7e996,1,216692,216739,244122,249572,27383,27430,47,0,0,0
244146,9efd76be-ca20-9861-720a-f6005c5bf9bf,1,216692,216739,244146,250519,27407,27454,47,0,0,0
244144,6e2ef8d7-b140-c586-ee6d-6442dd84e56c,1,216692,216739,244144,246587,27405,27452,47,0,0,0
244143,4a2671b5-587b-521c-2888-e146844c9783,1,216692,216739,244143,230586,27404,27451,47,0,0,0
244123,2f650efa-40ac-67a1-9bf4-a1ac03099cca,1,216692,216739,244123,246004,27384,27431,47,0,0,0
244147,fe73d88f-2fbc-d67a-6bd7-cc06733a3248,1,216695,216739,244147,255611,27408,27452,44,0,0,0
244130,5a126037-e627-484b-4625-ed2da2480776,1,216696,216739,244130,232896,27391,27434,43,0,0,0
244202,f110b192-3f2b-21c5-ddfb-8af9bccce1c9,1,216691,216739,244202,251853,27463,27511,48,0,0,0
244214,fc92089c-e2ee-1603-9b30-1c38d6a5228f,1,216695,216739,244214,239395,27475,27519,44,0,0,0
244231,aac57e20-e8f4-5672-a170-a0c61ad545b4,1,216695,216739,244231,243680,27492,27536,44,0,0,0
244271,9b34c649-26f8-03c6-d886-8d4d493bafc4,1,216687,216739,244271,250617,27532,27584,52,0,0,0
244252,4d39f29f-7fd3-3daf-a31c-6761eb002062,1,216688,216739,244252,243489,27513,27564,51,0,0,0
244244,dfe105aa-80da-97fe-f7ba-444fb2d3c152,1,216691,216739,244244,237169,27505,27553,48,0,0,0
244341,63a2d840-9394-57cb-4cc9-6644b13780e2,1,216688,216739,244341,237294,27602,27653,51,0,0,0
245303,7bd06794-2985-cdd3-4a1d-5528d85a254f,8,213989,214042,245303,248281,31261,31314,53,0,0,0
247316,fb0ba48c-eafe-3984-7667-937497f5533b,32,158733,158733,247316,249949,88583,88583,0,0,0,0
248564,139cebb3-7e3b-534b-f549-4b5d071ef20f,1,242119,242174,248564,249417,6390,6445,55,0,0,0
248584,cbec5016-4e82-fd5e-8756-e05035cb8d41,1,242114,242114,248584,246633,6470,6470,0,0,0,0
248572,5fb26d34-4115-d12e-005e-0b17dbae47c4,1,242115,242174,248572,248554,6398,6457,59,0,0,0
248572,a03d6f69-021c-facb-2673-6d23c5d0a0ac,1,242115,242174,248572,251525,6398,6457,59,0,0,0
248619,e929e7df-ff50-e581-edf7-aa29b7ff9c83,1,242115,242174,248619,247246,6445,6504,59,0,0,0
248601,e8119ab9-6c2e-ae0b-74a0-2c1f235992b8,1,242119,242174,248601,246859,6427,6482,55,0,0,0
248569,96f35771-242b-f7bf-c621-068e0443d9a8,1,242120,242174,248569,251061,6395,6449,54,0,0,0
248570,7bb7acd2-ac33-f5c1-ccb8-d6d60253e7b2,1,242123,242174,248570,250298,6396,6447,51,0,0,0
248616,2abb1647-d838-6f30-b70b-da21dd728d56,1,242123,242174,248616,250234,6442,6493,51,0,0,0
248637,28be894a-c6bb-2bbc-5461-74aaea258c65,1,242114,242114,248637,248838,6523,6523,0,0,0,0
248627,80f7c5f0-16e3-3c1d-c020-6118ed16bee5,1,242115,242174,248627,247016,6453,6512,59,0,0,0
248665,4862f17d-d37f-4be6-0dde-abcc6b258cbb,1,242119,242174,248665,248049,6491,6546,55,0,0,0
248630,e50399b7-8225-eb62-c700-be387ece75ee,1,242120,242174,248630,247044,6456,6510,54,0,0,0
248676,8c2c7d5c-d315-dad4-46ba-b6b11e100f9b,1,242121,242174,248676,246200,6502,6555,53,0,0,0
248638,f4d0d392-8ee9-0d39-fdfa-71a36c88d143,1,242124,242174,248638,250839,6464,6514,50,0,0,0
248640,f6003f09-9d53-e7f8-49a9-17d6c43953ed,1,242125,242174,248640,245854,6466,6515,49,0,0,0
248641,e303f451-ae36-22de-a913-a92ba410aa1a,1,242126,242174,248641,245869,6467,6515,48,0,0,0
248736,49fd5ee5-5192-afa7-387c-fb13340bffcb,1,242115,242174,248736,246878,6562,6621,59,0,0,0
248691,e157c124-fea9-dfb9-a385-31a9d1e63fb7,1,242115,242174,248691,247931,6517,6576,59,0,0,0
248734,4828eb85-a47d-657e-d6c4-bd5ce155d338,1,242115,242174,248734,247304,6560,6619,59,0,0,0
248727,2fd07b2f-7fb8-66bc-df8e-5693b290256f,1,242115,242174,248727,251250,6553,6612,59,0,0,0
248701,e9e73d57-9e7d-146b-07b8-bdeee90cbc49,1,242120,242174,248701,250396,6527,6581,54,0,0,0
248739,3eed5faf-c100-58ca-04dd-9975e3b5dd9f,1,242121,242174,248739,250964,6565,6618,53,0,0,0
248740,0dc2cee5-98f0-2d68-0a2c-9d8677060c7a,1,242121,242174,248740,245955,6566,6619,53,0,0,0
248781,a95d9448-ba98-4aef-4017-1c1a7101fcfc,1,242122,242174,248781,249836,6607,6659,52,0,0,0
248932,6cfa7287-8717-be6d-b5e2-478837ea3dc9,32,132724,132724,248932,235618,116208,116208,0,0,0,0
249167,adaa9b78-48cf-ed22-9529-87bbb9a27cd5,1,240183,240187,249167,252937,8980,8984,4,0,0,0
249186,ba42733c-4b59-0745-f29c-db17ba28a2b9,1,240182,240187,249186,250319,8999,9004,5,0,0,0
249180,9883c611-3c17-fa07-2944-12af3c782140,1,240183,240187,249180,252758,8993,8997,4,0,0,0
249169,d1f2be97-0bae-462c-704c-8a7d97955602,1,240183,240187,249169,250972,8982,8986,4,0,0,0
249193,07083aa6-8d64-c7d3-54cf-479fbc006136,1,240187,240187,249193,252501,9006,9006,0,0,0,0
249264,f7ddb1c3-fc7e-d140-60e5-85ab803e8d5f,1,240180,240187,249264,250652,9077,9084,7,0,0,0
249234,53b7a1d5-240f-d31c-ec65-7e3d88aca9f6,1,240180,240187,249234,252682,9047,9054,7,0,0,0
249287,a6719f38-a61f-60d8-8167-8e512c828b93,1,240180,240187,249287,249568,9100,9107,7,0,0,0
249287,1299a020-f157-8cad-c699-4e4839414a94,1,240180,240187,249287,251894,9100,9107,7,0,0,0
249277,6dee4228-631a-ae61-778a-ad6e1a7d5a41,1,240183,240187,249277,253234,9090,9094,4,0,0,0
249257,46fc31db-55ca-982a-ca88-276436affc77,1,240184,240187,249257,246380,9070,9073,3,0,0,0
249241,a2c39075-3101-9662-55ef-572391bbca03,1,240186,240187,249241,252482,9054,9055,1,0,0,0
249276,40dd4e0f-112c-8124-27d3-2d45ea24ea3a,1,240187,240187,249276,249511,9089,9089,0,0,0,0
249296,9cb0e36b-a1ba-3dcb-ccbe-fa231cfcbd1d,1,240180,240187,249296,249503,9109,9116,7,0,0,0
249344,ece91846-c2e1-4502-3036-0f505322ee8f,1,240180,240187,249344,250331,9157,9164,7,0,0,0
249298,d54bcec5-d918-7ff5-cd3a-9adb24cada76,1,240183,240187,249298,253833,9111,9115,4,0,0,0
249298,34cd5d6f-52bd-d07b-07b5-c69a4a13de29,1,240184,240187,249298,250281,9111,9114,3,0,0,0
249291,360848bc-c7c8-1db1-20b1-d8261c78e2d3,1,240186,240187,249291,249081,9104,9105,1,0,0,0
249351,c52391f2-c0e6-18f6-5a9b-a58634638bf0,1,240179,240187,249351,248944,9164,9172,8,0,0,0
249351,69ae6c75-11c7-7537-5639-755503109f0d,1,240179,240187,249351,249184,9164,9172,8,0,0,0
249357,77ba0b10-3c2b-836c-bfd6-277e63884e94,1,240179,240187,249357,245333,9170,9178,8,0,0,0
249359,8880ade1-844b-a88d-f2d0-8a26b27e7b9d,1,240179,240187,249359,251560,9172,9180,8,0,0,0
249373,f121434e-1010-a064-ce26-20ff328529a1,1,240185,240187,249373,248726,9186,9188,2,0,0,0
249391,8bb0cfe7-9f60-606f-35f1-d0a21a47d361,1,240185,240187,249391,244901,9204,9206,2,0,0,0
249371,cf7b3271-e118-8a69-4403-dae0bf3be31b,1,240188,240247,249371,249697,9124,9183,59,0,0,0
250884,e813bdc6-25bd-f494-5e6e-7e00dc124f44,4,248090,248090,250884,250181,2794,2794,0,0,0,0
251190,e4691176-2604-acea-f763-8f94d8612dad,1,242226,242234,251190,251189,8956,8964,8,0,0,0
251192,24510912-3bef-d844-5e0e-98121d79be77,1,242228,242234,251192,251134,8958,8964,6,0,0,0
251293,d15f2728-d477-d223-dcab-893c7a95df83,1,242226,242234,251293,254661,9059,9067,8,0,0,0
251367,a8ab9884-e908-bd44-053d-8ea23b22499a,1,242226,242234,251367,250793,9133,9141,8,0,0,0
251313,79b11c37-1055-a10d-01ff-49571afbbe0b,1,242229,242234,251313,247986,9079,9084,5,0,0,0
251359,840d0069-52bf-f0d3-c822-06b158d5a50b,1,242229,242234,251359,249566,9125,9130,5,0,0,0
251317,ed1771e4-d54e-c6a5-0899-c6912d61ea88,1,242230,242234,251317,252600,9083,9087,4,0,0,0
251372,a881644c-fa98-73b9-a701-d0960cb7321f,1,242224,242234,251372,249723,9138,9148,10,0,0,0
251423,620deb5e-628a-313c-46b4-b4603aa4960b,1,242224,242234,251423,248500,9189,9199,10,0,0,0
251395,eb8f6af2-d601-f36b-9784-f6e61d112177,1,242224,242234,251395,248514,9161,9171,10,0,0,0
251415,12bb954f-44c7-6929-e8f8-72c5e6e1396c,1,242224,242234,251415,255333,9181,9191,10,0,0,0
251409,b764b1f9-0df9-c154-5538-8c8fb84cb517,1,242226,242234,251409,250608,9175,9183,8,0,0,0
251406,823c69a2-4909-87c9-86d1-f4dbd3440ea3,1,242226,242234,251406,253731,9172,9180,8,0,0,0
251401,8928f9ea-5be3-0054-eef8-545733e25f16,1,242229,242234,251401,246874,9167,9172,5,0,0,0
251416,320beb5e-428f-0eb4-d67c-4527c0a7ac50,1,242229,242234,251416,249346,9182,9187,5,0,0,0
251383,384cbfbf-81d0-8054-b273-4f6e4b865144,1,242230,242234,251383,250796,9149,9153,4,0,0,0
251394,ba2133c5-08b8-615d-67fd-5f2d13831f01,1,242230,242234,251394,253903,9160,9164,4,0,0,0
251378,9f69d845-7df9-5cb3-378e-045a17bd1f60,1,242234,242234,251378,250179,9144,9144,0,0,0,0
251377,8994b175-c432-b87f-0050-203c020281d7,1,242234,242234,251377,249236,9143,9143,0,0,0,0
251454,150f3be4-24a3-e27a-0f53-3e9a0cd95fb9,1,242225,242234,251454,249820,9220,9229,9,0,0,0
251434,9f27bc06-f686-95aa-373e-2f8f34c93ebf,1,242228,242234,251434,250597,9200,9206,6,0,0,0
251435,0e1caea3-3c72-60b0-7b29-aa66e3b04af8,1,242229,242234,251435,254910,9201,9206,5,0,0,0
251459,37e27671-ea7f-17d1-9a01-76390e6ecd60,1,242233,242234,251459,253814,9225,9226,1,0,0,0
251466,cfd1c57d-9f35-dec1-9435-91cc06ea8ac9,1,242234,242234,251466,255445,9232,9232,0,0,0,0
251549,bb9fe5e8-43c2-a4ca-d944-a886808b902f,1,242233,242234,251549,254937,9315,9316,1,0,0,0
255180,1e3fdf12-3903-9fb3-cbda-c20c15f68117,1,253315,253337,255180,254936,1843,1865,22,0,0,0
255260,65df1bb3-19b5-94f7-a634-f02e4a6b6dcf,1,248764,248804,255260,253769,6456,6496,40,0,0,0
255301,4b88146b-2c7d-5b6b-c844-3b711ff294f8,1,248760,248804,255301,255965,6497,6541,44,0,0,0
255268,527420a1-6139-86e9-3ae8-cc86702a9bd3,1,248761,248804,255268,256258,6464,6507,43,0,0,0
255312,f8d9f45f-8bd0-ca6c-275d-e2c489bf9377,1,248764,248804,255312,253255,6508,6548,40,0,0,0
255313,abd16c63-7fcc-a09e-9149-2453135d0ddd,1,248765,248804,255313,258335,6509,6548,39,0,0,0
255297,33b90c47-4007-c07a-b220-96bcdc61cc72,1,248768,248804,255297,255044,6493,6529,36,0,0,0
255347,14ca6d82-6844-f776-4f7c-0c4e51362635,16,251734,251734,255347,253827,3613,3613,0,0,0,0
255361,0c652ac0-66ba-9945-8455-f4ef63651ce9,1,248760,248804,255361,255195,6557,6601,44,0,0,0
255354,f5f71def-2318-c5c6-e3c3-ecf705a4702b,1,248761,248804,255354,252728,6550,6593,43,0,0,0
255354,6a726a86-f984-166a-1f88-ee0bf36cf018,1,248761,248804,255354,256699,6550,6593,43,0,0,0
255368,6a9199ed-3196-6282-ccb6-588f61b1ad35,1,248764,248804,255368,252395,6564,6604,40,0,0,0
255367,bedc140f-bf1e-2b91-4c98-0eeca027a9a4,1,248764,248804,255367,253761,6563,6603,40,0,0,0
255337,b54211a4-e11f-4efd-48ab-d32e5eb4360a,1,248766,248804,255337,253229,6533,6571,38,0,0,0
255330,d9f861ea-6d2a-f6e3-5829-7e5612ddedc0,1,248766,248804,255330,253071,6526,6564,38,0,0,0
255346,e2655d96-24df-613b-10e8-a2cb185bc5f5,1,248767,248804,255346,257117,6542,6579,37,0,0,0
255341,ba26dbc3-2d3b-4adc-6386-d673412dff6c,1,248768,248804,255341,258291,6537,6573,36,0,0,0
255409,2f7f792b-79b7-e8d8-0a79-be49eb712852,1,248760,248804,255409,252512,6605,6649,44,0,0,0
255423,c2abd8e0-f219-ec35-a69e-22fd542092e1,1,248761,248804,255423,255778,6619,6662,43,0,0,0
255393,5639a196-9d76-52ce-41d5-f6269a8d39c5,1,248761,248804,255393,252045,6589,6632,43,0,0,0
255409,c35b83fb-a024-2eee-b792-338f85fba303,1,248761,248804,255409,254670,6605,6648,43,0,0,0
255416,bf9cd75c-0637-66dd-9729-0c024af53dfe,1,248763,248804,255416,253076,6612,6653,41,0,0,0
255423,8020982d-127e-e8b1-9a87-a83d8ab41c5b,1,248763,248804,255423,254383,6619,6660,41,0,0,0
255410,0022cc35-b695-1195-caad-191658a59bff,1,248768,248804,255410,252149,6606,6642,36,0,0,0
255404,4e7c39c2-fdb1-080f-37d4-25bbd2e54b9e,1,248769,248804,255404,256355,6600,6635,35,0,0,0
255447,8971ff47-1141-8142-7df7-82ebe88f823d,1,248761,248804,255447,256858,6643,6686,43,0,0,0
255447,c27b7491-cde0-81fa-f8d4-b975fcff9ed9,1,248765,248804,255447,257247,6643,6682,39,0,0,0
255550,aceab138-3e62-0898-b557-6846ee7616d1,1,253277,253277,255550,254813,2273,2273,0,0,0,0
257138,9cc37e56-c9f0-6339-553c-c03a3f64ec06,8,250638,250693,257138,259261,6445,6500,55,0,0,0
257800,6381bbd7-271f-fe38-a6fe-42117fe8b570,1,251403,251430,257800,258833,6370,6397,27,0,0,0
257837,ab4611be-0517-c4ef-a578-391987ab7bda,1,251399,251430,257837,256918,6407,6438,31,0,0,0
257837,1388d21e-6053-42f3-3ee5-3a20b7e4590d,1,251400,251430,257837,256297,6407,6437,30,0,0,0
257829,9df7a72f-fdfc-8b51-c82f-dccf15e18488,1,251402,251430,257829,256190,6399,6427,28,0,0,0
257909,228abcd7-7caa-a252-e0ad-01a0936b5322,1,251395,251430,257909,261006,6479,6514,35,0,0,0
257917,f068d554-7f24-c98e-dca9-1aee478a94a7,1,251395,251430,257917,254829,6487,6522,35,0,0,0
257893,1e001af7-0112-2d83-a232-df5c85c84ccb,1,251395,251430,257893,255162,6463,6498,35,0,0,0
257917,49b549cc-bfb1-e9da-92eb-ff8f95c51842,1,251395,251430,257917,257229,6487,6522,35,0,0,0
257871,c9cfcefb-26e6-d3f6-d067-cc1b65be2ecd,1,251400,251430,257871,259812,6441,6471,30,0,0,0
257872,e10b4445-5c35-2183-25be-0e503e6beee6,1,251401,251430,257872,260376,6442,6471,29,0,0,0
257877,659eff7e-39ba-880a-107e-d9af52e819a5,1,251402,251430,257877,255010,6447,6475,28,0,0,0
257918,836da569-d8e5-080a-1070-53c47ddfbc34,1,251404,251430,257918,257331,6488,6514,26,0,0,0
257885,25dd2524-0835-8e9c-3a29-eb47872bdc25,1,251404,251430,257885,260787,6455,6481,26,0,0,0
257947,765aa3f5-82aa-bada-7201-5af70e75e4ab,1,251396,251430,257947,256187,6517,6551,34,0,0,0
257949,f918455b-342c-342e-63f4-bc0f7ce43aec,1,251397,251430,257949,256596,6519,6552,33,0,0,0
257950,3c1719ad-475c-d160-25af-60043869d8e2,1,251397,251430,257950,257064,6520,6553,33,0,0,0
257934,e26224bb-2101-f87d-0a45-6ebbcc6cb94e,1,251399,251430,257934,258633,6504,6535,31,0,0,0
257942,3065b3a2-4afc-6fef-8a27-9be10e4683dd,1,251399,251430,257942,256473,6512,6543,31,0,0,0
257935,3ed6e353-0ea6-d1fe-c00d-1d9d1b165e42,1,251400,251430,257935,255990,6505,6535,30,0,0,0
258011,42db7313-0af7-b8a0-b755-4839e0150c0c,1,251395,251430,258011,256009,6581,6616,35,0,0,0
257993,291022d3-eca8-3ba9-56a0-faa54fbe6dca,1,251396,251430,257993,254762,6563,6597,34,0,0,0
258003,9cfa9b4a-27ec-d6b6-db4e-b35655ad1993,1,251396,251430,258003,257253,6573,6607,34,0,0,0
257986,929ba6f8-5dc9-8246-1d98-32e1217e52e6,1,251398,251430,257986,258716,6556,6588,32,0,0,0
257993,5ed03451-a13a-36db-8a12-ff3054bf2f54,1,251398,251430,257993,260311,6563,6595,32,0,0,0
258048,3cfca8cd-4000-2588-065f-06d7e5232adb,1,251395,251430,258048,261171,6618,6653,35,0,0,0
258095,991e0704-733b-e7cb-fda8-547410a7b21c,1,256255,256255,258095,258873,1840,1840,0,0,0,0
258259,6018a71b-b5ab-f66e-0e7e-481143eddd87,32,133286,133286,258259,307758,124973,124973,0,0,0,0
258515,f6feb332-1f6d-d463-f4fe-110d14572b45,8,213944,213982,258515,241156,44533,44571,38,0,0,0
260307,44a137cf-20d1-a8a8-a1ce-9fd43f293e0c,8,236540,236540,260307,269032,23767,23767,0,0,0,0
260948,1c21515b-fb11-4dc5-d6bb-889f0a278efa,1,253725,253777,260948,263221,7171,7223,52,0,0,0
261470,ebefeeb8-5780-9964-fbb7-ce92f2e31228,1,253726,253777,261470,259721,7693,7744,51,0,0,0
262798,2b573ecd-0304-7d1c-5612-872b7700ddb4,1,253721,253777,262798,261322,9021,9077,56,0,0,0
262825,b6838827-3509-855e-0ac3-5410eb3e0e8a,1,253717,253717,262825,264875,9108,9108,0,0,0,0
262847,43974997-fae2-dced-e569-3bb57ff7a5fc,1,253720,253777,262847,267141,9070,9127,57,0,0,0
262838,8d99a727-167f-0607-fcc4-0681eb1ba989,1,253720,253777,262838,259735,9061,9118,57,0,0,0
262829,d87fed47-97b3-121f-cb09-378a753d34dd,1,253723,253777,262829,265465,9052,9106,54,0,0,0
262912,15e9e019-9a9b-2c83-93a9-390615b19303,1,253717,253717,262912,259278,9195,9195,0,0,0,0
262905,0db71d95-0804-05dc-379a-72807d97fb59,1,253717,253717,262905,259409,9188,9188,0,0,0,0
262865,71297e0f-c77d-4134-1a51-23b01c0e3978,1,253717,253717,262865,261014,9148,9148,0,0,0,0
262901,b69cc4fe-0fa1-d48b-1853-0d8ff15a5c37,1,253718,253777,262901,261546,9124,9183,59,0,0,0
262907,7a8b7aca-b53f-7ddc-15fd-307891f81fad,1,253718,253777,262907,266111,9130,9189,59,0,0,0
262907,ce1fd9c4-7b02-fa03-aa51-426586c50e09,1,253718,253777,262907,265246,9130,9189,59,0,0,0
262916,534f7b30-ed84-65e1-f055-e55d8006bae5,1,253718,253777,262916,262314,9139,9198,59,0,0,0
262884,7e4e4d70-455b-e7a1-c79c-6ed500059930,1,253720,253777,262884,263656,9107,9164,57,0,0,0
262883,bddc50ba-594f-dbf8-dbb7-ae2d8746d7c6,1,253721,253777,262883,266277,9106,9162,56,0,0,0
262883,b81ae4a3-c4cb-5c68-2319-594f630ee896,1,253721,253777,262883,262368,9106,9162,56,0,0,0
262876,061664a3-5b24-da29-081b-c596891b3e6a,1,253722,253777,262876,258324,9099,9154,55,0,0,0
262878,d0f41b30-37f2-7fe6-34ef-bf2fcde68cba,1,253723,253777,262878,266359,9101,9155,54,0,0,0
262900,e47ad260-dd7b-0534-5f5a-04d9d5094d65,1,253725,253777,262900,267206,9123,9175,52,0,0,0
262957,360bb108-d18c-1169-06c9-9a0aae0136cc,1,253718,253777,262957,259732,9180,9239,59,0,0,0
262956,5b76a06d-e3dc-57a1-e5af-66b6c2916d42,1,253718,253777,262956,265728,9179,9238,59,0,0,0
262930,008f3fc8-e82f-d8b8-ce86-3135a418587a,1,253724,253777,262930,264021,9153,9206,53,0,0,0
262931,0847feab-673d-383a-a7fc-93ca98105b90,1,253725,253777,262931,266697,9154,9206,52,0,0,0
262975,c6406b52-cdef-eef2-09c3-9ca741b419ca,1,253725,253777,262975,262735,9198,9250,52,0,0,0
263678,cb58cbef-43b9-1c43-63f9-02bc90c432df,1,260816,260866,263678,263842,2812,2862,50,0,0,0
263740,65cbb014-763c-2109-683e-68ebb8235d5e,1,260815,260866,263740,264725,2874,2925,51,0,0,0
263741,cafac4f2-d3b8-242b-efd6-fcccd5bc5ae0,1,260815,260866,263741,263846,2875,2926,51,0,0,0
269427,8b760ba9-2342-0f4b-4b80-507d8ce7e0f2,8,268625,268625,269427,269506,802,802,0,0,0,0
269579,e002f214-d242-0b53-ae33-1288859c97d7,8,268760,268760,269579,269396,819,819,0,0,0,0
269918,2ff9632f-bb00-2c76-2078-1f1f388fa2ed,1,260807,260866,269918,265742,9052,9111,59,0,0,0
269957,90bc5076-5462-a3e4-849a-cf50655214af,1,260808,260866,269957,273833,9091,9149,58,0,0,0
270010,96de8576-09a7-c5f9-b8ee-05310e8eaab3,1,260810,260866,270010,268732,9144,9200,56,0,0,0
270010,3c66d01d-6bfd-1434-9143-3111af1136c2,1,260810,260866,270010,269814,9144,9200,56,0,0,0
269997,abeef75a-1682-8ce9-ba98-f8198b503a2b,1,260812,260866,269997,265629,9131,9185,54,0,0,0
269989,82db34f3-52c3-c305-b822-78411d222845,1,260814,260866,269989,271320,9123,9175,52,0,0,0
270043,1851408c-2512-4d94-ca1f-8f77719cec78,1,260806,260806,270043,267978,9237,9237,0,0,0,0
270050,c36901a4-6004-e429-bc27-faeb687ac02d,1,260806,260806,270050,266857,9244,9244,0,0,0,0
270066,688a74d4-a5dd-6a5c-c39d-06fea490e9d1,1,260807,260866,270066,272023,9200,9259,59,0,0,0
270019,fd2dd4e4-f17a-5c4e-44b3-725c567d8eb7,1,260807,260866,270019,265453,9153,9212,59,0,0,0
270054,0f962dde-4b1b-e774-9519-fd53586126fe,1,260808,260866,270054,267023,9188,9246,58,0,0,0
270072,ea9bd048-c7df-297c-9886-3fe176d5e948,1,260810,260866,270072,273060,9206,9262,56,0,0,0
270041,0590e87c-2ff8-7c17-ded0-1a38e7b62d67,1,260811,260866,270041,271840,9175,9230,55,0,0,0
270075,e090bbf2-f4d7-800a-62a7-5b42859ce128,1,260812,260866,270075,269138,9209,9263,54,0,0,0
270034,6dde5358-0b49-9144-02b7-50d6a743fe00,1,260812,260866,270034,265787,9168,9222,54,0,0,0
270046,788e7872-41d8-c57c-a923-d32680f7e737,1,260814,260866,270046,265729,9180,9232,52,0,0,0
270094,545eaa79-db9a-437a-6049-1fed86ab5a4c,1,260807,260866,270094,267868,9228,9287,59,0,0,0
270092,cc193642-3b89-aa26-7d10-098b63c3ee60,1,260810,260866,270092,271395,9226,9282,56,0,0,0
270084,51dcf909-d0d8-fc66-2ab5-b654e5b0bf55,1,260811,260866,270084,272467,9218,9273,55,0,0,0
270117,bbb089e8-11b6-23ce-bb53-1aee0a2fe221,1,260811,260866,270117,268267,9251,9306,55,0,0,0
270076,57178768-33fc-fd7d-f605-aa9c2de75a92,1,260813,260866,270076,270246,9210,9263,53,0,0,0
270093,d55fe520-572a-1c96-f393-94bee5e8f2d9,1,260814,260866,270093,266647,9227,9279,52,0,0,0
270424,07ef3d7c-67dc-5056-4ff8-4ab11559727f,8,269555,269555,270424,270222,869,869,0,0,0,0
270634,f418bd37-b952-b1bf-c0a0-f06c6f34f749,8,269604,269615,270634,270410,1019,1030,11,0,0,0
270845,8e4c15f3-5367-290f-6399-8656c38b4cf7,8,269835,269835,270845,270782,1010,1010,0,0,0,0
270911,4f8788ed-e5b4-f21f-ef84-102c133dbc86,8,269892,269895,270911,270944,1016,1019,3,0,0,0
270987,27c61236-efd0-03d0-19e3-8b6544d89a45,1,245183,245235,270987,275190,25752,25804,52,0,0,0
270987,1ce1f3af-6c22-167b-fa4e-df5a8471a52c,1,245184,245235,270987,264203,25752,25803,51,0,0,0
271009,d64dbbb0-3111-5e09-c8c6-cbbb65606cc7,1,245175,245175,271009,276011,25834,25834,0,0,0,0
271094,66c676f2-e5a2-e7d0-e895-01e534a1ce0c,1,245175,245175,271094,267741,25919,25919,0,0,0,0
271065,c859c0eb-cf6b-fd37-a9f6-05ed2aec7576,1,245175,245175,271065,266820,25890,25890,0,0,0,0
271163,32cdc1d0-0c99-a75b-d9d0-1c72529cbc09,1,245175,245175,271163,273287,25988,25988,0,0,0,0
271124,acf31b4d-9583-3542-095c-97fdfa51a4d5,1,245176,245235,271124,272547,25889,25948,59,0,0,0
271116,0ed588ac-66b3-2b0e-dfb5-d424d7b8470f,1,245176,245235,271116,275251,25881,25940,59,0,0,0
271145,4c1c946b-a3e2-29c0-9b22-e53364485715,1,245178,245235,271145,276215,25910,25967,57,0,0,0
271116,3fc31311-88f1-1964-80fc-844fb0395904,1,245180,245235,271116,280025,25881,25936,55,0,0,0
271164,da2329c8-d128-b80b-949d-94e29caeb54f,1,245184,245235,271164,276172,25929,25980,51,0,0,0
271199,c1f0ebf7-0b64-46f2-bf8c-0f0d9645adda,1,245179,245235,271199,264987,25964,26020,56,0,0,0
271275,5a33a6e7-57e9-5b83-2cfe-189a0dc29c55,1,245175,245175,271275,270218,26100,26100,0,0,0,0
271283,74cdae7e-73ba-7afd-a6d7-1157b8faa516,1,245175,245175,271283,275363,26108,26108,0,0,0,0
271310,aa1f3a39-2615-11a5-a267-a276e6d13d2c,1,245175,245175,271310,265782,26135,26135,0,0,0,0
271342,d84b2f9d-6d09-5461-f67a-1b391111770b,1,245175,245175,271342,261998,26167,26167,0,0,0,0
271330,1ab627e3-6487-af4d-91cb-9dae274a7225,1,245180,245235,271330,279490,26095,26150,55,0,0,0
271331,651a2c63-3162-2809-6412-b4ef456f99c2,1,245180,245235,271331,263310,26096,26151,55,0,0,0
271327,8e63fd56-dee7-0f9a-fc25-39d673f78379,1,245180,245235,271327,277688,26092,26147,55,0,0,0
271331,ee935510-5e8c-f6b6-b31f-01a1f4caf583,1,245181,245235,271331,281309,26096,26150,54,0,0,0
271328,46a1e473-df82-f12f-5383-9c0f2d839318,1,245184,245235,271328,282496,26093,26144,51,0,0,0
271368,1a676c83-e8d4-6a35-97e8-64ca2959b968,1,245182,245235,271368,262540,26133,26186,53,0,0,0
271375,471b2038-3b60-446e-c13a-179989a0685e,1,245182,245235,271375,275037,26140,26193,53,0,0,0
271400,4eb16892-75cf-e82c-a414-e9fb445c61f1,1,245183,245235,271400,282508,26165,26217,52,0,0,0
271369,30c059e0-8bd0-0908-8b73-d4521a956e55,1,245183,245235,271369,280608,26134,26186,52,0,0,0
272648,aa3af6b7-bd2a-9da3-ca5c-6f9ad873ef5a,8,140018,140020,272648,293505,132628,132630,2,0,0,0
274339,ae505915-8e6e-0f96-9de6-ec59fa237ec8,1,273620,273620,274339,273979,719,719,0,0,0,0
274393,d2a84d59-5d56-07ea-4f5e-22889a6857c1,1,273636,273680,274393,274314,713,757,44,0,0,0
274419,8651d059-d5f6-7432-1093-68fffc0ea433,1,273628,273680,274419,274126,739,791,52,0,0,0
274403,d3294a71-b697-492f-d840-fd58014cd941,1,273677,273680,274403,274667,723,726,3,0,0,0
274464,e2a4ae18-cd3c-b60f-64b1-8f8b3228381d,1,273695,273740,274464,274099,724,769,45,0,0,0
274489,ce3350d1-bd1e-7fc0-ca09-e857de2b8f8b,1,273706,273740,274489,274136,749,783,34,0,0,0
274482,7ffb14d0-d124-da10-dee2-235ec0786523,1,273731,273740,274482,274474,742,751,9,0,0,0
274477,6e40feeb-308f-bb84-dea0-574349839e4a,1,273733,273740,274477,274622,737,744,7,0,0,0
274801,9e4e7af1-6510-a25a-bc27-484a126f89c7,32,132985,132985,274801,209118,141816,141816,0,0,0,0
277386,123d329f-7f41-49af-45a1-21d8c81f2d3b,8,174554,174554,277386,260596,102832,102832,0,0,0,0
281486,d64fe4e2-38ac-1bcc-51f6-3ceae391bb7f,16,187789,187789,281486,272128,93697,93697,0,0,0,0
282412,74177003-8076-7cbf-bde2-c14d43057119,1,274972,274972,282412,283691,7440,7440,0,0,0,0
282427,2a22997b-713a-a5e1-c9d6-edbaf2131de4,1,274996,275032,282427,282497,7395,7431,36,0,0,0
282507,fddd99ad-f2d6-5ef9-2e75-20e457bb861d,1,275047,275092,282507,281037,7415,7460,45,0,0,0
282531,7d21b934-8f65-59e4-7d76-5345867d28bc,1,275047,275092,282531,284525,7439,7484,45,0,0,0
282595,23fb7ddb-de60-af01-3e97-699bb4083c27,1,275052,275092,282595,279798,7503,7543,40,0,0,0
282567,104a4141-5180-422f-9543-fad609cabe14,1,275065,275092,282567,283517,7475,7502,27,0,0,0
282588,6df00b4e-19ad-eec2-ac14-45af34bcfbd0,1,275100,275152,282588,279578,7436,7488,52,0,0,0
282624,7b7d91d4-f531-f226-9f2c-da971bbcd2e9,1,275066,275092,282624,283893,7532,7558,26,0,0,0
283679,4ae5e57d-6b1b-860f-00e7-38fd12a5eb04,8,266950,267001,283679,277724,16678,16729,51,0,0,0
283713,810755e0-7b49-0ffb-3d9a-712920657718,16,256549,256549,283713,280897,27164,27164,0,0,0,0
283713,830b230d-1223-b69d-e2a6-f98bd554e9aa,8,266941,266941,283713,287963,16772,16772,0,0,0,0
283867,8e60d31f-e84c-a0af-5c3d-122bb72cef88,8,236599,236600,283867,288511,47267,47268,1,0,0,0
284858,89d2e73e-c9d8-0901-7f73-fa3041d205a9,8,267003,267061,284858,279545,17797,17855,58,0,0,0
284905,3de78d0e-3d33-639e-e5d3-49efd21d66d9,8,267011,267061,284905,285287,17844,17894,50,0,0,0
285750,22e80727-2939-7928-a20b-d29915084a54,1,260683,260683,285750,280919,25067,25067,0,0,0,0
285867,9c012c23-63a5-4599-5cd1-f29335b1d7d4,1,260684,260743,285867,286977,25124,25183,59,0,0,0
285948,c2e02128-73dc-e0e0-6657-00be80c48989,1,260684,260743,285948,290603,25205,25264,59,0,0,0
285982,31c79faf-fb14-dc56-a010-e9b7e254b249,1,260687,260743,285982,284047,25239,25295,56,0,0,0
285983,381c4c97-5aa6-bcdb-bc7f-8a4b7c7ff8af,1,260689,260743,285983,273282,25240,25294,54,0,0,0
285974,4a4ef6c1-acd5-b138-4b92-71283186bbb9,1,260693,260743,285974,295468,25231,25281,50,0,0,0
286031,1ccadd5e-1ad3-31ce-20fb-f03af1440d84,8,256670,256670,286031,293300,29361,29361,0,0,0,0
286063,e40f9e2c-915a-a857-c48f-b0dbd3cc74d6,8,256690,256730,286063,277762,29333,29373,40,0,0,0
286058,8f57c122-f50a-82e8-03ec-608b5ae9d2b3,8,256701,256730,286058,274599,29328,29357,29,0,0,0
286013,ac33479f-bfbe-7683-9fc7-d097a718c8be,1,260683,260683,286013,293685,25330,25330,0,0,0,0
286018,db02a68c-cfe0-6ac9-cf70-b5e78d394846,1,260684,260743,286018,282818,25275,25334,59,0,0,0
286047,342edbc9-4cf7-c3c7-756c-0fcc1431528a,1,260684,260743,286047,297029,25304,25363,59,0,0,0
286010,44299108-ac07-2eea-8b57-22df2bfee718,1,260685,260743,286010,294839,25267,25325,58,0,0,0
286067,75ad231b-95de-12d5-d899-38bb1206994d,1,260687,260743,286067,296119,25324,25380,56,0,0,0
286065,b3d83b46-f510-3177-5e33-afef385e1055,1,260687,260743,286065,288384,25322,25378,56,0,0,0
286039,3be311ae-b69b-72a1-b5a6-de72c0e16f34,1,260687,260743,286039,296177,25296,25352,56,0,0,0
286066,4c0476a9-64e6-d715-3999-76785013c8aa,1,260687,260743,286066,296572,25323,25379,56,0,0,0
286076,58e0320d-7a10-9307-47b5-8bb58a9faf2f,1,260683,260683,286076,293555,25393,25393,0,0,0,0
286090,4b80a6b7-1130-e6dc-a248-b16068711af7,1,260684,260743,286090,279212,25347,25406,59,0,0,0
286073,8b869e30-c202-1b52-6f3f-3f763fed3d79,1,260686,260743,286073,288956,25330,25387,57,0,0,0
286119,40f3de91-eb14-2767-568b-e1db4fbe5bf9,1,260687,260743,286119,290375,25376,25432,56,0,0,0
286078,e1112ae6-c261-72af-27db-dc47e99be1d8,1,260692,260743,286078,281806,25335,25386,51,0,0,0
286078,55e12049-309e-0fc4-193d-15df6f4228d8,1,260692,260743,286078,277028,25335,25386,51,0,0,0
286177,77d5415f-be59-d254-61da-969f5f4dc37c,8,256682,256730,286177,277436,29447,29495,48,0,0,0
286179,34641786-f88f-27d7-1ec0-9b51d8241de8,1,260688,260743,286179,282028,25436,25491,55,0,0,0
286170,4928654c-e884-42c0-6c3d-7a287f12bba4,1,260691,260743,286170,288758,25427,25479,52,0,0,0
286201,67a4fdb6-60dc-3d2b-994f-e7dc4733f442,1,260690,260743,286201,276346,25458,25511,53,0,0,0
286263,4f8ac775-2364-f175-e0ff-7f11fd962c30,1,260685,260743,286263,277405,25520,25578,58,0,0,0
286329,2d81791b-e32a-60ac-0f10-9a9fc6ab385e,8,257052,257103,286329,277542,29226,29277,51,0,0,0
286310,1993644b-0f4d-626e-0d35-8bc380863f67,8,257072,257103,286310,275461,29207,29238,31,0,0,0
286325,97b87e38-4bf5-843d-1cb4-c9940984258c,1,260691,260743,286325,279512,25582,25634,52,0,0,0
286376,cc8c1dae-f3e3-3093-45be-06f83fbf7901,8,257061,257103,286376,293752,29273,29315,42,0,0,0
286369,843efe2f-3441-8d4c-0445-50e71e42ee2d,8,257084,257103,286369,279871,29266,29285,19,0,0,0
286796,80592bd0-df94-5be7-17af-0e28c9b77e59,8,11383,11383,286796,232198,275413,275413,0,0,0,0
290500,ac15f7e3-00f4-91a5-0334-9f8166f7ac98,8,266975,267001,290500,287856,23499,23525,26,0,0,0
290505,2a193ff9-a201-73ac-d4d3-32e6fdd29e6c,8,266965,267001,290505,294466,23504,23540,36,0,0,0
291413,98271523-86f5-cdaa-b406-f1c15b25d1f1,1,289338,289394,291413,292123,2019,2075,56,0,0,0
291413,b6a6b431-83f9-4f58-b0fd-ede4e397423a,1,289339,289394,291413,291648,2019,2074,55,0,0,0
291421,7a484132-ae9b-f313-0355-faea44d7acfa,1,289338,289394,291421,291291,2027,2083,56,0,0,0
291467,af656bef-326d-bb01-bd7f-d94a8cd8277b,1,289339,289394,291467,290977,2073,2128,55,0,0,0
291458,5a4594cf-6648-f283-f6de-1f5cd985084a,1,289341,289394,291458,291712,2064,2117,53,0,0,0
291435,cb882c8a-fb00-6331-a647-89f01f4b83af,1,289341,289394,291435,291100,2041,2094,53,0,0,0
291459,62824085-cb1f-4c06-d7b0-f9ccacef1584,1,289342,289394,291459,290918,2065,2117,52,0,0,0
291426,39a20ed1-5452-185c-ecfc-912a490a4abd,1,289343,289394,291426,290620,2032,2083,51,0,0,0
291474,bef0284b-ad0a-1ec6-dc9d-7f4be16ab497,1,289339,289394,291474,292329,2080,2135,55,0,0,0
291488,bc053832-1f7e-2e1e-a58d-85c5dd74f4e8,1,289344,289394,291488,291906,2094,2144,50,0,0,0
292645,98d470d7-df0d-c871-1e86-1ea4de641c67,1,286268,286308,292645,291192,6337,6377,40,0,0,0
292710,fdcadf20-5cd1-5fc8-c411-01383a1e1132,1,286275,286308,292710,290497,6402,6435,33,0,0,0
292744,d5329488-5dd4-797b-f480-6394fb276440,1,286266,286308,292744,295242,6436,6478,42,0,0,0
292744,0033d65c-1b0f-5962-843b-76b86798644d,1,286267,286308,292744,295736,6436,6477,41,0,0,0
292745,59d5f7a1-b3f3-a850-cba8-7493b5c47919,1,286270,286308,292745,292139,6437,6475,38,0,0,0
292746,11a0e905-ca87-35b5-1754-26a54a7c60bb,1,286270,286308,292746,292886,6438,6476,38,0,0,0
292735,21309ac5-88fa-b23b-e74d-bf943bfb89a6,1,286270,286308,292735,290845,6427,6465,38,0,0,0
292716,698a7ada-cb92-5e92-d9f7-07884d61d4c5,1,286274,286308,292716,290391,6408,6442,34,0,0,0
292764,561be345-fad9-11e5-10ac-12e9a84966af,1,286275,286308,292764,290401,6456,6489,33,0,0,0
292771,73c5a96c-4d9f-08b1-6974-57d2cdc25249,1,286275,286308,292771,291319,6463,6496,33,0,0,0
292795,eb8fd2e5-556a-e7e8-f55c-2fcca88cba61,1,286267,286308,292795,292669,6487,6528,41,0,0,0
292796,60e4ba2c-741f-4027-5798-1bc25f3df920,1,286268,286308,292796,295252,6488,6528,40,0,0,0
292822,ec3c8084-c240-ab62-ced2-57f8bed47280,1,286272,286308,292822,294583,6514,6550,36,0,0,0
292823,9f98673a-d618-395d-46c7-96de3da271ff,1,286273,286308,292823,293958,6515,6550,35,0,0,0
292834,d743a4cd-ae3e-0c98-8e35-490d73e99f68,1,286266,286308,292834,292537,6526,6568,42,0,0,0
292891,5cfbb010-7efb-9b2b-789f-8ea5edcd7411,1,286266,286308,292891,292273,6583,6625,42,0,0,0
292892,3d3ca786-726f-55ac-ff93-602f4852fbcc,1,286266,286308,292892,295722,6584,6626,42,0,0,0
292893,e11f15ad-bb82-8061-9e85-18387dd98863,1,286266,286308,292893,291732,6585,6627,42,0,0,0
292877,4acc99ea-c47a-09ff-0edc-6da4bac7cd06,1,286270,286308,292877,289819,6569,6607,38,0,0,0
292867,57418749-a9a9-fb2c-d0e4-fd8a48d4445d,1,286271,286308,292867,292769,6559,6596,37,0,0,0
292834,08b77c51-458d-971c-1c69-6395fe8e3b73,1,286271,286308,292834,294908,6526,6563,37,0,0,0
292867,c352a5c1-80ae-7fa4-e7d2-b43336a3005c,1,286272,286308,292867,293501,6559,6595,36,0,0,0
292945,859d86e7-cb69-3626-8169-84968a13b656,1,286266,286308,292945,292241,6637,6679,42,0,0,0
292909,db8d57d9-45c6-76c3-0ffb-db8f723f155c,1,286271,286308,292909,291183,6601,6638,37,0,0,0
292908,34d03ebf-0db5-f4af-d7a5-dcf2f3c148e2,1,286274,286308,292908,295229,6600,6634,34,0,0,0
293012,2ede3ede-7ce3-da45-24fd-f258ce3413ea,32,133616,133616,293012,328955,159396,159396,0,0,0,0
294753,ae326c53-ad9e-9a10-a9c1-5adc6232287c,1,285737,285740,294753,295886,9013,9016,3,0,0,0
294805,c9c620ea-4336-c1a9-8abe-e26bd13076b8,16,5810,5810,294805,314395,288995,288995,0,0,0,0
294781,bf8048b4-2381-7db9-75c3-2e981bdfdf34,1,285733,285740,294781,295833,9041,9048,7,0,0,0
294781,5ab3f581-f026-45a4-a83e-64c0c9b0088a,1,285734,285740,294781,297801,9041,9047,6,0,0,0
294873,8400bf6e-32c2-368c-973d-c559122beb5e,1,285734,285740,294873,299407,9133,9139,6,0,0,0
294864,c48eca3f-6d0e-aa2c-82fb-fdc717dedfbe,1,285734,285740,294864,295858,9124,9130,6,0,0,0
294824,6b31f6c1-d1b2-58ff-077c-dedb65f8cdbd,1,285734,285740,294824,296717,9084,9090,6,0,0,0
294816,864a512d-d9ce-129c-1b57-856c005b8b64,1,285735,285740,294816,292376,9076,9081,5,0,0,0
294815,d20bed9d-266d-bf5f-5839-27bb1c5a99b0,1,285736,285740,294815,293166,9075,9079,4,0,0,0
294855,eaa72752-e5de-4f81-d83d-31a0cb2cf472,1,285737,285740,294855,294262,9115,9118,3,0,0,0
294817,008bb736-db32-ff5c-16c8-8a748a2e9624,1,285737,285740,294817,297427,9077,9080,3,0,0,0
294853,f11b81b5-1d81-e198-6584-c9e3a9c29b8c,1,285737,285740,294853,294239,9113,9116,3,0,0,0
294855,de537673-5e3f-3ec7-cabf-ae4af61a8c46,1,285738,285740,294855,294270,9115,9117,2,0,0,0
294927,36502aef-ea93-17e9-2764-dec0448d4e76,1,285733,285740,294927,294669,9187,9194,7,0,0,0
294881,f294ab2e-9b67-bd94-215d-36f9e62077b7,1,285734,285740,294881,295786,9141,9147,6,0,0,0
294896,6571bc7f-1265-9624-f364-ae2c3f1f84a2,1,285737,285740,294896,295660,9156,9159,3,0,0,0
294927,641fd4a5-8ddf-03d0-0f61-44332c32ed18,1,285738,285740,294927,297936,9187,9189,2,0,0,0
294929,472b60f6-957d-b9fe-b8b2-8b73e9549d88,1,285738,285740,294929,291700,9189,9191,2,0,0,0
294898,8b25c717-ebb8-48a7-3495-ad7d19853d8f,1,285742,285800,294898,295261,9098,9156,58,0,0,0
294930,a828211d-7a94-10b6-1efb-6bc522d67eca,1,285744,285800,294930,291786,9130,9186,56,0,0,0
294983,89b80812-c69c-270f-86f8-6d78ef87bdbe,1,285741,285800,294983,294852,9183,9242,59,0,0,0
294989,bb0bf375-834c-d0eb-0695-a0ba33d5ceaf,1,285741,285800,294989,295512,9189,9248,59,0,0,0
294991,75fb4469-068c-3a14-42a3-03658e9705d1,1,285741,285800,294991,293635,9191,9250,59,0,0,0
294938,00bf7f2f-261e-217f-28e0-fd9e4f7d3715,1,285742,285800,294938,296523,9138,9196,58,0,0,0
295103,14b379f4-69c4-b61f-d6cc-298d576f3527,1,285735,285740,295103,297673,9363,9368,5,0,0,0
295131,9a6bd971-088b-efee-1fb4-2240948bf086,1,285743,285800,295131,294177,9331,9388,57,0,0,0
295765,31e8c914-3797-1892-e30b-7fcc2e941a91,1,289335,289394,295765,293013,6371,6430,59,0,0,0
295781,76c42543-e7fd-8630-4daf-3bea22a6df25,32,294969,294993,295781,296008,788,812,24,0,0,0
295787,e6b04b55-4e65-50d3-a864-bfae15838511,32,294973,294993,295787,295891,794,814,20,0,0,0
295788,a2f1a234-1ee1-4086-59dd-6bf401479762,1,289334,289334,295788,294340,6454,6454,0,0,0,0
295809,785b399a-57d6-e9fe-056f-c94b40359cc0,1,289335,289394,295809,293110,6415,6474,59,0,0,0
295847,68a8983c-fa18-c14a-c00c-c5bd3edaf6e2,1,289335,289394,295847,297802,6453,6512,59,0,0,0
295959,9d484003-af70-5e12-2429-42a16d67831d,1,289336,289394,295959,295496,6565,6623,58,0,0,0
295975,af3b32b9-5bf3-6412-1e85-6dede7b96323,1,289335,289394,295975,293492,6581,6640,59,0,0,0
295968,0e5650c3-492f-3756-6037-c111ccc2afef,1,289335,289394,295968,292848,6574,6633,59,0,0,0
296003,b46197f9-fc7a-f126-2f9e-5b5a850fc700,1,289335,289394,296003,295941,6609,6668,59,0,0,0
295993,78ec798b-b883-2e4e-0c1d-7fd52216a46c,1,289337,289394,295993,296408,6599,6656,57,0,0,0
295963,e0dd6aee-f119-dcd9-bb59-97d64fec20b0,1,289338,289394,295963,295352,6569,6625,56,0,0,0
295961,2b6c04c6-9f55-8bb0-dfb2-ecdeb337daf6,1,289338,289394,295961,296813,6567,6623,56,0,0,0
295962,ee994e2f-381d-268d-d5d1-3fdb1d501b3a,1,289338,289394,295962,295357,6568,6624,56,0,0,0
296071,7e8b3cc2-4750-62fb-ac22-97f3b4307cf0,1,289335,289394,296071,297840,6677,6736,59,0,0,0
296046,cfd3fefd-bc13-c586-70b1-f02bd6262706,1,289335,289394,296046,299007,6652,6711,59,0,0,0
296028,f5dcb21a-fa80-8941-49ed-d76f1c946125,1,289337,289394,296028,298063,6634,6691,57,0,0,0
296865,06470faf-850d-8003-b520-d86a9ae14459,32,296099,296139,296865,296658,726,766,40,0,0,0
297639,780eabae-0329-5e1c-de8d-9f3d2e0fab6e,32,95264,95264,297639,218271,202375,202375,0,0,0,0
298333,801fe222-14aa-9d7a-a70a-e33236dd3553,8,267022,267061,298333,294184,31272,31311,39,0,0,0
298361,56f8409c-5264-605a-f078-7539a378dacb,8,267029,267061,298361,288250,31300,31332,32,0,0,0
299346,be631d51-a07b-5693-739f-f4379ec5d0cc,16,5813,5870,299346,308959,293476,293533,57,0,0,0
299665,6957dc86-204a-c09d-2008-2013bfd8ae38,8,298361,298393,299665,299416,1272,1304,32,0,0,0
310828,da82c4cf-9b04-dd27-7813-c217e1e32a6d,1,285620,285620,310828,315634,25208,25208,0,0,0,0
310880,915fcf53-d83a-7dd5-035d-34696889bfad,1,285621,285680,310880,304888,25200,25259,59,0,0,0
310921,35bd0f08-9aa7-d84c-61e8-39c567f77e75,1,285621,285680,310921,322561,25241,25300,59,0,0,0
310919,3dee7e09-79ce-b425-06ce-34b16e5038dd,1,285621,285680,310919,298884,25239,25298,59,0,0,0
310974,1376ca78-1698-a88d-4c4c-d8ab3320ee94,1,285623,285680,310974,316345,25294,25351,57,0,0,0
311007,c27d5571-3c52-89ca-7314-834eba451fa6,1,285624,285680,311007,318629,25327,25383,56,0,0,0
310966,1c17ee0d-b295-11ac-d63e-7a0b03759f96,1,285624,285680,310966,304892,25286,25342,56,0,0,0
310967,62d85378-8c84-8b87-d052-47cc808d21ad,1,285625,285680,310967,298927,25287,25342,55,0,0,0
310999,ee0ec269-744d-101f-5bed-1b489ecbda14,1,285627,285680,310999,317602,25319,25372,53,0,0,0
311059,82b2a85a-c319-cd6f-c961-75192051c45f,1,285624,285680,311059,319723,25379,25435,56,0,0,0
311032,a63b6c9f-cd97-0b02-9354-0737ef3ee855,1,285629,285680,311032,303537,25352,25403,51,0,0,0
311026,32a99f44-6bbd-3b4e-8f37-01390c6e2d47,1,285630,285680,311026,309650,25346,25396,50,0,0,0
311093,8d31a34a-c47a-cb1c-5b06-492387de82bf,1,285621,285680,311093,319478,25413,25472,59,0,0,0
311111,b049ec0b-6ac5-4227-454a-19dbb91ece46,1,285622,285680,311111,302664,25431,25489,58,0,0,0
311125,48e724e4-c7bb-0252-9444-b5f81df52cb0,1,285622,285680,311125,300641,25445,25503,58,0,0,0
311118,1d875212-b6d5-f842-cea5-8c3e98433c3a,1,285622,285680,311118,307589,25438,25496,58,0,0,0
311083,4e4211e1-638c-ee09-2794-c9a49b1eeafc,1,285629,285680,311083,301477,25403,25454,51,0,0,0
311076,d6c04ae2-d464-2685-2987-0e589af58a79,1,285629,285680,311076,320191,25396,25447,51,0,0,0
311170,1749f8f7-d8e5-ac5d-e33d-78768f5dd125,1,285626,285680,311170,302580,25490,25544,54,0,0,0
311172,dc66a4dd-78b2-ae15-594b-cf668995e6ad,1,285626,285680,311172,303363,25492,25546,54,0,0,0
311133,c276a38d-442b-7a2c-2b74-9593a4b6614f,1,285627,285680,311133,314134,25453,25506,53,0,0,0
311207,50f15b8c-b6be-c014-3e1b-b73f0bd515d8,1,285622,285680,311207,317797,25527,25585,58,0,0,0
311215,ddf7cf3e-b127-41a6-5e9d-943355b3b8a7,1,285625,285680,311215,321031,25535,25590,55,0,0,0
311217,1e74d80a-26d9-3400-a433-ce4e3fdf77a2,1,285626,285680,311217,321566,25537,25591,54,0,0,0
311259,ce4a7635-2c6c-0b91-c6df-af7dc87208ef,8,266985,267001,311259,292938,44258,44274,16,0,0,0
311444,13164632-222a-8b0b-5659-1909309c5b52,1,286222,286248,311444,314437,25196,25222,26,0,0,0
311482,033a3740-696e-6a62-ca00-6fa953c3f674,1,286222,286248,311482,320703,25234,25260,26,0,0,0
311445,22a2a2f8-c048-96a0-bb49-0e519e46ddef,1,286222,286248,311445,298941,25197,25223,26,0,0,0
311455,eebea50d-5a6c-b33e-af5f-8913d13a962d,1,286224,286248,311455,301881,25207,25231,24,0,0,0
311446,ccdf321b-237c-3e70-6ea2-57c20471f6f8,1,286226,286248,311446,303371,25198,25220,22,0,0,0
311446,3237929d-db7d-f97a-f0a6-2a3ea2fd5c8f,1,286226,286248,311446,307892,25198,25220,22,0,0,0
311447,a0b9ec2c-e3cf-14c1-b958-d682b3de1447,1,286227,286248,311447,300337,25199,25220,21,0,0,0
311556,d699f908-d95a-017c-cb1e-7a8c2269d377,1,286218,286248,311556,312230,25308,25338,30,0,0,0
311539,d10c690a-8e14-b9f6-76aa-50e0427c954a,1,286219,286248,311539,303642,25291,25320,29,0,0,0
311508,69ff7726-2494-5f1c-8fc0-f04fbfe68aa9,1,286219,286248,311508,311684,25260,25289,29,0,0,0
311548,b5798280-e9c7-d673-e3c0-8f2df33a86db,1,286227,286248,311548,305964,25300,25321,21,0,0,0
311605,e0a05e9d-0ad8-8ed3-d9fa-aebed1756ee9,1,286219,286248,311605,316724,25357,25386,29,0,0,0
311583,b174d31c-b771-2366-64a7-76e30a91d7bd,1,286225,286248,311583,317293,25335,25358,23,0,0,0
311663,5bb90317-d242-43ab-f007-eee0c7bd7b63,1,286219,286248,311663,310041,25415,25444,29,0,0,0
311648,a604b598-1b77-b315-dd9b-04624569a49c,1,286219,286248,311648,317081,25400,25429,29,0,0,0
311664,1864630e-20de-77c5-6568-ef8d22e234bf,1,286221,286248,311664,310922,25416,25443,27,0,0,0
311671,65ebbf76-7a8d-25b4-7ec8-05c282538874,1,286224,286248,311671,314863,25423,25447,24,0,0,0
311628,1988b7ec-4a09-6bef-c81e-fa1ff412b349,1,286224,286248,311628,299485,25380,25404,24,0,0,0
311729,72dc4a8f-d0f7-a209-36cd-15312f91dda0,1,286218,286248,311729,308934,25481,25511,30,0,0,0
311712,a6c36f02-02ed-7cba-3159-b571c048ef2d,1,286219,286248,311712,311610,25464,25493,29,0,0,0
311720,44f3a555-a696-fd80-3087-cdfef568efe5,1,286219,286248,311720,302827,25472,25501,29,0,0,0
311695,649e0a91-64f2-aeec-ff17-444143a2a3ef,1,286222,286248,311695,321007,25447,25473,26,0,0,0
311696,9d366639-1c6c-7f27-9b0c-020dc7a96087,1,286223,286248,311696,303123,25448,25473,25,0,0,0
311764,3ee517c5-4e20-d6d8-a4bd-7d3a8d63d40e,8,266994,267001,311764,301033,44763,44770,7,0,0,0
311777,71a7fdb6-fd90-1bcb-8927-2f04668d7b72,1,286219,286248,311777,312594,25529,25558,29,0,0,0
311750,f4f839d9-8581-916a-34bc-ee91513d25a1,1,286223,286248,311750,303173,25502,25527,25,0,0,0
312491,375e38b7-1136-29da-5ac4-01de0e070e00,1,285630,285680,312491,310897,26811,26861,50,0,0,0
313035,0b3564af-a12f-0dfd-32b7-3301162ea77e,8,312290,312290,313035,312799,745,745,0,0,0,0
313076,d6c69578-e2e5-8a89-488c-7a64361bc766,8,312308,312350,313076,312855,726,768,42,0,0,0
313178,ee7e7fec-e99f-a644-c239-064b0c1a13b8,1,300209,300209,313178,319218,12969,12969,0,0,0,0
313220,145659ea-c7a0-5fe1-89e3-9c2ab8227f4c,1,300210,300269,313220,316454,12951,13010,59,0,0,0
313221,91108236-fb8c-d12a-1076-0bac005e5cf3,1,300210,300269,313221,307245,12952,13011,59,0,0,0
313202,cec88e0d-2056-30f7-8465-d576eeeb75c7,1,300212,300269,313202,315272,12933,12990,57,0,0,0
313233,995faf9e-7cf2-030a-c318-7da0784d1304,1,300212,300269,313233,316013,12964,13021,57,0,0,0
313194,eb5a83dd-4771-a24f-3cf1-e41b261847b1,1,300212,300269,313194,311423,12925,12982,57,0,0,0
313251,b972ff40-a35d-e603-72c0-d42d2f29ca3e,1,300210,300269,313251,309646,12982,13041,59,0,0,0
313258,548a3294-5d8f-fb1f-89d0-f9727eda1275,1,300212,300269,313258,307306,12989,13046,57,0,0,0
313452,de7dc507-576a-be72-4ad6-5349c0f17c16,1,300209,300209,313452,309667,13243,13243,0,0,0,0
313484,c6bf9d33-ec75-6a2a-61b5-f657d4453727,1,300209,300209,313484,313330,13275,13275,0,0,0,0
313511,e6612633-ee66-932d-c7a3-d6b2713e125f,1,300209,300209,313511,311455,13302,13302,0,0,0,0
313460,99f68c9a-50e2-b159-cc84-35ef7f9817c0,1,300209,300209,313460,318813,13251,13251,0,0,0,0
313503,a813ef5b-96a2-dcfb-280b-8f91f1431171,1,300210,300269,313503,313123,13234,13293,59,0,0,0
313494,d33609be-bf8e-d97d-d740-3862d2636829,1,300213,300269,313494,313681,13225,13281,56,0,0,0
313463,7e346174-ea3b-3fd6-582f-e1b6f533cc86,1,300214,300269,313463,316421,13194,13249,55,0,0,0
313455,c9fe2250-2a80-64b3-67bf-324a7437a0b0,1,300216,300269,313455,309626,13186,13239,53,0,0,0
313505,5c7acc79-72ed-cbf9-9ae4-fa2e3f2e653c,1,300216,300269,313505,317044,13236,13289,53,0,0,0
313483,0f15c338-2d03-9f33-3d00-f3ccabef8dca,1,300216,300269,313483,314366,13214,13267,53,0,0,0
313506,f1a158d1-1c61-9ade-1a88-73ec8402dccf,1,300217,300269,313506,308021,13237,13289,52,0,0,0
313506,d7280fd9-6087-826f-2364-2ba287401bc0,1,300219,300269,313506,317819,13237,13287,50,0,0,0
313563,fec64185-93fd-b225-7105-f0920d2d39cb,1,300210,300269,313563,309365,13294,13353,59,0,0,0
313533,085c4bf0-3137-01b4-06de-0c92b302a11e,1,300213,300269,313533,316455,13264,13320,56,0,0,0
313523,f558d6ea-dd7e-8333-6a53-990d80e1caa2,1,300214,300269,313523,319276,13254,13309,55,0,0,0
313514,fbba3dac-2246-d044-d5c6-88ba9f6d6c8c,1,300215,300269,313514,308101,13245,13299,54,0,0,0
313597,65c9756a-689b-f92d-baab-ed4fb2123a66,1,300215,300269,313597,318833,13328,13382,54,0,0,0
315739,29fd9415-8028-df6c-f9fd-0365a52e4cba,16,5883,5930,315739,268630,309809,309856,47,0,0,0
316775,841b74fb-66af-6ed6-9c61-1ab2d8450d5b,32,95419,95426,316775,369739,221349,221356,7,0,0,0
318413,492ce47f-0925-1906-bc3c-7b65ba6ecbfe,16,5880,5930,318413,406976,312483,312533,50,0,0,0
319133,a59b2d55-5baf-d14f-27b6-f26123489c10,8,86159,86159,319133,384701,232974,232974,0,0,0,0
321909,14413349-bd0c-f773-54d6-bcdb9a3962d3,1,300234,300269,321909,320654,21640,21675,35,0,0,0
321909,f8b65c79-7376-9d97-cc47-468adb8c9c44,1,300234,300269,321909,326375,21640,21675,35,0,0,0
321955,1d6e7ab6-5867-a007-fe7d-dbdbf3296aff,1,300233,300269,321955,329107,21686,21722,36,0,0,0
321949,f27c75ed-d491-4931-a2ad-03d60d0a5493,1,300234,300269,321949,319117,21680,21715,35,0,0,0
324005,c0036851-a0b6-8808-5305-482b1d240480,1,300225,300269,324005,320430,23736,23780,44,0,0,0
324005,154cfa54-4522-73e7-af88-42ecac18a9c5,1,300225,300269,324005,324455,23736,23780,44,0,0,0
324022,b3ab18d9-976e-206c-616a-bf8c3027015e,1,300229,300269,324022,315025,23753,23793,40,0,0,0
324047,381dfd22-c864-d140-1beb-d0728d5dfd2e,1,300229,300269,324047,315575,23778,23818,40,0,0,0
324105,57f65bd2-e728-4f5a-50eb-a3be200e183d,1,300226,300269,324105,313879,23836,23879,43,0,0,0
324098,3a5c7106-bc96-646a-7a2b-83aa0e9a8ee6,1,300227,300269,324098,331326,23829,23871,42,0,0,0
324246,4bfcfba0-a405-66ac-04cd-a3eaa5b3c115,1,300229,300269,324246,324807,23977,24017,40,0,0,0
324923,7ce456bb-0c9c-f9e4-58b5-dfedf2b47627,8,314591,314591,324923,322024,10332,10332,0,0,0,0
325001,f43f5088-6084-6cb6-59a6-54e12865eeb5,8,314600,314651,325001,326369,10350,10401,51,0,0,0
326141,a2d295db-b27b-d350-b06a-ab8f21f5b1e8,1,300226,300269,326141,321919,25872,25915,43,0,0,0
326197,2042c893-b59d-bb55-7451-8a2f147bf656,1,300225,300269,326197,330219,25928,25972,44,0,0,0
326197,029f745d-4d35-1375-1abf-d7aa50f10435,1,300225,300269,326197,318812,25928,25972,44,0,0,0
326167,db11aedd-f676-5648-a638-40d4dc3cd76d,1,300225,300269,326167,327957,25898,25942,44,0,0,0
326237,ff40abae-3c22-65fb-375e-aba38f43a702,1,300225,300269,326237,333473,25968,26012,44,0,0,0
326267,5da17dc9-ab48-9f7a-6474-5dce9e80e9b9,1,300225,300269,326267,331102,25998,26042,44,0,0,0
326321,fe1c4a28-c862-b70c-7904-ffb1443ff733,1,300229,300269,326321,317305,26052,26092,40,0,0,0
326352,a3ced9d2-ab8c-309d-474f-606b9161d089,1,300229,300269,326352,321034,26083,26123,40,0,0,0
326353,513d0f10-3e55-21ec-c3cd-61ab5fb6f397,1,300230,300269,326353,322697,26084,26123,39,0,0,0
326352,d4f64f83-9493-b46e-4ba4-0f5ceb15f36a,1,300230,300269,326352,314448,26083,26122,39,0,0,0
326344,1ed02b04-b10e-7dd6-bf05-413e9f531cc0,1,300233,300269,326344,322749,26075,26111,36,0,0,0
326383,ac8a6219-3f1c-47f2-4c11-d23b95a10399,1,300229,300269,326383,323886,26114,26154,40,0,0,0
326428,82d8426f-3302-278c-55e3-5bb6a8fdc8ef,1,300231,300269,326428,324573,26159,26197,38,0,0,0
326446,8f3aed55-ab1e-1817-9dee-9ee8a70b1d42,1,300229,300269,326446,316802,26177,26217,40,0,0,0
327543,1ee0946c-c2a0-0944-f8cb-509bea8ac7e2,8,250665,250693,327543,354312,76850,76878,28,0,0,0
327630,5b3cf9fe-73de-1685-3a97-d80450fca476,8,250645,250693,327630,309439,76937,76985,48,0,0,0
328033,883f9e16-4daa-f438-8017-c2db9f56118e,8,314615,314651,328033,327527,13382,13418,36,0,0,0
328276,7a995fba-7feb-2b41-8fda-8d85520a9f1a,8,250656,250693,328276,334359,77583,77620,37,0,0,0
329404,62684b43-408c-d80d-d175-b167175ec2b5,8,250633,250633,329404,336352,78771,78771,0,0,0,0
329469,6f7c4fd6-7bb0-ede3-aa3e-3c23a95186d0,1,328538,328550,329469,329459,919,931,12,0,0,0
330969,df1aa76a-84d3-2448-ecf7-4e8a2c0176d5,8,327634,327663,330969,331684,3306,3335,29,0,0,0
331323,e0b54744-4087-6d00-8285-6310692418b6,1,324879,324934,331323,331774,6389,6444,55,0,0,0
331323,c6bbb861-4840-ee5d-f8ef-7418739fe470,1,324880,324934,331323,334149,6389,6443,54,0,0,0
331344,edd8ece8-1af3-c49c-1f07-bf99870372fe,1,324874,324874,331344,329399,6470,6470,0,0,0,0
331361,8cc3e4c9-1f55-f8ac-bd5d-33375e8c22f2,1,324874,324874,331361,333244,6487,6487,0,0,0,0
331376,fab014c1-47bf-824e-c70d-cc6ce777dac2,1,324874,324874,331376,334494,6502,6502,0,0,0,0
331363,44ac435a-2b82-9c75-9f62-78fea7d84ed7,1,324874,324874,331363,328862,6489,6489,0,0,0,0
331340,e0a95f2f-0220-dfc6-8828-d9cdd9f6c0f7,1,324875,324934,331340,330477,6406,6465,59,0,0,0
331371,ee608e1f-7f64-60ae-3846-e85d6627cd56,1,324875,324934,331371,331685,6437,6496,59,0,0,0
331371,6dffd943-36fd-a98d-94ab-24e96794e589,1,324879,324934,331371,333332,6437,6492,55,0,0,0
331362,ebec9a01-e205-eabf-7f22-fba53cc3097d,1,324879,324934,331362,331598,6428,6483,55,0,0,0
331384,fd9e54ce-8048-a0be-e0e1-96dd98a2a6e3,1,324874,324874,331384,334622,6510,6510,0,0,0,0
331417,674ccb71-cf4f-aa6e-dc77-be61dc629367,1,324874,324874,331417,333141,6543,6543,0,0,0,0
331401,855a1f4f-8bc0-2f6f-c43b-778345005273,1,324874,324874,331401,329726,6527,6527,0,0,0,0
331423,d392d5ec-c336-ab4a-0b75-b5f88bb25f9b,1,324874,324874,331423,330967,6549,6549,0,0,0,0
331440,cba8dd6e-ea54-79f2-399b-29fc5f5cf4f9,1,324880,324934,331440,332135,6506,6560,54,0,0,0
331442,11e55363-e318-2010-ebce-a5341e6b8a76,1,324880,324934,331442,334024,6508,6562,54,0,0,0
331442,51fa13fb-c1ff-13d4-775c-5718838e863a,1,324880,324934,331442,330802,6508,6562,54,0,0,0
331386,ae672648-b932-ab84-9c01-a3459b751b4f,1,324885,324934,331386,330460,6452,6501,49,0,0,0
331428,a9222088-a93e-d33b-ef04-0a3ca26d50d4,1,324885,324934,331428,334441,6494,6543,49,0,0,0
331384,04badcf4-9000-72e3-1599-1dbf6609b9a1,1,324885,324934,331384,330100,6450,6499,49,0,0,0
331386,8e30ff33-fae4-8458-3391-3ad4009ff786,1,324885,324934,331386,330770,6452,6501,49,0,0,0
331495,0fadcb09-7208-ffb2-8ac5-3f93906128df,1,324879,324934,331495,331205,6561,6616,55,0,0,0
331484,3236f41d-c22c-384c-9a7f-8712c216a949,1,324880,324934,331484,328253,6550,6604,54,0,0,0
331477,303715d7-293e-4a92-e6d0-9951417f6da9,1,324881,324934,331477,329655,6543,6596,53,0,0,0
331478,6c759415-ecd4-ff6b-68e5-44883c18ebd9,1,324884,324934,331478,331149,6544,6594,50,0,0,0
334920,5312ab77-c729-e964-a142-42218cc5c84e,8,333545,333545,334920,335232,1375,1375,0,0,0,0
336041,9d157617-2c7a-5163-fbfa-92d74aa425fe,8,332176,332176,336041,336183,3865,3865,0,0,0,0
336182,cfe84ae2-51bf-2d1d-83ed-79b20bfb997c,8,326734,326734,336182,338733,9448,9448,0,0,0,0
337639,ccda775c-a8ba-1f8f-d176-026420a22a93,1,328546,328550,337639,333416,9089,9093,4,0,0,0
337691,8a064b9b-902c-e81c-d979-a73b73cb2695,1,328537,328550,337691,340329,9141,9154,13,0,0,0
337683,08303126-82ec-2f42-1a40-77920209f205,1,328538,328550,337683,335149,9133,9145,12,0,0,0
337672,2de92307-a9ca-27f7-c305-01d2935a7058,1,328541,328550,337672,334068,9122,9131,9,0,0,0
337680,0c42333b-e081-aabd-48b1-8785592d899e,1,328541,328550,337680,339645,9130,9139,9,0,0,0
337657,82dba4db-1e57-deb0-8695-864941ee0c23,1,328541,328550,337657,341111,9107,9116,9,0,0,0
337688,4a1a98b5-01b8-76e1-b22f-af39a96cd8e2,1,328541,328550,337688,333807,9138,9147,9,0,0,0
337699,d2228ef8-35f8-56e8-9acf-760b68778ecb,1,328544,328550,337699,334418,9149,9155,6,0,0,0
337678,aaa79e8f-16db-aa93-5d31-1a849e532353,1,328544,328550,337678,340549,9128,9134,6,0,0,0
337680,cf699c98-9312-c20c-7918-68e3f9f08c1c,1,328545,328550,337680,336399,9130,9135,5,0,0,0
337680,54a6e6a6-c369-4889-9405-f1f8fd5c430c,1,328545,328550,337680,340025,9130,9135,5,0,0,0
337740,ae0b9c3e-2ef4-37db-126d-0b23f08a9f63,1,328536,328550,337740,335776,9190,9204,14,0,0,0
337704,47107b23-9832-4d70-ca57-66558590ca75,1,328537,328550,337704,337104,9154,9167,13,0,0,0
337750,96d765d0-7b16-c936-521d-ae98c42fa03e,1,328537,328550,337750,334080,9200,9213,13,0,0,0
337724,9d319350-5b7e-d2ff-839b-edd0781241bc,1,328538,328550,337724,338646,9174,9186,12,0,0,0
337724,c69fca09-ac6f-ec8e-4afb-9204198d9b79,1,328538,328550,337724,334204,9174,9186,12,0,0,0
337719,cf82779e-3079-49c6-9a5a-4d67055ae18d,1,328541,328550,337719,334209,9169,9178,9,0,0,0
337734,0c63b952-2b9e-7d18-615a-b9c7770f5152,1,328543,328550,337734,341217,9184,9191,7,0,0,0
337713,aca58f21-89d9-0927-b0ab-c45fcbd26e85,1,328545,328550,337713,334848,9163,9168,5,0,0,0
337766,5e17df4a-f9fb-6273-ad74-fc20c7c244cf,1,328538,328550,337766,341635,9216,9228,12,0,0,0
337770,5d661199-6f93-056c-638c-c8e03b5a402f,1,328541,328550,337770,334612,9220,9229,9,0,0,0
337768,128689bc-fd2f-9643-2f41-5f9dfd7f60a6,1,328542,328550,337768,335529,9218,9226,8,0,0,0
337762,91f01de0-2e4b-7c7f-5782-7826f6d000dd,1,328542,328550,337762,337806,9212,9220,8,0,0,0
337883,3921c69d-7761-e77a-82e3-01f023aa2c56,1,328541,328550,337883,338669,9333,9342,9,0,0,0
340054,4735b784-74eb-df66-d77b-fe0ad24850b0,32,54915,54915,340054,359323,285139,285139,0,0,0,0
341848,5cafca04-7317-58c7-e190-9c434e82263e,8,334301,334301,341848,345036,7547,7547,0,0,0,0
341948,a08c1d43-d00d-1898-ebc6-bc59f64b835b,8,334311,334361,341948,338406,7587,7637,50,0,0,0
342136,9b7289e5-20a6-4192-deb5-d042beb6b446,8,336299,336299,342136,339457,5837,5837,0,0,0,0
343145,437e6068-4ccb-8ee7-77ea-8daafc46b071,8,326865,326865,343145,344067,16280,16280,0,0,0,0
343658,1aa8fcd7-afb0-3328-58f3-25c0cc77f138,1,328430,328430,343658,347181,15228,15228,0,0,0,0
343658,83353c3d-3b91-e4f4-3326-af5861c0b62b,1,328430,328430,343658,336411,15228,15228,0,0,0,0
343660,b23283b2-8107-2c9f-bf1c-25a8760a54e8,1,328430,328430,343660,342281,15230,15230,0,0,0,0
343686,0df85499-a393-775c-a52c-bf13217c41ea,1,328430,328430,343686,347872,15256,15256,0,0,0,0
343660,a91ee2d3-406d-cb60-e6ee-6ade2c7381ab,1,328431,328490,343660,346756,15170,15229,59,0,0,0
345276,2474faaf-89f1-cc00-40c1-2f43b577dd1b,8,334327,334361,345276,343870,10915,10949,34,0,0,0
345382,9d38eb9c-b420-9426-9b00-6259990dcb3b,8,334320,334361,345382,345059,11021,11062,41,0,0,0
348406,68a4c56f-92e1-7ce5-ab66-b8e73fa014a2,8,327116,327116,348406,353958,21290,21290,0,0,0,0
348731,93e024d2-00bd-eefd-0d8d-2944ded9c34c,8,334347,334361,348731,349487,14370,14384,14,0,0,0
348804,de81b3ed-b77b-1335-0e4d-bfb24675aa13,8,334337,334361,348804,355805,14443,14467,24,0,0,0
350305,f0acce13-cda3-cd5a-ca9e-90b614e1521c,8,326922,326925,350305,348908,23380,23383,3,0,0,0
353657,2a665ac5-4a46-2ec7-b9bd-6cd858a895b0,1,328434,328490,353657,355248,25167,25223,56,0,0,0
353659,5aa7abc5-548f-c66a-dce1-113fc921fee8,1,328434,328490,353659,342627,25169,25225,56,0,0,0
353650,087df61d-21e4-a7e7-7856-fcb38b27036b,1,328435,328490,353650,355830,25160,25215,55,0,0,0
353738,dd918930-ec13-4367-2e97-4f7a98f314cb,1,328431,328490,353738,364355,25248,25307,59,0,0,0
353752,620423f1-08f5-3973-0663-7e426e4e8497,1,328431,328490,353752,360555,25262,25321,59,0,0,0
353761,fb59a25b-6236-c6f1-ff4d-aa0c2d74cf85,1,328434,328490,353761,364842,25271,25327,56,0,0,0
353754,864ddc0d-e84d-f8cd-33d3-07f2d745e51e,1,328434,328490,353754,361419,25264,25320,56,0,0,0
353711,a5ea0d8f-788e-f5c1-a8a9-4ed52d427251,1,328435,328490,353711,347767,25221,25276,55,0,0,0
353745,9a8578e8-f044-7ca9-a7d1-415a09d955ef,1,328435,328490,353745,349623,25255,25310,55,0,0,0
353816,95fd62db-5fc2-252e-1974-99ae110e0a1d,1,328431,328490,353816,358906,25326,25385,59,0,0,0
353777,9e61740f-cf68-4768-dcdb-c872fabfe297,1,328431,328490,353777,354985,25287,25346,59,0,0,0
353763,bf921069-55d7-449c-8f6e-3160b65c0ef8,1,328434,328490,353763,355273,25273,25329,56,0,0,0
353817,058cbf65-a568-9f3a-0ee1-ec9d00871d18,1,328436,328490,353817,346354,25327,25381,54,0,0,0
353810,3c7edb88-ddf4-5d30-0c9c-2d55a1bbe389,1,328440,328490,353810,366251,25320,25370,50,0,0,0
353870,e6c0b0c9-4016-3bc5-37cb-51216e9602ff,1,328436,328490,353870,357863,25380,25434,54,0,0,0
353878,775e0841-8abe-925c-38a3-a9c2aaad68e4,1,328440,328490,353878,342458,25388,25438,50,0,0,0
353879,c202054b-c687-f52c-ad07-9f5a49dc9c23,1,328441,328490,353879,341816,25389,25438,49,0,0,0
353883,8722f1c1-0832-dc92-2286-58786f488673,1,328431,328490,353883,343853,25393,25452,59,0,0,0
353885,e907aae7-e222-f39e-f00f-7fc93f38f537,1,328439,328490,353885,354330,25395,25446,51,0,0,0
353950,da44ca8d-4c5f-ba9f-ad23-7dc1e7e4acb0,1,328440,328490,353950,355951,25460,25510,50,0,0,0
355029,8119136d-ad2b-e9a9-550f-9533d51b840f,32,296091,296139,355029,349740,58890,58938,48,0,0,0
355470,5e6d9db3-2217-3f70-b646-9a1f5f7402f2,8,348379,348379,355470,354110,7091,7091,0,0,0,0
355568,40ce922c-4dce-488d-a55c-67bd5ca4a098,8,348387,348439,355568,357418,7129,7181,52,0,0,0
356266,77174dc6-317c-2dbe-5e2f-5749e02bc406,32,297356,297356,356266,360740,58910,58910,0,0,0,0
358634,b11822ff-ab73-b9a1-be9d-d3cc28aca4da,8,348409,348439,358634,360800,10195,10225,30,0,0,0
358755,152b7fbd-aa15-a7d3-b4ec-733defe47a7e,8,348400,348439,358755,363543,10316,10355,39,0,0,0
358964,ea7d9349-6779-8ac0-1e7b-5e00ed032b70,1,349862,349862,358964,361505,9102,9102,0,0,0,0
358980,f3adea7d-245e-ceec-cf6b-95506a2f7860,1,349862,349862,358980,358908,9118,9118,0,0,0,0
358965,59b5f891-ad2e-6105-2ca6-50a3eec445f5,1,349862,349862,358965,359567,9103,9103,0,0,0,0
358999,1203f15e-df6c-6e6f-e411-1f4a8406562d,1,349863,349922,358999,363100,9077,9136,59,0,0,0
358983,f6dd23fc-4fea-c34f-5155-89118abbd74f,1,349870,349922,358983,355845,9061,9113,52,0,0,0
358995,adacbf26-34e5-5d9c-ca6b-802b9fe8c455,1,349871,349922,358995,357960,9073,9124,51,0,0,0
359041,cea9e905-e0e4-fb32-8c14-1f2316954ee6,1,349863,349922,359041,357357,9119,9178,59,0,0,0
359041,c960b917-296b-bf50-ddef-2a66c530dd82,1,349863,349922,359041,362908,9119,9178,59,0,0,0
359079,39138902-c544-eab0-fe70-3fc225bb2712,1,349863,349922,359079,354513,9157,9216,59,0,0,0
359030,53e946d9-528d-a2fe-660a-7799f2700781,1,349867,349922,359030,359298,9108,9163,55,0,0,0
359073,522be5d5-f848-169c-5b7f-aafef30226bd,1,349868,349922,359073,355887,9151,9205,54,0,0,0
359030,ee068e53-0573-47dd-c2bf-3bda0404e989,1,349869,349922,359030,362295,9108,9161,53,0,0,0
359082,820abe75-6c8b-f454-9613-bb63f766c361,1,349870,349922,359082,354751,9160,9212,52,0,0,0
359083,fe76d3e5-4fcf-1b1c-8031-3984ce53cccf,1,349870,349922,359083,360299,9161,9213,52,0,0,0
359086,e37fa237-cb75-805b-0882-dcaacce5dc31,1,349863,349922,359086,362143,9164,9223,59,0,0,0
359099,b2e1a5f1-0e4f-078c-705a-7fab10025918,1,349863,349922,359099,358616,9177,9236,59,0,0,0
359099,8e8f4854-956d-92e2-089c-fd5a9d3cf4ab,1,349866,349922,359099,363349,9177,9233,56,0,0,0
359135,83637de0-7196-71a5-0c0d-640b0626176b,1,349866,349922,359135,359386,9213,9269,56,0,0,0
359093,eccc0831-9410-02e7-be33-c4bdfbae117f,1,349866,349922,359093,360077,9171,9227,56,0,0,0
359122,743d0ed3-5540-df98-f8d8-b584ce04663f,1,349866,349922,359122,359021,9200,9256,56,0,0,0
359101,7964421a-2444-d19c-6d4f-52f755bc36e9,1,349866,349922,359101,362526,9179,9235,56,0,0,0
359109,db9bca04-1948-ac3e-2526-f41c2e5cfd07,1,349868,349922,359109,356622,9187,9241,54,0,0,0
359088,2a5252c8-d4d6-08b4-6322-5384a1fc53c3,1,349871,349922,359088,362163,9166,9217,51,0,0,0
359188,48c23668-678a-ec24-1558-6e6348020250,1,349863,349922,359188,360625,9266,9325,59,0,0,0
359172,6d1eb722-60ab-bc7f-c47b-90ed77eba921,1,349867,349922,359172,354697,9250,9305,55,0,0,0
361954,bcad7491-d1e2-4f28-15be-dddf19af378c,8,348418,348439,361954,363431,13515,13536,21,0,0,0
361955,dd61730b-5efe-232c-eaf6-8f57701dc761,8,348426,348439,361955,363831,13516,13529,13,0,0,0
362959,96502536-a19c-c66b-6172-2d0cadd5901e,1,362322,362330,362959,363101,629,637,8,0,0,0
363059,53172e89-1595-3106-9511-6c5f34c4f6ad,1,362415,362450,363059,363278,609,644,35,0,0,0
363117,27237c1a-6172-4155-277b-af460d7eee5e,1,362270,362270,363117,362730,847,847,0,0,0,0
363061,607242e8-5034-f6d1-4aff-51abc51df0ca,1,362435,362450,363061,363268,611,626,15,0,0,0
363061,8e78646b-7d47-af43-f4dd-59785c009a69,1,362436,362450,363061,362891,611,625,14,0,0,0
363126,e464a4f2-f7aa-a07e-64e5-cdc7be85300c,1,362502,362510,363126,363105,616,624,8,0,0,0
363127,4f85f747-e885-0279-501f-3f11d5468910,1,362506,362510,363127,363223,617,621,4,0,0,0
363215,cb5f85f5-a10e-0c72-4c41-59422627d722,1,362372,362390,363215,363297,825,843,18,0,0,0
363337,62c04528-e687-e1f3-a061-8b976355e25d,1,362458,362510,363337,363271,827,879,52,0,0,0
363369,83de069c-4ed2-c7d9-d9db-71ede283a8a0,1,362472,362510,363369,362953,859,897,38,0,0,0
363376,14ab1f3c-922a-a4c7-4802-78617fe66c2a,1,362535,362570,363376,363426,806,841,35,0,0,0
363400,b20c42aa-1b42-200d-4637-d5fe03813d26,1,362541,362570,363400,363566,830,859,29,0,0,0
363853,034a0aab-71a5-e9e3-3ebc-7049d67e7010,1,363195,363239,363853,363678,614,658,44,0,0,0
363855,7daae9db-5b90-aa65-2612-a30409ce2544,1,363195,363239,363855,363784,616,660,44,0,0,0
364064,0bc25a3b-741d-319d-52bb-e4e1fda57faf,1,363207,363239,364064,364183,825,857,32,0,0,0
364082,0d19364d-00eb-f10e-c40c-f33a42e32c21,1,363185,363239,364082,363924,843,897,54,0,0,0
364082,a630e28b-6c57-3391-40bd-07abe194891f,1,363188,363239,364082,363994,843,894,51,0,0,0
364098,7b2df78f-3ba4-6082-0336-6b3d08384e87,1,363207,363239,364098,363806,859,891,32,0,0,0
371670,13e2c5ee-1afe-14f8-ddfb-b48ed32cdaf0,1,362500,362510,371670,368787,9160,9170,10,0,0,0
371670,1f0c033b-a5fc-982f-3dbd-331984fef0f5,1,362500,362510,371670,367705,9160,9170,10,0,0,0
371756,83b10677-e3bb-bbeb-8c65-c13df17871ba,1,362500,362510,371756,374526,9246,9256,10,0,0,0
371719,149bc313-acc2-ac76-c533-c8c6a0a75dfe,1,362500,362510,371719,370755,9209,9219,10,0,0,0
371788,2d47c84a-d3dc-a7d4-cc62-ac5428c95338,1,362506,362510,371788,367244,9278,9282,4,0,0,0
371816,2ae0e12c-9570-c489-4e6d-0bbf3cdaa243,1,362506,362510,371816,374868,9306,9310,4,0,0,0
371789,99860656-3699-56ab-2951-9a0f060f22eb,1,362508,362510,371789,367301,9279,9281,2,0,0,0
371813,f878339c-8535-16ec-e2b4-c4a76cc9773b,1,362510,362510,371813,376261,9303,9303,0,0,0,0
371871,eda7b6e5-eb1a-c86f-c4e5-b7e4ebea8fee,1,362501,362510,371871,371424,9361,9370,9,0,0,0
371837,74c8b8a5-74bb-a122-2e74-095cc51c452b,1,362502,362510,371837,371468,9327,9335,8,0,0,0
371851,2f8e3cde-ceed-d234-96f5-87d8a192d203,1,362504,362510,371851,375356,9341,9347,6,0,0,0
371852,2ee65b00-fd3e-1572-d4ad-e022e0038105,1,362505,362510,371852,367280,9342,9347,5,0,0,0
371852,dd134751-5119-4e38-13be-d02f56c8d221,1,362505,362510,371852,373270,9342,9347,5,0,0,0
371853,6ad1182f-5e93-e505-6ec7-c0eebebe06ea,1,362505,362510,371853,371065,9343,9348,5,0,0,0
371876,13ddd5b2-3287-e958-cabc-a3205c6b69e9,1,362506,362510,371876,376040,9366,9370,4,0,0,0
371832,be93b360-baef-cd21-4363-90ca0b268aaa,1,362507,362510,371832,376081,9322,9325,3,0,0,0
371833,8c393f4c-29ef-e33b-51e5-9f8d807600fe,1,362509,362510,371833,370547,9323,9324,1,0,0,0
371829,cebdc3e3-c05f-b0c8-6f44-cd6dc382ba7f,1,362511,362570,371829,368930,9259,9318,59,0,0,0
371917,d052857e-8f8b-55d1-5d60-be10d7ee5d4f,8,353185,353241,371917,364332,18676,18732,56,0,0,0
371931,b0fb843c-fa31-346b-f041-d9612a983f49,1,362501,362510,371931,373260,9421,9430,9,0,0,0
371932,a0725989-a1db-830f-1fb0-abc3aecbf7f1,1,362501,362510,371932,375847,9422,9431,9,0,0,0
371912,6fe61bfa-74d2-feb6-37a4-465141500063,1,362504,362510,371912,372855,9402,9408,6,0,0,0
371890,b624c283-6bb4-5123-f81d-42726d8b643e,1,362509,362510,371890,368696,9380,9381,1,0,0,0
372014,35013e0b-3815-dbf4-125e-4b3fe81133a9,1,362501,362510,372014,371156,9504,9513,9,0,0,0
372014,e2b77137-8173-e1c0-513d-5c96dfab137c,1,362501,362510,372014,375541,9504,9513,9,0,0,0
372027,8e7cf803-626e-f43f-0446-9f66c90a115d,1,362504,362510,372027,373899,9517,9523,6,0,0,0
372884,ea7dbecd-e06f-f0d4-6f53-5f89e401ce0f,1,359499,359499,372884,376593,13385,13385,0,0,0,0
373135,cd78327c-744f-c942-2c33-54edfab09e92,8,353172,353181,373135,377035,19954,19963,9,0,0,0
373837,d7f74004-a2b4-91ff-e6b0-aca026fd8253,16,59098,59098,373837,334715,314739,314739,0,0,0,0
374430,75228d84-9409-ecd4-c7f8-d0982838f0ff,16,59098,59098,374430,396403,315332,315332,0,0,0,0
375853,82a3df65-dd26-7ae5-c8be-93a637fdefa4,8,374855,374900,375853,375758,953,998,45,0,0,0
377734,948148e4-3f3f-87bb-aeef-749fe42d3cd4,8,376767,376767,377734,377449,967,967,0,0,0,0
379681,bc9ca81c-ecfe-f33d-8f50-371934108ea2,8,378475,378475,379681,379489,1206,1206,0,0,0,0
380346,cc39398d-23f3-853a-acfd-c5f3c535fb4c,8,379290,379326,380346,379793,1020,1056,36,0,0,0
380569,4f995de6-8a77-0e42-d3e9-2b7561f3555d,8,379398,379446,380569,380946,1123,1171,48,0,0,0
380616,15be2848-cad7-cd24-0491-670d64ef936d,8,379337,379386,380616,380827,1230,1279,49,0,0,0
380797,0ef974a9-e72b-0e03-7356-131b699dba9b,1,371604,371641,380797,377257,9156,9193,37,0,0,0
380840,2f649cc2-5eda-7b2a-9a5d-092090ef62ce,1,371604,371641,380840,380885,9199,9236,37,0,0,0
380841,f720a35d-034b-3b25-26b8-1db9c0b739f3,1,371607,371641,380841,376311,9200,9234,34,0,0,0
380833,dcaaffc4-d6c8-460f-4978-fcd7ce37237a,1,371609,371641,380833,377353,9192,9224,32,0,0,0
380883,e78dba98-4f8a-e217-9d94-d1c4d7681471,1,371607,371641,380883,380147,9242,9276,34,0,0,0
380913,1ac4df91-0498-4e28-7e80-8be1efec2095,1,371611,371641,380913,376384,9272,9302,30,0,0,0
380933,f01e9c07-b9d0-832f-b5d7-9e8e8f21e8ec,1,371603,371641,380933,379101,9292,9330,38,0,0,0
380923,b625220b-656f-ba0b-d3bd-2099951a8375,1,371604,371641,380923,380691,9282,9319,37,0,0,0
380923,e692e081-751d-e5f0-0c53-cecbac48253f,1,371607,371641,380923,379359,9282,9316,34,0,0,0
381046,295c1fe4-f2c4-16f1-035c-5a0b5630033c,1,371603,371641,381046,380672,9405,9443,38,0,0,0
381119,d56f403a-33a7-bb68-bbd3-f06681971c92,1,371603,371641,381119,379583,9478,9516,38,0,0,0
381215,a96e4559-cce9-5a81-b3c3-655898e31b8f,8,379981,379981,381215,381746,1234,1234,0,0,0,0
382070,dba1586f-3ad5-a9e2-048f-bc73e4b0796b,8,380800,380857,382070,381925,1213,1270,57,0,0,0
382085,70f98933-7c99-11e6-e333-c90f0906fbc0,8,380970,380977,382085,382494,1108,1115,7,0,0,0
382308,38d16511-8891-4fbf-f59d-079f075e03ed,8,381032,381037,382308,382662,1271,1276,5,0,0,0
382398,53f17e12-7da7-0582-6bb4-82c70b533a90,8,326974,326985,382398,372889,55413,55424,11,0,0,0
382984,22b089c7-aa31-0ee0-ce8c-9c65ca1c2593,8,381025,381037,382984,382831,1947,1959,12,0,0,0
383065,12cc7134-f175-10ac-5edf-87dad485d540,1,373931,373957,383065,386368,9108,9134,26,0,0,0
383101,cac7ec48-a6e9-dafb-a218-091af8b7aa63,32,94258,94302,383101,337056,288799,288843,44,0,0,0
383152,29a55243-6197-38ba-e5af-e0fd879883f4,1,373931,373957,383152,379584,9195,9221,26,0,0,0
383233,ee31bc55-a973-d8f7-cf7d-59dc4b9486e6,1,373927,373957,383233,386327,9276,9306,30,0,0,0
383230,00e4e0b0-599b-3cae-93d0-25137a045c43,1,373930,373957,383230,386043,9273,9300,27,0,0,0
383210,3bc27b50-8bdf-da2c-1379-f7fbb2a92e73,1,373931,373957,383210,383295,9253,9279,26,0,0,0
383217,402077fb-2855-34b4-3bf3-4f6cf83296c1,1,373934,373957,383217,386186,9260,9283,23,0,0,0
383283,7db9fa27-cae3-a240-bce6-4b1ffd00dfdf,1,373927,373957,383283,378969,9326,9356,30,0,0,0
383286,14fe1200-93f2-ea4d-214b-230e9f918e64,1,373930,373957,383286,382870,9329,9356,27,0,0,0
383285,1405be55-7df0-fbd1-e274-359a7ab4ab80,1,373931,373957,383285,380898,9328,9354,26,0,0,0
386125,a55b8e54-c0a2-303c-8a3e-a4a8208df061,1,373930,373957,386125,381923,12168,12195,27,0,0,0
386145,61033940-b078-91e7-5b76-4007ec1d9c52,1,373927,373957,386145,381097,12188,12218,30,0,0,0
386172,51338523-e933-45b8-bc5f-8a5bee0d0354,1,373928,373957,386172,388828,12215,12244,29,0,0,0
386171,8bfa681d-8f82-f371-ff5f-d5e0fd186564,1,373928,373957,386171,381605,12214,12243,29,0,0,0
386162,f40c9767-bf4b-5064-42ba-ac0224b0146f,1,373929,373957,386162,385994,12205,12233,28,0,0,0
386139,60bd0ea8-74c0-e9b6-58b4-6d7fc840c21c,1,373934,373957,386139,385857,12182,12205,23,0,0,0
386214,8e45720c-d088-6d20-00e4-99b5925f9b67,1,373928,373957,386214,391901,12257,12286,29,0,0,0
386201,2821922b-60a9-e072-cc67-0a1f9b0aec94,1,373935,373957,386201,383403,12244,12266,22,0,0,0
386270,f7d7b1d9-fac1-50ea-a1ce-bac41f44a5e8,1,373929,373957,386270,387228,12313,12341,28,0,0,0
386295,3523915d-7e2e-c7af-9b96-312ee51582f3,1,373930,373957,386295,386395,12338,12365,27,0,0,0
386307,10846404-63ea-e724-eec5-d07699d657ab,1,373928,373957,386307,383602,12350,12379,29,0,0,0
386355,d9da15e6-bc27-5719-2bb5-5ac9a5767e70,1,373935,373957,386355,382973,12398,12420,22,0,0,0
386415,a87747a1-8d80-5e12-2a6b-379c7abc333c,1,373928,373957,386415,389675,12458,12487,29,0,0,0
386448,19197604-3b7f-805f-718b-1135a4f0b6d2,1,373928,373957,386448,382926,12491,12520,29,0,0,0
386713,28ace558-c81e-e77d-34b8-c32cb8e096ef,1,371599,371641,386713,387910,15072,15114,42,0,0,0
386759,2a7159b4-8cf4-dc8d-6dda-120ed526460b,1,371600,371641,386759,385182,15118,15159,41,0,0,0
386753,64b25499-ad5a-0110-4a90-85149f3d007c,1,371602,371641,386753,389880,15112,15151,39,0,0,0
386807,b1966dd3-d4a1-dc32-84bf-e58ca905150f,1,371601,371641,386807,390513,15166,15206,40,0,0,0
386861,e4e7f9e7-93c0-914e-7ac1-4727f3e25e1f,1,371599,371641,386861,388590,15220,15262,42,0,0,0
386883,8ded95e6-8333-1e4d-4b4e-cd8dc31ffff2,1,371600,371641,386883,381444,15242,15283,41,0,0,0
386876,9d6ca021-1e46-ecdc-bd76-8a7dc8497cca,1,371603,371641,386876,390109,15235,15273,38,0,0,0
386907,c5c68438-b92c-0430-3539-8963d3270cc0,1,371599,371641,386907,383810,15266,15308,42,0,0,0
386908,221cb479-2478-b821-4852-019deeb335b8,1,371599,371641,386908,380201,15267,15309,42,0,0,0
386922,c9fb8785-05f3-24ff-1f92-3c2da511e769,1,371600,371641,386922,384518,15281,15322,41,0,0,0
386996,01ef34ff-8b3e-13a9-8910-ec5c313fb71e,1,371601,371641,386996,391748,15355,15395,40,0,0,0
386987,cdcf9e05-bd8c-c80e-e34d-391a700b34a8,1,371602,371641,386987,383051,15346,15385,39,0,0,0
386988,ba456de9-8a6d-bf9e-2a15-a70f4b05cd2b,1,371602,371641,386988,391293,15347,15386,39,0,0,0
386975,7a6e8482-0db0-4347-3549-f42024551e23,1,371603,371641,386975,382806,15334,15372,38,0,0,0
388284,1de8b35f-bd8f-ad35-1b17-809de70a7e3c,1,362390,362390,388284,375683,25894,25894,0,0,0,0
388435,8eb4e2b4-0e49-3870-d407-1486057ae649,1,362388,362390,388435,395118,26045,26047,2,0,0,0
388452,97bfc026-44bf-8bc1-dbed-b714d88b8f52,1,362381,362390,388452,393476,26062,26071,9,0,0,0
388486,11856991-e442-0699-6116-2d0db3faec91,1,362386,362390,388486,389404,26096,26100,4,0,0,0
388516,2e6a88c0-fb4c-db43-f27f-8712e573acc5,1,362381,362390,388516,377344,26126,26135,9,0,0,0
388515,e0986ed7-51f5-d47b-bfc6-cf2bda030e73,1,362381,362390,388515,397230,26125,26134,9,0,0,0
388513,28dd2e89-e4db-1d95-460e-372bac2d0f39,1,362381,362390,388513,380228,26123,26132,9,0,0,0
388502,0886278d-f4f2-5c0c-e71c-5006a24a72ad,1,362381,362390,388502,400686,26112,26121,9,0,0,0
388513,a1cf040f-e5c6-e572-393e-1d02502a70e9,1,362381,362390,388513,383089,26123,26132,9,0,0,0
388511,a90829a6-f89e-54ea-8ac0-6a9e6cf7f504,1,362381,362390,388511,377325,26121,26130,9,0,0,0
388501,99d9ce1d-55a8-81cd-bab7-ce38da5ff051,1,362381,362390,388501,393865,26111,26120,9,0,0,0
388552,1900c321-4219-eb72-5ba6-612b42d8c523,1,362383,362390,388552,377126,26162,26169,7,0,0,0
388520,d3c456ae-75c6-f18d-40a6-c85555840778,1,362389,362390,388520,381671,26130,26131,1,0,0,0
388521,58a1a0be-2312-a685-7f95-1f817c6d7e0d,1,362390,362390,388521,382238,26131,26131,0,0,0,0
388577,5b117f20-8a05-ce06-1f83-c18b7c7dca05,1,362384,362390,388577,389162,26187,26193,6,0,0,0
388578,1f9054bb-ffc3-5d02-a1da-9cda51e02147,1,362385,362390,388578,381309,26188,26193,5,0,0,0
388577,a751f7d9-4f9a-936c-6743-9b986fe9dfc5,1,362387,362390,388577,399065,26187,26190,3,0,0,0
388563,2eb5073b-e5cb-1475-83b0-f80e8064b287,1,362389,362390,388563,382776,26173,26174,1,0,0,0
388602,78658c08-fd78-a7da-a280-fd5556d6c1eb,1,362390,362390,388602,383000,26212,26212,0,0,0,0
388660,c1510574-3616-e387-3444-39d59d12955e,1,362384,362390,388660,390907,26270,26276,6,0,0,0
388675,4dd4c6fc-d506-11aa-d2de-7909bb8a9d08,1,362384,362390,388675,387350,26285,26291,6,0,0,0
388618,f785cd0d-685a-8e53-1d27-597885e381a2,1,362385,362390,388618,398303,26228,26233,5,0,0,0
388661,3a8c0c71-e488-dfd3-f661-26edb0d709f4,1,362385,362390,388661,390949,26271,26276,5,0,0,0
388645,e9753bd6-8a63-6ba5-a0d0-940f069a3c79,1,362388,362390,388645,401419,26255,26257,2,0,0,0
388720,95952125-70db-85f9-9d27-d39d0593b210,1,362383,362390,388720,380148,26330,26337,7,0,0,0
389458,7f58f942-1ea0-c939-3291-74326e09069d,8,356403,356403,389458,398759,33055,33055,0,0,0,0
389587,457f0cf1-fd88-dd38-5068-53a269abb9de,8,356432,356463,389587,381660,33124,33155,31,0,0,0
394590,7d4428c4-1279-7f2c-2207-c6211b5d0620,8,388210,388261,394590,393848,6329,6380,51,0,0,0
394594,31bdd7de-f202-c05a-0d36-0498258ce2bf,8,388201,388201,394594,391915,6393,6393,0,0,0,0
395128,ce1b4bf8-28b8-9843-dde2-7d0a52805fbc,8,387589,387589,395128,392228,7539,7539,0,0,0,0
395391,1689d72c-5155-69f4-d2ab-3eb624bee05c,8,387961,387961,395391,391966,7430,7430,0,0,0,0
395419,74a9b142-990e-3a80-5615-6797e8e465ae,8,387969,388021,395419,393580,7398,7450,52,0,0,0
395977,29dd4973-2fb3-a898-fccf-b409bf583d5f,1,374185,374185,395977,398317,21792,21792,0,0,0,0
395997,1c7b9285-7340-856b-a21e-a21be673b335,1,374186,374245,395997,390931,21752,21811,59,0,0,0
396067,4f0ac825-ec38-0f2d-f45a-38b4b7ace1b3,1,374190,374245,396067,393009,21822,21877,55,0,0,0
396145,8055f3c8-cd92-b0bb-274f-f643aecc015a,1,374186,374245,396145,401810,21900,21959,59,0,0,0
396101,5ea4d9b3-469a-bb47-542c-a399f2a5e387,1,374186,374245,396101,393148,21856,21915,59,0,0,0
396138,aadf37cc-f9a2-fe31-6d6c-95aea7356f6f,1,374187,374245,396138,398121,21893,21951,58,0,0,0
396107,5c2ed7bf-8a65-2f75-e076-0e6a6259375a,1,374189,374245,396107,406553,21862,21918,56,0,0,0
396170,1f1e74f5-85e1-7c3c-6301-1a73ac0ff333,1,374185,374185,396170,385463,21985,21985,0,0,0,0
396165,74021562-c5db-a032-787b-2cae3e820f4d,1,374195,374245,396165,401833,21920,21970,50,0,0,0
396260,15f697fd-a35c-f9f7-bd74-f9d3b949c125,1,374187,374245,396260,387563,22015,22073,58,0,0,0
396250,684fc293-3251-4a46-82b2-51f1199457eb,1,374194,374245,396250,399579,22005,22056,51,0,0,0
396301,fba778b9-2fdd-77cd-ac60-0af0f0bedf9a,1,374186,374245,396301,387813,22056,22115,59,0,0,0
396281,b87fcd14-91c8-c699-2843-c6517561834e,1,374189,374245,396281,394806,22036,22092,56,0,0,0
396327,8cd54cb6-c0e4-e373-0152-300eeb47d902,1,374189,374245,396327,389809,22082,22138,56,0,0,0
396313,a6f20f6a-aaea-c217-5bc6-9d21cf055ebe,1,374194,374245,396313,401632,22068,22119,51,0,0,0
396312,9873e3ac-4f58-6137-e84e-d94e92f9a8fd,1,374194,374245,396312,386460,22067,22118,51,0,0,0
396348,9b20dac7-cff7-ce32-7649-a52a0ddf6858,1,374186,374245,396348,400964,22103,22162,59,0,0,0
396628,75649ecc-957c-fc83-1f23-c7d93f5c7a04,1,374190,374245,396628,396947,22383,22438,55,0,0,0
396651,97f3a5de-b145-26b0-d8b2-a4ac4519b98c,1,374189,374245,396651,396541,22406,22462,56,0,0,0
396712,cc78f060-746f-3431-fe83-90214b96b952,1,374193,374245,396712,402653,22467,22519,52,0,0,0
398647,28ff1860-01e7-2f3e-cadd-56267885c68f,8,387695,387695,398647,402112,10952,10952,0,0,0,0
398678,55b129a5-c744-5bfb-8f6d-27e1ffd7ee25,8,387705,387755,398678,393447,10923,10973,50,0,0,0
398922,fb785272-0091-f77c-fb3b-e5e977439b31,8,387982,388021,398922,394949,10901,10940,39,0,0,0
400089,d6bbe5ca-995b-5665-6a75-a86222ef5535,8,381035,381037,400089,395909,19052,19054,2,0,0,0
401990,dfc9550d-48f7-407a-b5f0-18e40fe75f7e,8,391059,391086,401990,407036,10904,10931,27,0,0,0
402927,f41d4011-0832-9b86-84f0-716bf78e5f10,8,392026,392026,402927,406520,10901,10901,0,0,0,0
404491,2f7ff30b-a971-98e4-f73f-707d6eef882a,8,327203,327203,404491,435315,77288,77288,0,0,0,0
405319,ca0a4ac9-31f3-e260-9f43-eb20fd6f6bbb,8,397720,397720,405319,407996,7599,7599,0,0,0,0
406887,8867260d-70e2-2b70-7324-cc7c02a09432,1,405574,405632,406887,407227,1255,1313,58,0,0,0
406993,fef9b10b-4f36-ce79-86b8-2a3d7a197bbb,1,405435,405435,406993,407150,1558,1558,0,0,0,0
407142,5820653c-e029-7487-7a0b-29d0904cc2ef,1,405572,405572,407142,406781,1570,1570,0,0,0,0
407176,3492abcf-6938-edd8-717b-b519830080fc,1,405573,405632,407176,406492,1544,1603,59,0,0,0
408313,61bf4326-412c-1034-41fe-dc5f66bd7b2f,8,393945,393981,408313,404464,14332,14368,36,0,0,0
411833,179ef857-45de-0e0b-0054-76f5082ddc63,1,405202,405202,411833,410032,6631,6631,0,0,0,0
411876,5223111f-b82b-b912-0aab-d482deaa3d09,1,405202,405202,411876,415147,6674,6674,0,0,0,0
411856,49b868c2-cfda-ff51-5caa-2701cef1878f,1,405203,405262,411856,409301,6594,6653,59,0,0,0
411856,55ad6655-4b94-f3d9-169f-915e59828abf,1,405203,405262,411856,413640,6594,6653,59,0,0,0
411880,d5e82907-d66c-d553-12dc-4248f169e2ce,1,405203,405262,411880,409255,6618,6677,59,0,0,0
411881,17013558-4826-c678-8f37-47794d3e8ae0,1,405203,405262,411881,409956,6619,6678,59,0,0,0
411873,c3377ad3-3c6c-a88b-6c77-e782419da3e1,1,405205,405262,411873,408648,6611,6668,57,0,0,0
411892,8a83e051-3e5f-99e8-cb9a-de50eb5a6eed,1,405209,405262,411892,410902,6630,6683,53,0,0,0
411936,7603fce3-98ac-352b-2b0c-ba4118182465,1,405203,405262,411936,413498,6674,6733,59,0,0,0
411927,43c62187-353d-28b2-d895-42d4d27f8d4d,1,405203,405262,411927,409530,6665,6724,59,0,0,0
411928,f71ac049-5829-c75f-ffdc-3e24c0a9fab9,1,405205,405262,411928,409299,6666,6723,57,0,0,0
411910,0f84c89c-523e-a0dd-ebc5-821eca123602,1,405206,405262,411910,413951,6648,6704,56,0,0,0
411948,b51f767a-746f-4373-58b0-6e0040c16f6f,1,405207,405262,411948,409733,6686,6741,55,0,0,0
411902,2aa14851-fec0-2849-e6f8-498c8215b86a,1,405207,405262,411902,409353,6640,6695,55,0,0,0
411900,3b4a165b-2e58-8458-766c-8d33819cea5f,1,405207,405262,411900,413823,6638,6693,55,0,0,0
411902,e0ada076-e945-758c-4eb1-8194ad9f1325,1,405207,405262,411902,414473,6640,6695,55,0,0,0
411925,10ec3c87-3bc1-c038-f4ea-6d5d3dbf4e1c,1,405208,405262,411925,409915,6663,6717,54,0,0,0
411903,acfdb0c8-9e06-8ae3-8a7b-3b88938b5372,1,405208,405262,411903,414916,6641,6695,54,0,0,0
411926,a310ca23-eddc-60d8-e3b6-83d4d3a35339,1,405209,405262,411926,413142,6664,6717,53,0,0,0
411926,7d2202dc-02f6-ed3e-6111-fe2d071bcd2a,1,405210,405262,411926,411824,6664,6716,52,0,0,0
411947,21afe3ab-b829-15d5-440d-c11a1ed53091,1,405211,405262,411947,410881,6685,6736,51,0,0,0
411956,8b42a745-16c6-3710-31a8-b75a0e3c7039,1,405206,405262,411956,409698,6694,6750,56,0,0,0
411954,f7131a89-adad-84f5-bfc9-3c9a6a4a78e3,1,405210,405262,411954,409673,6692,6744,52,0,0,0
411983,659b6536-f7c4-e418-d659-21e3dcd771f5,1,405211,405262,411983,415228,6721,6772,51,0,0,0
414995,e6d7b38f-9d3f-b2bf-826a-ad170a882932,8,391026,391026,414995,407819,23969,23969,0,0,0,0
415118,ca86df51-3527-390c-646f-a3f08fcc25c8,8,391258,391258,415118,406558,23860,23860,0,0,0,0
415130,07c3f5bf-deec-a16f-aad4-1a734658b22e,8,391037,391086,415130,418229,24044,24093,49,0,0,0
415283,55d0591e-130c-6722-7d80-43dea0f301ab,8,391266,391318,415283,411246,23965,24017,52,0,0,0
415296,7bf59c6a-77d2-9a3a-0314-0be39ea6ffda,8,391058,391086,415296,419843,24210,24238,28,0,0,0
416015,fd38752d-6a8d-c6eb-48a9-3c9352c60a7d,1,399825,399825,416015,412602,16190,16190,0,0,0,0
416269,fe758605-1871-891f-470f-057236ab058a,1,399892,399945,416269,408093,16324,16377,53,0,0,0
416351,4481c4d2-cef3-de42-9580-da3a97cf695f,1,399924,399945,416351,418570,16406,16427,21,0,0,0
416475,0326e324-6d22-7438-c65f-d9b060a9154d,1,399877,399885,416475,416327,16590,16598,8,0,0,0
416538,da702265-fb79-e367-3195-f73068344756,1,400197,400225,416538,414249,16313,16341,28,0,0,0
416619,1803e038-f55d-b579-2f7f-aa736a815581,1,400165,400165,416619,419067,16454,16454,0,0,0,0
416720,f7e04b1e-c41b-6e70-a276-4813660c3366,1,399923,399945,416720,421477,16775,16797,22,0,0,0
416750,c0135411-2650-899d-eb51-d5b401946e64,1,400276,400285,416750,413523,16465,16474,9,0,0,0
416831,018d6d94-4048-3826-8c12-22054fafd096,1,400459,400459,416831,412397,16372,16372,0,0,0,0
417106,e0ba46f3-feb7-bb5e-75bc-a0caf919db88,1,400790,400832,417106,410881,16274,16316,42,0,0,0
417334,07801bde-277d-6af9-3d86-c367502d3593,1,400772,400772,417334,411813,16562,16562,0,0,0,0
417486,0e6042fe-2a6f-7a09-a600-9174ab403ed7,1,400973,400973,417486,414742,16513,16513,0,0,0,0
417778,9ede807c-24f7-53a3-a83b-921238bc4ce7,1,401001,401033,417778,411275,16745,16777,32,0,0,0
417921,d583543a-3908-fe2c-00a7-60884ab04c4a,1,414111,414158,417921,417647,3763,3810,47,0,0,0
419122,66ce8d55-b2b6-fdf8-a999-ac1ae3e1f96b,8,393460,393460,419122,426401,25662,25662,0,0,0,0
419293,953a8bfb-e72a-6c39-f76a-e8a4162a8923,8,393469,393520,419293,409388,25773,25824,51,0,0,0
419507,c1d1a0f5-5e67-a69b-4707-3dc42186bfbd,1,412899,412899,419507,416954,6608,6608,0,0,0,0
419539,1d6a62d5-9c19-3073-edd8-b2daec6092bb,1,412899,412899,419539,417682,6640,6640,0,0,0,0
419513,ff23dc19-9787-5918-6369-9332fea32c75,1,412899,412899,419513,420193,6614,6614,0,0,0,0
419544,b9e32584-dd2f-8c09-00a6-2f7b1647a849,1,412899,412899,419544,418369,6645,6645,0,0,0,0
419508,a97db3d8-3f4e-9743-1fe7-600699904924,1,412899,412899,419508,419437,6609,6609,0,0,0,0
419537,bd8de700-1bd0-ad87-10bc-b6b81fd46e8e,1,412899,412899,419537,417657,6638,6638,0,0,0,0
419531,0514157c-6b7f-f1f1-fe29-fdca22589d3b,1,412899,412899,419531,421004,6632,6632,0,0,0,0
419515,a515b18d-1b10-114b-fa4c-dd81c1837629,1,412899,412899,419515,416211,6616,6616,0,0,0,0
419593,e533f1c5-d23e-b130-eb56-fde3d839ea8d,1,412900,412959,419593,422051,6634,6693,59,0,0,0
419593,d3f3cad9-188a-09eb-78ec-221bb6027a95,1,412900,412959,419593,420695,6634,6693,59,0,0,0
419603,dcad3105-5232-701e-d1e3-8b2654d697a8,1,412903,412959,419603,420329,6644,6700,56,0,0,0
419612,bbd6ef33-861f-cba0-f39f-e641377c15a4,1,412903,412959,419612,416515,6653,6709,56,0,0,0
419603,dc8c456b-268d-f887-6203-8741911ddf90,1,412903,412959,419603,420955,6644,6700,56,0,0,0
419612,2be1bb09-cc15-3371-14f6-95edd862fe2f,1,412903,412959,419612,418374,6653,6709,56,0,0,0
419605,f4184dc9-4964-41d1-7784-6e4a2f5dcc06,1,412903,412959,419605,417363,6646,6702,56,0,0,0
419606,e22b66d6-cc54-5012-92c7-83a0d6db086d,1,412904,412959,419606,422306,6647,6702,55,0,0,0
419605,5c854436-7b72-a711-8fb7-70b3571c7037,1,412904,412959,419605,416925,6646,6701,55,0,0,0
419664,2d4165f1-e1c9-db86-c55a-3f6cfabd2daa,1,412905,412959,419664,422681,6705,6759,54,0,0,0
419666,1056d60e-91da-3e74-104b-746f07d8db58,1,412906,412959,419666,422768,6707,6760,53,0,0,0
419666,35a3bfe3-0f56-816f-ff14-eeba27eb7195,1,412907,412959,419666,420037,6707,6759,52,0,0,0
419667,a4d4e6e4-b2f7-ef17-6b74-77dee67c55a3,1,412907,412959,419667,420182,6708,6760,52,0,0,0
419661,f460e485-61a7-442f-c772-e2ba9187f45a,1,412908,412959,419661,420676,6702,6753,51,0,0,0
419661,600d9638-d673-30bb-1901-66c2d67dcfed,1,412908,412959,419661,420091,6702,6753,51,0,0,0
419663,8bcfb847-72e6-c8fa-3d3e-6bfb01ddd4db,1,412910,412959,419663,418883,6704,6753,49,0,0,0
419720,849267cb-dff2-1807-2033-3e8151e745ff,1,412904,412959,419720,418480,6761,6816,55,0,0,0
424228,5cf2241f-5d22-68a4-442f-275546a3df9e,8,415063,415063,424228,427746,9165,9165,0,0,0,0
425471,bfd21111-94ab-b358-5120-8bbb987f9999,8,322976,322976,425471,414770,102495,102495,0,0,0,0
425727,4d2c0893-724d-dd1e-e2ca-eb651fc08d8f,8,416502,416535,425727,429035,9192,9225,33,0,0,0
425880,af058d4c-0f74-169a-4a1e-29ea72c827a0,8,323012,323036,425880,456960,102844,102868,24,0,0,0
426639,1a492555-2b89-24a1-2279-9225adb3a657,8,419138,419182,426639,428862,7457,7501,44,0,0,0
427622,e83f405a-144b-36f2-1e13-498e1f462f03,8,140858,140858,427622,325099,286764,286764,0,0,0,0
428943,1fe42cdc-0b9b-e349-31c0-8c108c7f6489,8,373863,373897,428943,431243,55046,55080,34,0,0,0
429160,9f420db4-80d8-7ed8-b410-f21fb94a6812,1,414103,414158,429160,434269,15002,15057,55,0,0,0
429248,f49657f8-7341-7e30-87a0-41f9ddd0375f,1,414102,414158,429248,422661,15090,15146,56,0,0,0
429379,b9257691-cca0-6420-28f4-07365b04ab99,8,417461,417514,429379,429634,11865,11918,53,0,0,0
429419,16f9d47e-7cd0-50b5-bc71-bba13627bf2a,1,414106,414158,429419,428998,15261,15313,52,0,0,0
429640,f8f15c22-8a22-d653-bda8-a949dacc2d1a,8,427017,427017,429640,430309,2623,2623,0,0,0,0
429861,6d61c2b7-db31-8c10-b9c2-d65b6c5aaa25,8,417945,417981,429861,428633,11880,11916,36,0,0,0
430612,dd42a08d-7a6b-6010-9fd3-05b006c38094,8,429885,429921,430612,430703,691,727,36,0,0,0
430777,f8852280-fcce-7798-fcbf-3589abe87e4e,1,414108,414158,430777,437555,16619,16669,50,0,0,0
430877,9d1fa859-91f3-aae2-714a-ceb8f1cace88,1,414107,414158,430877,424239,16719,16770,51,0,0,0
431158,f001877f-0794-bf3b-298e-a5e0747fee18,1,414110,414158,431158,423848,17000,17048,48,0,0,0
431360,13517fc4-fd6b-2de9-c13a-69b31dbea7d5,1,414106,414158,431360,439721,17202,17254,52,0,0,0
431423,ef5abd62-ed1f-db8f-1c11-a8e7d81ffc66,1,414111,414158,431423,435946,17265,17312,47,0,0,0
433033,1ffc2123-3fa3-3888-a42c-150f2d10b3d5,1,414098,414098,433033,436016,18935,18935,0,0,0,0
433074,3ff5e62f-6ae5-d025-d45b-a227b0d7d1dd,1,414098,414098,433074,433979,18976,18976,0,0,0,0
433051,df7e6540-4d9b-d420-2b7c-ede75ed29e43,1,414099,414158,433051,442281,18893,18952,59,0,0,0
433099,e0c15e14-f887-4da3-cd57-5a79cb17cec3,1,414098,414098,433099,432268,19001,19001,0,0,0,0
433118,3d390f79-2963-eb20-e423-90236c597f2e,1,414099,414158,433118,434948,18960,19019,59,0,0,0
433126,056760f8-0de9-b292-98b5-e7e188ef88f7,1,414099,414158,433126,440660,18968,19027,59,0,0,0
433094,5ddf2edd-4c9e-d793-d253-5dc264fc77c2,1,414099,414158,433094,432702,18936,18995,59,0,0,0
433118,5fe98889-7eef-8777-e1d4-bdef873f7749,1,414100,414158,433118,435637,18960,19018,58,0,0,0
433190,b8957c93-c28a-a3ec-1f0a-7308544b1a44,1,414101,414158,433190,438661,19032,19089,57,0,0,0
433192,b0b4f9ca-0175-c34a-b2fb-e76e01ff5912,1,414101,414158,433192,440292,19034,19091,57,0,0,0
433192,fc9fe716-230d-8139-b738-ff0adc7df2cf,1,414102,414158,433192,437204,19034,19090,56,0,0,0
433158,c6220c02-0227-e5cb-776d-5a7cf8f7b82c,1,414102,414158,433158,430619,19000,19056,56,0,0,0
433221,d9b833fd-0964-45f3-5f36-8532241939f4,1,414102,414158,433221,435293,19063,19119,56,0,0,0
434545,a1cacff1-d9e0-aaa9-7599-b3df889b2b65,8,390069,390069,434545,438208,44476,44476,0,0,0,0
434623,d1c8a66c-1ef3-d3ed-48ef-37f2dadecdfc,1,371941,371941,434623,428493,62682,62682,0,0,0,0
434643,56ef1586-1b12-9d36-6d90-cc3668026646,1,371941,371941,434643,465306,62702,62702,0,0,0,0
434732,1e3640b1-1742-b052-f01f-7382e4fa62c2,1,371943,372001,434732,450433,62731,62789,58,0,0,0
434861,7650be86-2538-5ee9-cd30-a6e4b1f80754,1,371939,371941,434861,441374,62920,62922,2,0,0,0
434903,0a44b9ff-133d-b01a-3ede-cbbeffb4a107,1,371933,371941,434903,428293,62962,62970,8,0,0,0
434972,7c017d36-7aad-2446-885c-48c6498a1ff6,1,371938,371941,434972,415495,63031,63034,3,0,0,0
435007,34ff2d85-6185-17bd-fca9-4d04b1dc0fe3,1,371943,372001,435007,420032,63006,63064,58,0,0,0
435082,186e8180-cec9-646b-bc92-379cba9a7c30,1,371932,371941,435082,426482,63141,63150,9,0,0,0
435072,88197b4c-4d54-7b96-0b8f-743d8007519f,1,371933,371941,435072,434081,63131,63139,8,0,0,0
435100,e6694f3f-8dbe-81e1-161a-a2030216d820,1,371934,371941,435100,446656,63159,63166,7,0,0,0
435062,1113e35f-22a2-ea1f-35c9-cdcff058a9dc,1,371937,371941,435062,419030,63121,63125,4,0,0,0
435052,0d95b5be-ceca-16ea-68ec-8182d68ef2d7,1,371938,371941,435052,459619,63111,63114,3,0,0,0
435079,461df9e4-18ae-0d77-8453-11fdf47a8193,1,371941,371941,435079,407664,63138,63138,0,0,0,0
435131,6af8ef62-d507-017f-e416-2f2ca28bc59f,1,371932,371941,435131,455743,63190,63199,9,0,0,0
435109,ecdc7b52-f1d3-ef7f-77d3-7567d8f26ed8,1,371933,371941,435109,451395,63168,63176,8,0,0,0
435122,d9486fd8-13d4-6c93-fbce-d554b4293a81,1,371938,371941,435122,413161,63181,63184,3,0,0,0
435179,466886d1-142e-e8fe-8256-fea784266a05,1,371933,371941,435179,455123,63238,63246,8,0,0,0
435178,b9f9dfbc-d9b0-4539-4549-991651f6800b,1,371933,371941,435178,442041,63237,63245,8,0,0,0
435208,3f92d258-4830-eb0d-156a-0e9a2f5680e2,1,371940,371941,435208,409052,63267,63268,1,0,0,0
435263,4740f073-7586-4f71-f457-302fa4897d75,1,371937,371941,435263,456679,63322,63326,4,0,0,0
435282,ff53d16a-a48c-6a92-6786-ef02b3c3fbf7,1,371938,371941,435282,403707,63341,63344,3,0,0,0
435327,35caa76d-f0c7-e1ea-1daa-b6ea3098a5fa,1,371938,371941,435327,419479,63386,63389,3,0,0,0
435444,9ca9257f-9c03-0e6d-93ef-3396a89b7c8a,1,371933,371941,435444,465696,63503,63511,8,0,0,0
435487,c5ce3692-6c53-3408-a8ce-e611604f29c2,1,371932,371941,435487,445768,63546,63555,9,0,0,0
435607,d04a2fb5-8172-1148-b000-13c5769cfef7,1,371936,371941,435607,432767,63666,63671,5,0,0,0
436070,c96ec149-1355-0472-e65f-5c59913406a4,8,435156,435161,436070,435749,909,914,5,0,0,0
437060,071d06cd-ad4d-758f-dffb-285fad8a19d7,8,434051,434051,437060,437077,3009,3009,0,0,0,0
437858,954134c7-68c3-2600-b173-e3150fc44567,8,436683,436683,437858,438180,1175,1175,0,0,0,0
438287,5e2bcab9-c102-0fc8-d637-7a84cefa8037,8,437282,437282,438287,438225,1005,1005,0,0,0,0
439594,d1748912-7794-e58e-8b5b-bbfdcdc54cae,8,432379,432418,439594,437270,7176,7215,39,0,0,0
439630,b0b60d86-1dca-52f8-c3bb-526b430538f2,8,432388,432418,439630,437066,7212,7242,30,0,0,0
439687,1cd98e6b-3a0d-3859-82e8-67554ba74d82,8,432397,432418,439687,436896,7269,7290,21,0,0,0
441270,e5ceac23-aff7-188d-eada-d07f2d6b89e7,1,371522,371581,441270,425160,69689,69748,59,0,0,0
441385,4a0fc88c-7fb0-b337-b96d-3eb3371367e3,1,371522,371581,441385,445738,69804,69863,59,0,0,0
441653,10da6403-6af3-a358-3610-0ed542e13bc8,1,371530,371581,441653,468638,70072,70123,51,0,0,0
441655,7845e0ff-9581-c2f1-b4a9-fe0b5b407ea1,1,371521,371521,441655,439572,70134,70134,0,0,0,0
441706,219a0e64-3c5c-b061-5be3-c6970e1856db,1,371522,371581,441706,440123,70125,70184,59,0,0,0
441762,966a66e9-8811-f899-46bf-8daf71f4d6ed,1,371525,371581,441762,408146,70181,70237,56,0,0,0
441726,edd0a30f-b55b-f7df-44d6-35b5a8139699,1,371526,371581,441726,475826,70145,70200,55,0,0,0
441774,c218d089-1a4b-18c0-3ed1-d993851987ab,1,371527,371581,441774,451813,70193,70247,54,0,0,0
441774,d6e9e765-8edb-e792-4fd8-06d8e458e273,1,371529,371581,441774,434390,70193,70245,52,0,0,0
441962,44c56f4c-d4c7-05a9-39fb-aff28fa031f8,1,371525,371581,441962,453811,70381,70437,56,0,0,0
442016,0627f5ac-9faa-f465-afe1-b9e375396a00,1,371521,371521,442016,442618,70495,70495,0,0,0,0
441991,4f2a32f9-0872-4db8-42fe-df5f7e9fa5dc,1,371526,371581,441991,465966,70410,70465,55,0,0,0
442076,b2416aed-fe3d-c3e5-8cdd-fdd5c8256291,1,371525,371581,442076,436268,70495,70551,56,0,0,0
442029,233e1589-58ac-4a0e-d6d2-34b469f760ae,1,371526,371581,442029,432537,70448,70503,55,0,0,0
442051,45cd0c41-c57b-f7e4-05a0-476ca238df16,1,371527,371581,442051,432306,70470,70524,54,0,0,0
442052,f1bdddd4-9eea-f708-f96f-6c07fa3b829f,1,371529,371581,442052,461314,70471,70523,52,0,0,0
442043,406996a0-437a-5b1c-1652-6a596d577ccc,1,371530,371581,442043,416161,70462,70513,51,0,0,0
442134,1de14ac0-b993-2694-21e5-85be23f5b1b9,1,371521,371521,442134,448072,70613,70613,0,0,0,0
442137,1ab6d603-ffb7-e2f0-17e2-6f5cb26c1757,1,371522,371581,442137,439772,70556,70615,59,0,0,0
442128,4c52d3ca-e6f3-c4c8-471f-e3d9b0105ccd,1,371524,371581,442128,456349,70547,70604,57,0,0,0
442237,021903cf-b5c4-96b2-e529-5788fbb60d99,1,371521,371521,442237,458566,70716,70716,0,0,0,0
442239,99ba118b-7e5e-212d-6f25-222ddd6f0420,1,371523,371581,442239,411132,70658,70716,58,0,0,0
442313,5798db52-cbf8-2f53-4f16-91a410837e3a,1,371523,371581,442313,439307,70732,70790,58,0,0,0
442313,4a54a5f3-3d3d-4d08-7e5a-86ad2f8611d5,1,371525,371581,442313,465848,70732,70788,56,0,0,0
442269,4165406c-d5a8-f2bc-9f4c-028ec05a2e08,1,371530,371581,442269,427480,70688,70739,51,0,0,0
442971,ed850f27-40af-4998-a154-acf2ce331d81,8,432409,432418,442971,447623,10553,10562,9,0,0,0
442971,e71bef25-7f5f-7a16-158e-d5c101fdc5af,8,432416,432418,442971,445207,10553,10555,2,0,0,0
442988,2363ffd7-f645-fab6-ffea-e7f5c3d5aee0,8,432424,432478,442988,443426,10510,10564,54,0,0,0
444014,c195842c-ed8a-ad7e-08f1-651410160de4,8,398437,398437,444014,436328,45577,45577,0,0,0,0
444088,9bd179d6-4fc4-c893-67bc-de05e3fb18a3,8,398267,398308,444088,449631,45780,45821,41,0,0,0
444123,72f1e739-c1ae-ebca-da38-38bbc351999e,8,398258,398308,444123,461623,45815,45865,50,0,0,0
444246,1075f5ed-1c23-6b9a-6019-19170e74e3df,8,398248,398248,444246,450653,45998,45998,0,0,0,0
444338,0442e80b-48d7-234c-a5dd-05313b200dc9,8,398013,398013,444338,447710,46325,46325,0,0,0,0
444429,60e1ced7-64cd-53f0-3818-5ffb2295f29d,8,398447,398497,444429,445590,45932,45982,50,0,0,0
444769,a7e84991-ba97-1ae8-5446-4f1f198fecf0,8,398461,398497,444769,428008,46272,46308,36,0,0,0
444877,ecedc78b-1ce1-c6f0-2237-d235a38d188b,8,440475,440475,444877,443770,4402,4402,0,0,0,0
444915,ad5a4a37-4eea-696c-ed54-3aa02c3be788,8,440481,440535,444915,446615,4380,4434,54,0,0,0
444938,9ccee93c-5e51-4265-b6b3-c921e074cf5a,8,440477,440535,444938,446401,4403,4461,58,0,0,0
445562,0d92c5bf-0bd2-a470-da2c-8e5baefae7b6,8,431204,431218,445562,438610,14344,14358,14,0,0,0
446040,ff570304-7c14-e62e-f0e4-2289a2df2c60,8,413023,413023,446040,455947,33017,33017,0,0,0,0
446280,7b70a734-333a-2009-8ed7-c6e6b5456648,8,432450,432478,446280,443462,13802,13830,28,0,0,0
446330,2284bca3-f2fe-cdde-8cd6-8440b801a813,8,432433,432478,446330,450350,13852,13897,45,0,0,0
446377,b614c52a-5ab6-4d5c-e556-7d9bbf9adb75,8,432441,432478,446377,439966,13899,13936,37,0,0,0
446699,1a735d49-e75f-c829-a16d-fae69e51e399,1,445374,445374,446699,446572,1325,1325,0,0,0,0
446732,60a75fb5-bf0a-8f68-998b-64161f846af3,1,445401,445434,446732,446124,1298,1331,33,0,0,0
446724,833e7942-d778-4f4d-0a7a-bcd3a5587878,1,445404,445434,446724,446670,1290,1320,30,0,0,0
446703,04c78f58-12b2-eb13-dabe-c72a5ed0a072,1,445406,445434,446703,446635,1269,1297,28,0,0,0
446797,ac5d3cf5-7b01-2a15-8c29-5915487dea2b,1,445518,445518,446797,447007,1279,1279,0,0,0,0
446799,49c7f370-f785-e007-0c64-17778c2dbd72,1,445561,445578,446799,447086,1221,1238,17,0,0,0
446840,77fd35a0-afc9-4350-5fcf-324f01c5380e,1,438846,438904,446840,443453,7936,7994,58,0,0,0
446966,91c1649f-4a26-15c0-e69f-777e75fce80c,1,438850,438904,446966,444723,8062,8116,54,0,0,0
446979,c11fda29-debd-f53c-d032-306158d24990,1,438846,438904,446979,446428,8075,8133,58,0,0,0
447010,d2d9eb0d-b366-82e6-d4f2-0774156c1280,1,438847,438904,447010,448351,8106,8163,57,0,0,0
446999,1b4b41ec-713d-d54e-12ea-1618e28d3518,1,445404,445434,446999,447716,1565,1595,30,0,0,0
446981,3fda8388-751f-8769-933e-0e04c10a59d2,1,445405,445434,446981,446506,1547,1576,29,0,0,0
447244,a001ce13-8729-302a-2178-3ec8785bb210,1,445607,445638,447244,446981,1606,1637,31,0,0,0
447709,89e88154-9340-de4b-286d-17da29e0a292,1,438688,438747,447709,449778,8962,9021,59,0,0,0
447724,4c3fe94f-c4a9-a7c5-9797-5b0b324b2851,1,438691,438747,447724,447989,8977,9033,56,0,0,0
447794,7f140af5-6bb4-420a-71f6-a9b6ca8304bf,1,438688,438747,447794,444004,9047,9106,59,0,0,0
447808,0f3e4ec4-90d9-8e1b-2ba1-a7a18c7e6fb7,1,438691,438747,447808,450033,9061,9117,56,0,0,0
447800,ef2fbbb3-52e1-70ab-fd71-9fe2c1967fa6,1,438692,438747,447800,451884,9053,9108,55,0,0,0
447794,7f815a33-1ac7-6e05-d692-936cd9ecbdef,1,438693,438747,447794,447730,9047,9101,54,0,0,0
447832,94c1b7d4-93c6-6baf-e6ba-51826592d015,1,438687,438687,447832,445954,9145,9145,0,0,0,0
447884,818b4ed4-7fa4-d8ff-c225-5b2c37f81f31,1,438688,438747,447884,450319,9137,9196,59,0,0,0
447885,01775527-dfac-679b-7868-27f247e9f13f,1,438688,438747,447885,445719,9138,9197,59,0,0,0
447859,22ad47e8-2e7c-21c0-a205-e9c1af866d97,1,438691,438747,447859,450167,9112,9168,56,0,0,0
447852,6ac84e62-bc94-a17c-cc8d-63948b321356,1,438692,438747,447852,444556,9105,9160,55,0,0,0
447937,af4b354c-3b1b-f801-2b76-cafc3ff466c3,1,438687,438687,447937,443789,9250,9250,0,0,0,0
447929,09faa93e-23ed-dca2-1e6e-b157d27a6092,1,438687,438687,447929,447404,9242,9242,0,0,0,0
447892,915213e8-2cb4-dc34-6fde-d069d633b48c,1,438688,438747,447892,448012,9145,9204,59,0,0,0
447903,99e386fd-75d5-0d77-b950-3be207a75ee9,1,438691,438747,447903,448710,9156,9212,56,0,0,0
447990,2be9cf5e-c185-e76b-76cc-4aa5afe0558c,1,438688,438747,447990,443988,9243,9302,59,0,0,0
448009,6ae2ab28-d029-91d9-dc33-c99b18b67fb4,1,438690,438747,448009,444302,9262,9319,57,0,0,0
447999,2de1b82e-c91b-a264-c90c-8904e47dd05e,1,438691,438747,447999,449318,9252,9308,56,0,0,0
447983,f8c43847-5d44-b558-f1c5-24a83cfbdc82,1,438693,438747,447983,449895,9236,9290,54,0,0,0
448030,c2789b0f-4299-057d-ab17-eb1829dc5cba,1,438687,438687,448030,450759,9343,9343,0,0,0,0
448658,24f82a96-b995-30cf-75cd-9559222e34e7,8,440951,440996,448658,446240,7662,7707,45,0,0,0
448673,67b988f6-260d-df70-0b40-750fd221cdde,8,440943,440996,448673,446172,7677,7730,53,0,0,0
448686,e1213c03-779e-e8de-237a-66a84d4e7af1,1,438845,438904,448686,449719,9782,9841,59,0,0,0
448774,d131276b-012d-9ebf-69e8-d1d3d99cb917,1,438845,438904,448774,450054,9870,9929,59,0,0,0
448823,361f83da-c6ed-940c-ab48-df2e8d5dbc9f,1,438844,438844,448823,446893,9979,9979,0,0,0,0
448806,b3f9ce12-8178-1648-966d-6eb41f949a11,1,438846,438904,448806,445237,9902,9960,58,0,0,0
448833,b8c20889-0055-b7d8-5a0c-2aac165d4c7a,1,438857,438904,448833,449229,9929,9976,47,0,0,0
448833,78df0f95-74ca-3720-6f4e-0e9f06a894f5,1,438858,438904,448833,448253,9929,9975,46,0,0,0
448812,58667341-4174-d7e9-e76e-6aacf3b89516,1,438859,438904,448812,445351,9908,9953,45,0,0,0
448847,7b16a649-fcac-48fd-0474-776bb4c5d469,1,438846,438904,448847,447292,9943,10001,58,0,0,0
448841,63c4722c-27f3-b303-74a7-c15b161fc0eb,1,438852,438904,448841,444664,9937,9989,52,0,0,0
448887,21f69c30-c293-8347-2127-52587e05d727,1,438852,438904,448887,453490,9983,10035,52,0,0,0
448885,ba68d886-8ce1-6d40-f8f9-08e5821f6689,1,438852,438904,448885,448748,9981,10033,52,0,0,0
448912,ecd194fc-4845-ac27-06e3-8d30b5184d1c,1,438850,438904,448912,451286,10008,10062,54,0,0,0
448940,3efebc12-55d6-3279-3459-f7526d75c096,1,438851,438904,448940,449718,10036,10089,53,0,0,0
448930,3ba1e0f0-d75f-36ef-35a7-da659f690e9c,1,438856,438904,448930,447345,10026,10074,48,0,0,0
448969,7eb674f0-9c1b-6efa-3738-a63fc212798d,1,438846,438904,448969,445272,10065,10123,58,0,0,0
449019,64f49e7a-1305-b643-c261-f93fc65c0c2a,1,438846,438904,449019,447277,10115,10173,58,0,0,0
449367,91e62df6-9435-6b94-2a40-49d282033ec2,1,443602,443602,449367,449644,5765,5765,0,0,0,0
450552,00421dd9-14c7-faa6-c4c9-921c0060566b,1,449249,449249,450552,450248,1303,1303,0,0,0,0
450862,0a551c67-1986-4475-a030-25d8b84ac398,1,449273,449309,450862,450544,1553,1589,36,0,0,0
451124,8b4ad625-6977-2fbc-263d-9cae86863614,8,411167,411167,451124,455390,39957,39957,0,0,0,0
451198,7e2a9ced-8a27-527c-3e77-5b7f8b4db6dc,1,449544,449566,451198,451411,1632,1654,22,0,0,0
451222,0cb532db-362a-135b-14fd-eea1909d711a,8,411175,411227,451222,449147,39995,40047,52,0,0,0
451662,905f4447-023a-793f-1699-3c9f23c18741,1,445101,445156,451662,449454,6506,6561,55,0,0,0
451665,088ae658-c363-a714-2280-88299b559dd2,1,445096,445096,451665,453557,6569,6569,0,0,0,0
451717,73067e2d-af92-47bf-0286-78bbc7c4d17c,1,445097,445156,451717,448877,6561,6620,59,0,0,0
451716,603af460-ebf2-b573-86eb-5e3ad2e673ec,1,445097,445156,451716,451301,6560,6619,59,0,0,0
451707,0d5ee78a-ae18-1853-5ae5-01caf59ff3b4,1,445098,445156,451707,451629,6551,6609,58,0,0,0
451697,f5771042-e185-5e53-2123-1f2881ab5333,1,445101,445156,451697,453882,6541,6596,55,0,0,0
451705,d498b88b-5145-1785-aaf4-fd66163d0b23,1,445102,445156,451705,448490,6549,6603,54,0,0,0
451703,37b678c4-63bd-994c-505f-1c4d180453a0,1,445102,445156,451703,452284,6547,6601,54,0,0,0
451775,96f4159b-d347-5526-e479-91025cf30d10,1,445097,445156,451775,452133,6619,6678,59,0,0,0
451767,107983c6-5ee2-7a01-cd6f-4850df2b399a,1,445097,445156,451767,450166,6611,6670,59,0,0,0
451758,2dca3284-1b4a-c270-5d07-03eff60fabc9,1,445097,445156,451758,449489,6602,6661,59,0,0,0
451765,09263b94-0ceb-27bb-a6c8-1eb6b2c4af8f,1,445097,445156,451765,453492,6609,6668,59,0,0,0
451750,2b0e57a7-98b9-8619-0ae5-3849f804ab4d,1,445098,445156,451750,448696,6594,6652,58,0,0,0
451758,2239ee12-e930-aafd-7390-769630a2deff,1,445098,445156,451758,454691,6602,6660,58,0,0,0
451752,fd28ce09-cbf1-2ed9-833c-ffab22e6942f,1,445100,445156,451752,453905,6596,6652,56,0,0,0
451750,904435ef-ac9d-18ef-14c6-423e72b3f2cc,1,445100,445156,451750,451608,6594,6650,56,0,0,0
451735,ec3abe85-cd36-7475-4408-67c1e622f49a,1,445102,445156,451735,452440,6579,6633,54,0,0,0
451736,e2f05684-3280-d327-7da7-23ed01a92ba9,1,445105,445156,451736,450895,6580,6631,51,0,0,0
451795,875757c9-7691-e40a-2e19-418f95400277,1,445101,445156,451795,454099,6639,6694,55,0,0,0
451828,81c7f339-0a08-39da-dcbe-07f5db53927e,1,445102,445156,451828,452583,6672,6726,54,0,0,0
452121,98c6c1a7-7318-1f22-ad78-31a0133859c1,8,440960,440996,452121,448443,11125,11161,36,0,0,0
452114,a8f53197-111c-55db-dc8a-bf51ac8e474a,8,440969,440996,452114,452004,11118,11145,27,0,0,0
452102,e05ef84f-05f9-91d7-86c1-f3a51a918771,1,450772,450772,452102,452416,1330,1330,0,0,0,0
453329,092779d4-bec5-5cab-d849-4b7618863eb1,8,429522,429522,453329,442087,23807,23807,0,0,0,0
453715,cd5afc3f-d06b-ddc5-4757-b52b2a28e8cd,1,452378,452378,453715,453756,1337,1337,0,0,0,0
453988,87eb1667-2060-e2d7-7d1e-9ee785af5b2c,1,452953,452953,453988,454332,1035,1035,0,0,0,0
455583,35af685f-c88c-e028-818e-12e27146cffe,8,440978,440996,455583,459326,14587,14605,18,0,0,0
455688,c5e3f524-41dd-d517-6192-023b91426c7d,8,440986,440996,455688,460240,14692,14702,10,0,0,0
456082,7162ef9f-2f40-e722-1c7d-a3b318f23779,8,327319,327319,456082,494107,128763,128763,0,0,0,0
457260,496bd174-e6ee-e64f-0bf2-feaad3a9ba8d,8,432298,432298,457260,444855,24962,24962,0,0,0,0
457274,c2255913-7779-bb5b-f297-de6adeb86e1b,8,432307,432358,457274,458812,24916,24967,51,0,0,0
461284,e82ccfd9-b1d5-aea5-43e6-b71f38f230b1,8,459370,459393,461284,460997,1891,1914,23,0,0,0
461289,a69fd885-e572-416e-64a5-3f5e0a2f6f9b,8,459359,459393,461289,461116,1896,1930,34,0,0,0
463930,0c4e8447-95cb-97fc-54fa-b32c0b7af0b1,1,444989,444997,463930,471033,18933,18941,8,0,0,0
463957,7611a3cb-c18b-91ec-7f9b-574d4f206ebe,1,444986,444997,463957,471829,18960,18971,11,0,0,0
463974,021f3310-cac5-c483-df81-f4bcc657eefc,1,444988,444997,463974,465022,18977,18986,9,0,0,0
463980,bceeacdd-7ded-74db-66c8-47022b9f9711,1,444992,444997,463980,459451,18983,18988,5,0,0,0
464030,e1c1fba2-015e-560f-01d2-d6d90cd24fdd,1,444987,444997,464030,469400,19033,19043,10,0,0,0
464012,cf7859eb-ebef-7531-89ae-9834a3d9653a,1,444989,444997,464012,465084,19015,19023,8,0,0,0
464006,6fe7899b-8068-684d-d555-c60a5fe9798c,1,444989,444997,464006,462455,19009,19017,8,0,0,0
464014,c35422f5-faa0-1764-c657-c1b80e29c12e,1,444989,444997,464014,471763,19017,19025,8,0,0,0
464012,bb4e4862-7d35-ec33-456e-bbb182b55700,1,444989,444997,464012,463231,19015,19023,8,0,0,0
464039,5fc02441-57aa-5ae5-ecf5-497eb38a5783,1,444994,444997,464039,454521,19042,19045,3,0,0,0
464040,81880021-984d-cca2-4119-2e850b66c0de,1,444996,444997,464040,465299,19043,19044,1,0,0,0
464097,1d01e1ac-bd4b-dbf2-59c6-29bf49621035,1,444988,444997,464097,472722,19100,19109,9,0,0,0
464061,3b973cd8-348d-d05d-79d2-12f31e1a899c,1,444988,444997,464061,457199,19064,19073,9,0,0,0
464096,166da6ec-ac56-0358-d2c8-76f2cffdec76,1,444990,444997,464096,455588,19099,19106,7,0,0,0
464086,dea3352b-f6f5-e6d1-c5f2-b7ac40ccf2e8,1,444992,444997,464086,454925,19089,19094,5,0,0,0
464086,e0b79d4f-e00f-a28c-405c-1d50a3562ae7,1,444993,444997,464086,461332,19089,19093,4,0,0,0
464077,9e3208ec-e2c3-753d-12af-dd8607f1d9bf,1,444994,444997,464077,468021,19080,19083,3,0,0,0
464169,9a123b42-ed3f-42a6-18a1-d95a95694427,1,444988,444997,464169,467375,19172,19181,9,0,0,0
464150,f70742dd-b847-0eb8-816e-49e90ae5f73f,1,444989,444997,464150,455591,19153,19161,8,0,0,0
464123,f91b43c6-2ac6-4f88-d18c-6ab948a0e962,1,444992,444997,464123,470011,19126,19131,5,0,0,0
464114,a36893cd-1bc2-ed35-2ce7-a7929676d313,1,444993,444997,464114,461681,19117,19121,4,0,0,0
464114,474cd1a1-b60f-1d69-5d05-0f7045cb86d6,1,444994,444997,464114,464982,19117,19120,3,0,0,0
464221,92b7e5e7-db53-a4e4-77fa-1ea1f7618aab,1,444987,444997,464221,462641,19224,19234,10,0,0,0
464213,06111161-d089-f2ad-aa99-d68290450a45,1,444988,444997,464213,455684,19216,19225,9,0,0,0
464205,70d95dd6-c5f0-dfb3-1ff2-ca834a78ffe0,1,444990,444997,464205,462702,19208,19215,7,0,0,0
464960,eefaacd2-6263-e8fd-6159-cf7f8be0685e,1,445112,445156,464960,466556,19804,19848,44,0,0,0
465026,9d9d817c-56f0-0bd9-8f11-3c8d446fd414,1,445110,445156,465026,455308,19870,19916,46,0,0,0
465046,b7427eb6-154f-8243-5bc7-5849a20fcc8f,1,445104,445156,465046,464907,19890,19942,52,0,0,0
465045,7cd5f6c1-2c91-bf45-a83c-4984f0270274,1,445110,445156,465045,466146,19889,19935,46,0,0,0
465034,9784905e-f390-4b98-3577-07f6ec2932eb,1,445111,445156,465034,461627,19878,19923,45,0,0,0
465066,1627e3cf-2825-a04b-1845-421fee71a35e,1,445111,445156,465066,470720,19910,19955,45,0,0,0
465120,4309b117-3590-e2e6-67be-791a11d61455,1,445105,445156,465120,463658,19964,20015,51,0,0,0
465146,25d8fe0f-c48d-2648-26bf-9e73aab9dc4f,1,445106,445156,465146,464383,19990,20040,50,0,0,0
465125,7907e1a2-6055-b448-9a30-19af1fe65efe,1,445110,445156,465125,455701,19969,20015,46,0,0,0
465156,9c71aebd-b725-f18d-9224-e4279f053fa7,1,445105,445156,465156,463976,20000,20051,51,0,0,0
465182,da798e97-b612-875d-8e9e-ed95d47e2d34,1,445105,445156,465182,463957,20026,20077,51,0,0,0
465147,5103c95d-e1fc-0ced-9baf-a427732198d9,1,445105,445156,465147,461531,19991,20042,51,0,0,0
465175,53df7070-1ba6-b2ce-99b0-b51f65f85154,1,445106,445156,465175,461188,20019,20069,50,0,0,0
465175,9f7c7704-8854-5a0d-d5ef-6f496fd90254,1,445108,445156,465175,470016,20019,20067,48,0,0,0
465203,6fde7d31-4171-7646-fa3d-ddc0fcf8afa1,1,445113,445156,465203,456128,20047,20090,43,0,0,0
465214,19013e36-c7a8-c499-0495-845bbd5e628b,1,445106,445156,465214,461330,20058,20108,50,0,0,0
465214,7fe3aa6e-a4c1-dd96-499b-11896033f6a1,1,445107,445156,465214,465667,20058,20107,49,0,0,0
465256,bbb51d4b-742b-1e85-40da-438d171d28b0,1,445110,445156,465256,467812,20100,20146,46,0,0,0
465254,7862fa7d-4138-5321-2c11-e260f74fe2b9,1,445111,445156,465254,457911,20098,20143,45,0,0,0
465246,921424e3-ffe1-d65a-daff-e5fa07663276,1,445112,445156,465246,465742,20090,20134,44,0,0,0
465224,901c3aa6-cc54-02b4-b203-60ba63ed8c86,1,445116,445156,465224,462222,20068,20108,40,0,0,0
465434,4a0699bf-6a0c-2ea0-f526-6f56b6835195,1,445116,445156,465434,457624,20278,20318,40,0,0,0
465462,5b01939f-05c2-d34d-a979-0968a3429321,1,445115,445156,465462,455977,20306,20347,41,0,0,0
465502,c790396a-4529-d779-3eef-94c631c64655,1,445115,445156,465502,455396,20346,20387,41,0,0,0
465497,7f69eb95-fec1-afaa-4fcd-c795e8e525e3,1,445116,445156,465497,468571,20341,20381,40,0,0,0
466464,55345db3-b4a8-486c-3655-c0ac686b797f,1,449506,449506,466464,461329,16958,16958,0,0,0,0
466530,9b86f765-bde9-daf3-22aa-1291b174ced1,1,450043,450043,466530,462366,16487,16487,0,0,0,0
466899,4f491f7c-646d-e4b5-93d2-f0f6aaa1e87b,1,450101,450103,466899,464298,16796,16798,2,0,0,0
467132,46b3d9a2-2b84-254a-4167-b8dd9a35accb,1,450822,450832,467132,468048,16300,16310,10,0,0,0
467139,7f9131c2-d67a-f5b3-4e72-f8567d0b4da8,1,450443,450445,467139,461505,16694,16696,2,0,0,0
467231,009e9ed2-ed0e-9484-91b5-6e0b5f0a41ed,1,450325,450325,467231,462925,16906,16906,0,0,0,0
467303,5fa59e42-57eb-1444-b3f6-5cebf95440bd,1,450371,450385,467303,474709,16918,16932,14,0,0,0
467322,7ae9993c-7cd2-e3ed-81a5-19492a6e0b4c,1,450816,450832,467322,471076,16490,16506,16,0,0,0
467352,dabba049-ea17-25be-c0bd-78d89b0067c6,1,450938,450952,467352,463947,16400,16414,14,0,0,0
467674,4c296360-a4ee-8024-41bb-09ebd8cb2943,1,451326,451326,467674,467405,16348,16348,0,0,0,0
468110,3f8d50a6-b90b-ba39-7dad-0327cc581b77,1,451930,451930,468110,462854,16180,16180,0,0,0,0
468380,e4c4cc4c-61a2-eb14-a491-8bd2e79398c7,1,452068,452068,468380,468889,16312,16312,0,0,0,0
468483,95018a74-f0e1-aea0-8f2e-6ee0c22d5a6e,1,451933,451990,468483,467594,16493,16550,57,0,0,0
468724,688c82c5-a711-9205-2657-4da418900054,1,452546,452546,468724,465170,16178,16178,0,0,0,0
468907,ae421baa-aecf-2f69-bef2-00aaf114f774,1,452154,452188,468907,467432,16719,16753,34,0,0,0
469009,d00fdb10-18ca-4e7e-e818-93c741d02f19,1,452631,452631,469009,470292,16378,16378,0,0,0,0
469307,2fbb6758-6aee-bd20-fde7-58c75a32dd3f,1,452878,452878,469307,464443,16429,16429,0,0,0,0
469735,6f05dcb5-b84c-8ce6-dedc-71d28eaa683b,1,424770,424770,469735,487706,44965,44965,0,0,0,0
469944,32d157a8-4390-37e8-5ee8-3986bdcc0eeb,1,453514,453550,469944,463629,16394,16430,36,0,0,0
470031,d7b5c56b-9a03-83fc-f641-45d0ead987e2,1,453436,453490,470031,463044,16541,16595,54,0,0,0
470084,0a34e33e-a037-46f2-19fd-67b2d0907cdd,1,453536,453550,470084,476400,16534,16548,14,0,0,0
470367,0cdf1163-502f-5b2a-fca8-4da249cdfd14,1,454346,454376,470367,475070,15991,16021,30,0,0,0
470586,e5074961-e30c-efb7-1f92-aab2a565745c,1,453430,453430,470586,466444,17156,17156,0,0,0,0
470657,de8427be-3383-1088-dfbc-bc9faaa8e791,1,464201,464230,470657,468394,6427,6456,29,0,0,0
470705,985654c5-b9ec-2a27-8a4b-83d1b0c65f67,1,454196,454196,470705,467883,16509,16509,0,0,0,0
470689,e949f57a-cefd-ea3f-f222-611505de8976,1,464200,464230,470689,473303,6459,6489,30,0,0,0
470689,58111179-d630-5b45-f7cc-bee9c9275407,1,464201,464230,470689,467410,6459,6488,29,0,0,0
470691,30158278-198f-2ed1-92e9-06548f03e621,1,464205,464230,470691,472215,6461,6486,25,0,0,0
470735,a11274c3-69af-4fdc-3400-3a994113a8ca,1,464200,464230,470735,471501,6505,6535,30,0,0,0
470719,a7acc549-247f-ca51-4feb-f36095857083,1,464201,464230,470719,472799,6489,6518,29,0,0,0
470775,9e0bea8f-729f-8013-88bb-6a9c1b980fd5,1,464202,464230,470775,471726,6545,6573,28,0,0,0
470774,5fe5071b-d214-7f37-1c44-6f27a8024eb6,1,464202,464230,470774,468217,6544,6572,28,0,0,0
470731,41735d0e-4c51-2513-b2b2-785664fb8319,1,464203,464230,470731,467771,6501,6528,27,0,0,0
470731,4c66da55-8d78-8bd0-cb9f-d9ae07150540,1,464204,464230,470731,467975,6501,6527,26,0,0,0
470766,5f6ab338-057a-4d53-6afc-df872e3fa03a,1,464204,464230,470766,473758,6536,6562,26,0,0,0
470774,b7c39b3f-b9c1-035c-207a-e78426409626,1,464208,464230,470774,472544,6544,6566,22,0,0,0
470775,559306bb-099b-4746-1540-3212e0f43a98,1,464208,464230,470775,472850,6545,6567,22,0,0,0
470823,ddbbf6e3-2591-1040-b902-7e9ae79a71c2,1,464203,464230,470823,467706,6593,6620,27,0,0,0
470813,93c6fffe-53ce-c5c5-8810-a1ff0e0ba330,1,464205,464230,470813,472401,6583,6608,25,0,0,0
470814,6846ebe8-4039-f216-6354-99763d2e029f,1,464206,464230,470814,471037,6584,6608,24,0,0,0
470807,a4aa440f-74db-5194-9d5e-8f2c39240e23,1,464208,464230,470807,472355,6577,6599,22,0,0,0
470814,79809bc7-f372-59ae-db19-b4bc45ee2609,1,464208,464230,470814,468688,6584,6606,22,0,0,0
470843,91186af4-1a2f-51dd-ce40-9d7575cf289b,1,464206,464230,470843,472141,6613,6637,24,0,0,0
470903,107bde00-b572-cd3d-6a6e-26df6fcdef95,1,464204,464230,470903,470755,6673,6699,26,0,0,0
477325,06a35572-9c85-a324-e478-2698e4562787,1,476417,476452,477325,477154,873,908,35,0,0,0
478205,009af9ba-8015-3e13-b4e4-9cb1966a58d6,1,476397,476452,478205,478692,1753,1808,55,0,0,0
478289,93a65b82-1e63-3712-5fcc-2ef7ba141188,1,476406,476452,478289,479112,1837,1883,46,0,0,0
478782,57c3add6-83d3-2337-6ec4-26c116279342,1,476412,476452,478782,479102,2330,2370,40,0,0,0
479245,702ae3c2-6ae9-37cb-968f-140249c90d5f,1,476408,476452,479245,479637,2793,2837,44,0,0,0
479268,c1754cf3-3241-f4f0-0ab6-a7eda7fdbdd1,1,476398,476452,479268,478163,2816,2870,54,0,0,0
479455,3650bd70-dcd3-e76f-3956-6917ce140830,1,476428,476452,479455,478324,3003,3027,24,0,0,0
479459,a8d2a8a6-1d88-cbe4-3a26-318c2def9c1d,1,476433,476452,479459,480362,3007,3026,19,0,0,0
479739,f546aabc-f61d-39e3-358f-4c9cdc7894ba,1,476426,476452,479739,480885,3287,3313,26,0,0,0
480416,1c036ebe-4384-0061-2e9f-59935c8bfec4,1,476433,476452,480416,480957,3964,3983,19,0,0,0
480577,1af64451-efb1-398b-878d-2cfa7d1c493c,1,476436,476452,480577,480524,4125,4141,16,0,0,0
481983,f24bc2c0-c5f8-fded-28ca-9023667693ab,8,459369,459393,481983,487558,22590,22614,24,0,0,0
484951,31490475-e5b2-7ed0-10a0-cd0fb4e91064,1,476427,476452,484951,483018,8499,8524,25,0,0,0
485759,49ad5cbb-7322-b792-cf94-9b7d7ca26cba,1,485083,485083,485759,485716,676,676,0,0,0,0
485780,bc194683-d987-e067-112d-b7de565ae02f,1,485092,485143,485780,485539,637,688,51,0,0,0
485807,077d5caf-8a1c-a3a8-dc4e-03c1fd2cadc5,1,485100,485143,485807,485490,664,707,43,0,0,0
485804,f20eda5a-5f7a-0611-300e-aba654032982,1,485108,485143,485804,485742,661,696,35,0,0,0
485785,661e0f0e-ee10-f503-7766-ab44b2ca0644,1,485114,485143,485785,485686,642,671,29,0,0,0
485806,65108131-d0c3-1c50-29f3-18cfc359a437,1,485119,485143,485806,485680,663,687,24,0,0,0
485807,59e4d312-faa1-ffb0-5021-6737b2e17215,1,485120,485143,485807,485602,664,687,23,0,0,0
485812,ca696526-c810-88d8-9398-06fa239c65ff,1,485185,485203,485812,485494,609,627,18,0,0,0
485864,f78ebdb1-743d-f59d-233c-c28756aafa64,1,484607,484607,485864,486166,1257,1257,0,0,0,0
485864,8198e919-bbd3-361d-7a04-8ced5081a400,1,485094,485143,485864,486136,721,770,49,0,0,0
485849,6ff4d125-b12a-22b4-4850-e86561d3b32d,1,485100,485143,485849,485900,706,749,43,0,0,0
485825,d7073400-bb62-1534-1246-60f2b00dfeb6,1,485104,485143,485825,486032,682,721,39,0,0,0
485869,a5a9c1be-48d3-ef98-b870-2def844e19ff,1,485118,485143,485869,485766,726,751,25,0,0,0
485849,f8c3dfca-f1df-46a0-160c-ae644b318a03,1,485118,485143,485849,485893,706,731,25,0,0,0
485851,3a30a5da-5359-b00e-f13a-69ca200f7f61,1,485185,485203,485851,485820,648,666,18,0,0,0
485862,ce81d541-6d4a-a116-91be-d6c83fad566f,1,485195,485203,485862,485703,659,667,8,0,0,0
485893,fe66f861-4657-6837-0779-28c3937b94e7,1,485184,485203,485893,485741,690,709,19,0,0,0
485892,1f728212-7c4a-4472-1a38-11441a6f70d2,1,485186,485203,485892,486144,689,706,17,0,0,0
485894,ec4cb297-65e7-3f5b-0858-d8f425a965a3,1,485189,485203,485894,485865,691,705,14,0,0,0
485958,ef2a4dca-cc18-998d-7a06-cd74c99ab08f,1,485192,485203,485958,486276,755,766,11,0,0,0
485967,c1077860-d573-5a37-9ba4-07f9e4c68c6d,1,485195,485203,485967,485957,764,772,8,0,0,0
485968,113f6606-f975-43aa-53d8-8d7d0dbfd841,1,485200,485203,485968,485904,765,768,3,0,0,0
485969,6a1d4dbe-43df-099f-162e-6472af47a214,1,485201,485203,485969,485802,766,768,2,0,0,0
485969,4df81539-50b7-b9b7-b329-26626d8a7a6e,1,485202,485203,485969,485986,766,767,1,0,0,0
485978,6ee34080-f251-e040-193a-8a833bce8fcd,1,485208,485263,485978,486103,715,770,55,0,0,0
485989,4ddb98de-7e35-f431-12e9-816c63cc975a,1,485236,485263,485989,485662,726,753,27,0,0,0
485991,20fa6f11-20ff-74c5-b5c2-e83d4184d045,1,485279,485323,485991,485715,668,712,44,0,0,0
485948,32632cc3-665e-816f-1b67-b77503b88938,1,485288,485323,485948,485740,625,660,35,0,0,0
486005,3c20dbe6-06d9-2835-06be-ac5ad49d3c77,1,485200,485203,486005,485657,802,805,3,0,0,0
486015,14691539-99ee-2665-5888-1ed9215a6d3a,1,485212,485263,486015,485631,752,803,51,0,0,0
486023,96f0226b-f14e-b339-8e4c-5da3905d27a2,1,485214,485263,486023,486196,760,809,49,0,0,0
486031,5418341c-75ff-5e23-56a5-bec9c5b70386,1,485306,485323,486031,485775,708,725,17,0,0,0
486317,c4adb29c-a01e-248d-db36-0c5f2dfc59f1,1,476423,476452,486317,485779,9865,9894,29,0,0,0
486570,d36289a5-bc72-e5fe-4ce9-e8df57f29ec0,1,476421,476452,486570,490658,10118,10149,31,0,0,0
486850,ace08b86-bc11-330a-e16d-ac5bb06fcf8c,1,476443,476452,486850,490904,10398,10407,9,0,0,0
487049,5ad1904c-4397-028d-d0b6-ba753ed9d8e3,1,476394,476452,487049,484248,10597,10655,58,0,0,0
488545,5884a8c3-1cd0-4b14-dd79-170f4c67c10f,1,450518,450518,488545,471387,38027,38027,0,0,0,0
488611,0087a6e9-a47c-94bf-c7af-e7572289020f,1,476453,476512,488611,483459,12099,12158,59,0,0,0
489247,0bb386db-c000-5895-0670-443c179cb4b9,1,476395,476452,489247,484221,12795,12852,57,0,0,0
489201,4b67580c-ebe1-e646-ad51-c193958f027a,1,476416,476452,489201,494963,12749,12785,36,0,0,0
489285,c9c7f74f-5553-d222-94c6-4b99305c2c8c,1,476399,476452,489285,485453,12833,12886,53,0,0,0
489311,dbccee78-9ccc-3ea8-c486-ca7144006cc6,1,476423,476452,489311,486850,12859,12888,29,0,0,0
489356,e847d6b7-0c0d-c186-4de3-dd6614dc5ccc,1,476404,476452,489356,485452,12904,12952,48,0,0,0
489412,57faf13d-30e2-370c-c5be-a40b206fe4d0,1,476439,476452,489412,487458,12960,12973,13,0,0,0
489486,43e0f9f0-e579-b25e-763b-7b466a828f3f,1,476400,476452,489486,487435,13034,13086,52,0,0,0
489487,d5d393a7-26f0-d5de-af51-69b07772d8db,1,476402,476452,489487,489843,13035,13085,50,0,0,0
489495,8608da42-0d15-b670-b120-67d81c6b1e50,1,476452,476452,489495,483188,13043,13043,0,0,0,0
489543,e9f36223-81e2-6143-fb77-35ed128fb3b9,1,476414,476452,489543,493019,13091,13129,38,0,0,0
489557,4e9ac7c0-eb33-225c-94de-92f7593accf2,1,476434,476452,489557,494297,13105,13123,18,0,0,0
489608,06012881-008c-8ea9-0843-578fd941a66c,1,476395,476452,489608,489189,13156,13213,57,0,0,0
489564,b8fcc7fd-f729-8f09-468a-00a99a2f99a7,1,476409,476452,489564,486953,13112,13155,43,0,0,0
489618,bb83114a-5fde-222d-0f28-51a92deb72dc,1,476428,476452,489618,484790,13166,13190,24,0,0,0
489572,7cc17b10-bf1c-67c6-0338-3c8a4c4e7e58,1,476429,476452,489572,494247,13120,13143,23,0,0,0
489575,82da33fd-c15b-25f2-bcb0-0cfc55d84fa3,1,476437,476452,489575,495143,13123,13138,15,0,0,0
489574,6d0102f9-83c6-e86c-bc5f-eb6aab1635f0,1,476439,476452,489574,491475,13122,13135,13,0,0,0
489574,d1678ac0-8e89-ea97-37f1-c35a939e51d2,1,476442,476452,489574,482979,13122,13132,10,0,0,0
489620,414c2daf-8b5e-c0e5-dd2a-cf59c2bfe362,1,476392,476392,489620,491042,13228,13228,0,0,0,0
489635,1314e0eb-897a-96e6-7b13-e1366added37,1,476421,476452,489635,484073,13183,13214,31,0,0,0
489654,76ad3bb6-0776-4242-c135-2b00c92c2bcb,1,476439,476452,489654,483256,13202,13215,13,0,0,0
489680,b2c3681a-fce5-2055-1062-7761fdb536ad,1,476420,476452,489680,492446,13228,13260,32,0,0,0
489724,16af3442-43ea-d84a-b0fc-a9d9cc1186c0,1,476433,476452,489724,490857,13272,13291,19,0,0,0
489681,cedba8e8-a9fc-9c2d-ee83-739f8b7550f7,1,476443,476452,489681,488527,13229,13238,9,0,0,0
489694,84852c6c-75aa-3694-88e0-e3674ff9a861,1,476450,476452,489694,490832,13242,13244,2,0,0,0
489732,84f73884-8c78-9ee1-4d67-b50702a80927,1,488154,488154,489732,489981,1578,1578,0,0,0,0
489756,37bd0ad8-232c-40a7-e1f6-981e508c99e1,1,476418,476452,489756,493930,13304,13338,34,0,0,0
489757,4cd54a9d-d782-6cb8-d776-4d952fbbcea0,1,476418,476452,489757,487055,13305,13339,34,0,0,0
489760,e0c6dd63-6579-1c66-3209-256b7d31aa11,1,476447,476452,489760,490839,13308,13313,5,0,0,0
489742,cb5ca041-cef0-efbd-903c-c2c7c7340099,1,476448,476452,489742,488043,13290,13294,4,0,0,0
489843,54c35fcd-4e71-c76a-6c13-0b4c7329666b,1,450531,450578,489843,479125,39265,39312,47,0,0,0
489837,83704ccb-602e-f747-dc9a-0a81fb16d8a4,1,476407,476452,489837,486668,13385,13430,45,0,0,0
489852,0c055bb3-01a0-78f5-1565-fe66db6de8a4,1,476448,476452,489852,488456,13400,13404,4,0,0,0
489834,291426c1-5276-fda5-a575-9afb5480b898,1,476451,476452,489834,495426,13382,13383,1,0,0,0
489893,a56b22a2-3b6a-0a85-3765-2bf7cb286bab,1,476411,476452,489893,486832,13441,13482,41,0,0,0
489927,473ab3de-50c7-9b16-0470-fd4ddaf93a25,1,476402,476452,489927,483658,13475,13525,50,0,0,0
489954,2e973a61-6f59-d09b-9a21-0ec8f66a65bb,1,488386,488386,489954,489442,1568,1568,0,0,0,0
490023,0d44fa84-d006-9c8f-ed99-b04454a51767,1,476394,476452,490023,487833,13571,13629,58,0,0,0
489981,25555acd-c344-3ba8-23bd-ee65f1b2b5e2,1,476400,476452,489981,491591,13529,13581,52,0,0,0
489981,b6a7cccd-dea9-3051-c73b-7b638c04208c,1,476414,476452,489981,489490,13529,13567,38,0,0,0
490012,57c168fb-7982-b4a4-2163-e6976f643c79,1,476445,476452,490012,491775,13560,13567,7,0,0,0
490086,9e09447b-65a9-4098-a937-6658aca0e259,1,476405,476452,490086,496465,13634,13681,47,0,0,0
490093,1557c23a-0e8a-ddd9-7e13-56bdaa2badbf,1,476445,476452,490093,496382,13641,13648,7,0,0,0
490100,e141d2a5-da6d-bb3c-dd55-d27080c09a5b,1,476392,476392,490100,494723,13708,13708,0,0,0,0
490146,d9fcd8b5-450b-d05b-1b41-618688aae39a,1,476410,476452,490146,493067,13694,13736,42,0,0,0
491078,bae0f3da-00ec-8333-3b47-57e5b1105482,1,489523,489558,491078,490894,1520,1555,35,0,0,0
491564,b6397107-c8a0-c691-ed8c-24b2d58f5a8a,1,489866,489918,491564,492048,1646,1698,52,0,0,0
491568,3422bb5a-d9cc-21d2-2d9c-60cd5ea03d42,1,489904,489918,491568,490940,1650,1664,14,0,0,0
491854,a2bfd9d0-33c8-a51f-7318-dd3d7da8cf85,1,490452,490466,491854,491599,1388,1402,14,0,0,0
491855,6d256249-5b6e-dedf-445a-bdcea0a7f916,1,490510,490526,491855,491517,1329,1345,16,0,0,0
491940,65bd19cb-f808-7a09-595e-7421540381a1,1,490547,490586,491940,491697,1354,1393,39,0,0,0
492029,00c3f267-3b38-387c-f617-2de1c78764de,1,490328,490346,492029,491205,1683,1701,18,0,0,0
492038,f373057b-7bbf-ec61-e344-7f1d4efe5cf1,1,491340,491378,492038,492194,660,698,38,0,0,0
492088,66834d0b-c266-3c3f-90e4-08a65a3b73ba,1,491422,491438,492088,492031,650,666,16,0,0,0
492069,fda20c90-fb48-ca87-5b34-fbaa529cb29f,1,491432,491438,492069,492118,631,637,6,0,0,0
492136,dd45a2db-b7ec-5579-ee4b-9e58e34f8ce2,1,490383,490406,492136,492122,1730,1753,23,0,0,0
492148,6b36e98e-9146-8a8c-f87f-7210212e5fdd,1,490784,490784,492148,492692,1364,1364,0,0,0,0
492160,a08f0dae-8b9b-9fbf-2fdd-13628380186b,1,490837,490844,492160,491553,1316,1323,7,0,0,0
492193,281ef235-9578-6324-634d-b08437c914dc,1,490839,490844,492193,492718,1349,1354,5,0,0,0
492160,3da0fe55-f957-58a0-2977-1f73671a9f03,1,490839,490844,492160,491542,1316,1321,5,0,0,0
492327,106bc3b2-7720-2dd8-e164-d172c02a8cc7,1,490955,490955,492327,492554,1372,1372,0,0,0,0
492378,bc01f14d-29b5-6963-e046-e5c806a7d305,1,491007,491015,492378,491717,1363,1371,8,0,0,0
492464,6a77ef8c-8651-56e7-b428-cf140f90f3a1,1,490831,490844,492464,492196,1620,1633,13,0,0,0
492555,0f72f4c4-a319-cb73-d866-be2db3e3cb18,1,491198,491198,492555,491855,1357,1357,0,0,0,0
492669,0a18501d-394a-3116-fe72-54691565b21b,1,490965,491015,492669,492027,1654,1704,50,0,0,0
494366,5684257e-7cd3-a605-1b50-4d43a2135d8c,1,491461,491498,494366,493731,2868,2905,37,0,0,0
497449,44795120-cf08-a6d7-d178-988c75006324,8,459366,459393,497449,500799,38056,38083,27,0,0,0
497604,65421627-e923-98e9-2439-7b23d7ea0ea9,1,491130,491138,497604,494771,6466,6474,8,0,0,0
497604,68a3d320-4a5a-ec2b-2f55-e5f6ecf163ee,1,491131,491138,497604,494668,6466,6473,7,0,0,0
497611,30b9cead-1fbc-c5f0-b19c-4b306f71d28a,1,491130,491138,497611,500160,6473,6481,8,0,0,0
497651,d9738a63-c262-de44-efdd-42c0484c6265,1,491131,491138,497651,496168,6513,6520,7,0,0,0
497682,12377609-f47b-c25b-0fe4-3c25ba767b8b,1,491126,491138,497682,495696,6544,6556,12,0,0,0
497724,917f06dc-cf55-9a94-aa4e-d9ce07c32150,1,491126,491138,497724,494880,6586,6598,12,0,0,0
497681,55988a6b-f838-8941-b8a8-7d841f3a24ad,1,491126,491138,497681,497612,6543,6555,12,0,0,0
497715,7672317d-5e3b-3441-9ef9-8613a8f90d8e,1,491127,491138,497715,497368,6577,6588,11,0,0,0
497706,17658f16-f5d5-0a90-1222-f1be0a308019,1,491128,491138,497706,497279,6568,6578,10,0,0,0
497707,255100c2-286c-2d47-3384-4055b415e6c8,1,491130,491138,497707,496197,6569,6577,8,0,0,0
497698,4351868d-223b-b44d-bceb-4b5613edc4f4,1,491131,491138,497698,496306,6560,6567,7,0,0,0
497768,1b62b2bb-1698-6cb8-da43-5139fb88afc8,1,491127,491138,497768,496456,6630,6641,11,0,0,0
497767,370abfbc-fe24-eaf8-8c9f-d4413409666f,1,491127,491138,497767,494414,6629,6640,11,0,0,0
497766,6f65def6-790a-6959-658e-cb2a70fe5439,1,491127,491138,497766,500683,6628,6639,11,0,0,0
497759,21e4e08b-5f9b-9139-70ef-a8adf969fc96,1,491128,491138,497759,495963,6621,6631,10,0,0,0
497742,63f15a67-4a0d-f4cc-1043-1241c02edc3d,1,491131,491138,497742,499839,6604,6611,7,0,0,0
497749,c580424f-37b9-5cc5-92eb-c686609c17ac,1,491131,491138,497749,498873,6611,6618,7,0,0,0
497748,10a11fd3-9bd3-8b65-0b02-becc1ea8c59d,1,491131,491138,497748,499242,6610,6617,7,0,0,0
497744,597bdde5-f5da-3c0f-b068-893c7e045fd7,1,491132,491138,497744,494593,6606,6612,6,0,0,0
497826,44d848a8-bcea-71e5-0128-e7a4aaa835c1,1,491126,491138,497826,497767,6688,6700,12,0,0,0
499716,fce28232-b4fa-785b-f477-649bc78af9dc,1,491219,491258,499716,499624,8458,8497,39,0,0,0
499714,3870c7a9-a6eb-5fb7-3b46-36dce75bb552,1,491219,491258,499714,499312,8456,8495,39,0,0,0
499672,ce2e2e2a-d701-597c-2bba-1b17c414c913,1,491221,491258,499672,497949,8414,8451,37,0,0,0
499716,80bf5c25-5db8-e038-e8e7-2d02cd4b381c,1,491221,491258,499716,496207,8458,8495,37,0,0,0
499693,68eed68d-2ef4-d78e-afae-9a24a42e024f,1,491222,491258,499693,499967,8435,8471,36,0,0,0
499753,e877ba23-cf63-df5b-f0d2-9556d87d6475,8,106910,106910,499753,440296,392843,392843,0,0,0,0
499727,10787df6-2817-3345-050b-cf476bb2807a,1,491217,491258,499727,500601,8469,8510,41,0,0,0
499728,af9e62a2-3d01-20f7-22fc-31db0bf6c417,1,491218,491258,499728,497176,8470,8510,40,0,0,0
499725,6306ac41-cbf9-c222-c669-4eaf913f1871,1,491218,491258,499725,496103,8467,8507,40,0,0,0
499773,e6199d55-8e36-98e8-89de-79641d0c5184,1,491218,491258,499773,501232,8515,8555,40,0,0,0
499776,3fb9c537-792b-9356-27d0-37b7f8a18c04,1,491218,491258,499776,496207,8518,8558,40,0,0,0
499727,4b94b930-393a-4207-719c-c375a599252d,1,491218,491258,499727,501373,8469,8509,40,0,0,0
499776,396351d0-7b30-6b99-e7de-53d5fb329ae3,1,491219,491258,499776,498405,8518,8557,39,0,0,0
499742,8a536fb5-20e5-a4cd-8843-4cb50b54acd0,1,491223,491258,499742,498868,8484,8519,35,0,0,0
499740,40cbf2c3-7b80-1e1b-7d18-9f807e0a096e,1,491223,491258,499740,497668,8482,8517,35,0,0,0
499743,f4e77917-6366-f51e-fb5a-46ed2cdf0bb3,1,491224,491258,499743,501120,8485,8519,34,0,0,0
499742,e144edde-3062-329f-a9d1-ed6b03f59265,1,491224,491258,499742,498295,8484,8518,34,0,0,0
499734,e1903719-31de-f4b2-3c2c-55298dc12eba,1,491225,491258,499734,497523,8476,8509,33,0,0,0
499733,22963760-7a72-8c7a-828f-7c01853acb89,1,491225,491258,499733,499239,8475,8508,33,0,0,0
499733,989c8a74-36e9-5805-6224-b85a1c396065,1,491225,491258,499733,501921,8475,8508,33,0,0,0
499736,cfb489f5-963f-ea97-345e-ee44e28dcfb3,1,491226,491258,499736,497610,8478,8510,32,0,0,0
499773,301a1db9-ac9f-f95f-8167-4d9b138bfe04,1,491227,491258,499773,498117,8515,8546,31,0,0,0
499724,5d9a1711-a07c-4bd8-3b58-314e7b25706b,1,491227,491258,499724,503804,8466,8497,31,0,0,0
499725,a5e1a559-d8cb-8d78-b659-822bcf500caf,1,491228,491258,499725,500057,8467,8497,30,0,0,0
499725,8c0b58bd-1c6c-80a7-7431-c3feea809596,1,491229,491258,499725,496440,8467,8496,29,0,0,0
499800,4fdc8ac8-1395-8e2f-6d27-951866dbe857,1,491223,491258,499800,497708,8542,8577,35,0,0,0
500555,d8000d71-32e1-cb3a-9d9d-8085da90560b,1,491269,491318,500555,497806,9237,9286,49,0,0,0
500594,608d32c2-98c8-6dea-2a57-66a6c8c938a3,1,491267,491318,500594,505076,9276,9327,51,0,0,0
500636,597493a0-91a5-ef7a-345b-2edcbd1f8d7f,1,491266,491318,500636,501783,9318,9370,52,0,0,0
500718,1003667c-8c77-ea46-4749-3806e4ec9cee,1,491264,491318,500718,503253,9400,9454,54,0,0,0
500773,99a93fad-282f-77e5-f386-fc844ba548a8,1,491264,491318,500773,501129,9455,9509,54,0,0,0
500773,5f9838db-6116-3281-aa53-916fc39f26ff,1,491264,491318,500773,497219,9455,9509,54,0,0,0
500762,96d2e428-039d-148b-28e7-96b2646ad281,1,491265,491318,500762,501051,9444,9497,53,0,0,0
500764,ef8d281d-a6e7-9f1f-fc25-86272d61a77a,1,491265,491318,500764,496480,9446,9499,53,0,0,0
500769,4272adf3-238e-7ae4-6c68-d3d8b5e8f105,1,491266,491318,500769,500049,9451,9503,52,0,0,0
500771,72dc83ed-786b-1336-4e71-0f53baec2ca3,1,491266,491318,500771,500009,9453,9505,52,0,0,0
500764,0e5d6328-4c32-6e2d-6a3e-e1e1ba2530b4,1,491266,491318,500764,505072,9446,9498,52,0,0,0
500740,666d7739-dfab-100b-3e39-f028f88cb9b2,1,491267,491318,500740,497007,9422,9473,51,0,0,0
500749,5b9f15c8-fa63-4f76-c34b-a4589fc63a31,1,491269,491318,500749,497500,9431,9480,49,0,0,0
500820,068b36e9-3860-3eb8-be5a-29645642f886,1,491263,491318,500820,498864,9502,9557,55,0,0,0
500820,60d21804-f691-615d-64cc-0731729f93b5,1,491264,491318,500820,498893,9502,9556,54,0,0,0
500819,11aaa4ca-9883-fb6d-db17-394ac4eea3ae,1,491264,491318,500819,503501,9501,9555,54,0,0,0
500829,9a1e0227-67c8-48d9-7a2f-8c4156c040a0,1,491266,491318,500829,498046,9511,9563,52,0,0,0
500848,a9bc4a95-6799-e400-d258-eb33902ddf0d,1,491267,491318,500848,501967,9530,9581,51,0,0,0
500871,8c410b8e-6811-b11a-1101-82d163771964,1,491262,491318,500871,497414,9553,9609,56,0,0,0
500859,83dd6a1e-6dc1-fead-6129-296bedcae4f1,1,491263,491318,500859,498347,9541,9596,55,0,0,0
501275,2549e09b-6911-3141-2932-cfea9462224e,1,484708,484708,501275,502188,16567,16567,0,0,0,0
501672,88df6a45-5a2d-022f-548e-2df49a2f8623,1,484766,484768,501672,503029,16904,16906,2,0,0,0
501761,13b6994c-6e5e-3069-0144-33102aa70976,1,491307,491318,501761,504552,10443,10454,11,0,0,0
501838,551b6e87-9150-23ba-fddb-3f2b4b03ded9,1,491311,491318,501838,503938,10520,10527,7,0,0,0
501838,4efaa16b-ea35-8283-cd82-721d75361064,1,491312,491318,501838,501284,10520,10526,6,0,0,0
501900,a68ae8fb-bf8c-8858-9891-62b039c2f88e,1,491310,491318,501900,506662,10582,10590,8,0,0,0
501957,0b89d61f-e3f3-ae27-b767-869128a06717,1,491306,491318,501957,497302,10639,10651,12,0,0,0
502034,2548d5c9-22e8-cbaa-4c46-39a254735c2e,1,491310,491318,502034,501148,10716,10724,8,0,0,0
502060,f5f2cda8-e8d7-d689-0e50-7e62f7bb6c28,1,491312,491318,502060,497610,10742,10748,6,0,0,0
502092,89e73823-fbbf-9df8-781c-695a3c5e0874,1,491306,491318,502092,506372,10774,10786,12,0,0,0
502082,5fecd211-7cde-c1cb-9b7b-edefb888a538,1,491308,491318,502082,507004,10764,10774,10,0,0,0
502071,6e7d46fc-4c6e-0c6e-2081-af204c6f016a,1,491311,491318,502071,504781,10753,10760,7,0,0,0
502071,a111bdbc-439c-725d-f6b9-0ae07395d3fc,1,491312,491318,502071,498461,10753,10759,6,0,0,0
502137,8ed3fd0c-db75-3d0e-718e-9264ce73dc4e,1,491310,491318,502137,497012,10819,10827,8,0,0,0
502127,2c4d8acd-845c-7a3e-cfe0-05587ab939e2,1,491311,491318,502127,500329,10809,10816,7,0,0,0
502187,c1796fe4-e889-a8f3-0d15-f2062792d1f5,1,491309,491318,502187,499034,10869,10878,9,0,0,0
502555,2fd18781-396f-1701-73fd-507c553afcaf,1,486034,486059,502555,508339,16496,16521,25,0,0,0
504077,2b5c0b76-09a0-5b9f-f24e-2646db71bec2,1,487554,487554,504077,498387,16523,16523,0,0,0,0
504775,9d731175-e207-dbb6-6f95-be223facdfa6,1,491306,491318,504775,508535,13457,13469,12,0,0,0
504809,84732bee-0fc7-65ce-30d0-ef78192f08f9,1,491306,491318,504809,511218,13491,13503,12,0,0,0
504776,16c52d2a-58ad-9965-b5c6-e8f9668770b4,1,491306,491318,504776,507176,13458,13470,12,0,0,0
504868,28aa184c-7446-39ea-a910-8c01f481ecd3,1,491305,491318,504868,499620,13550,13563,13,0,0,0
504870,a2444fd3-1aa5-c53b-d668-ad5cc388e5e6,1,491306,491318,504870,509597,13552,13564,12,0,0,0
504823,fd55a15a-bab5-9d8f-f917-a8b2e50c12f4,1,491306,491318,504823,511170,13505,13517,12,0,0,0
505134,837410bf-80d1-7b77-facd-237b9e46fcb1,1,488651,488671,505134,499829,16463,16483,20,0,0,0
505632,a5658d53-8346-d526-7ceb-742fbd5b3e9b,1,489066,489066,505632,500493,16566,16566,0,0,0,0
506081,1c09e657-d408-89a3-2509-54745fc7fc04,1,489745,489798,506081,506440,16283,16336,53,0,0,0
506373,3c363f92-4579-0615-d676-7d5a4611650a,1,489198,489198,506373,501966,17175,17175,0,0,0,0
506673,b92c2284-6641-ba88-35be-b95ae136b2f0,1,489834,489858,506673,507428,16815,16839,24,0,0,0
506853,ab9d74b0-50ab-5bd5-1773-c920a14aa4c8,1,490286,490286,506853,505751,16567,16567,0,0,0,0
506990,366e99ba-880b-84e4-afaa-9c01f1a517fc,1,490458,490466,506990,505932,16524,16532,8,0,0,0
507300,7e405778-02f6-68c6-110f-ede881f1fe2d,1,490387,490406,507300,513856,16894,16913,19,0,0,0
510262,f6d7607d-cea2-9164-a039-18313fd915e3,8,498954,498987,510262,507903,11275,11308,33,0,0,0
510337,17e2ec72-be35-6d09-412d-d84d302e5ec2,8,498961,498987,510337,512220,11350,11376,26,0,0,0
511093,518fe8f3-6412-b588-6c2d-8334b07f7157,8,459375,459393,511093,494680,51700,51718,18,0,0,0
511318,8068939b-2277-9110-f1c1-8283fb600d05,1,503158,503215,511318,507686,8103,8160,117,1,0,0
511629,de598930-23de-6993-4ea2-afafe1b5eaf4,1,503511,503563,511629,515264,8066,8118,116,1,0,0
511707,a3109440-f899-f213-3755-540679cdf8d9,1,503446,503503,511707,514886,8204,8261,117,1,0,0
511693,446405c6-fe6c-c582-42d6-f44cf2baf696,1,503678,503683,511693,508645,8010,8015,5,0,0,0
511963,030d8eee-ac78-3213-f207-4bcb486d00d2,1,503928,503985,511963,514800,7978,8035,57,0,0,0
512243,b9aee2af-b45c-bd5a-a02f-8aab8025613a,1,504175,504230,512243,512533,8013,8068,55,0,0,0
512355,67052038-c43e-cc48-b6c1-25255f73f838,1,504176,504230,512355,512072,8125,8179,54,0,0,0
512519,616b9643-29e7-0d83-5d62-4823e4e5917e,1,504415,504415,512519,511928,8104,8104,0,0,0,0
512522,3d70241c-ebed-b454-b383-d8aa21df423e,1,504417,504475,512522,515664,8047,8105,58,0,0,0
512837,c8caa571-a33b-d683-6bdc-01b59572b13e,1,504678,504699,512837,513029,8138,8159,21,0,0,0
513141,be849a19-9f3c-4ac3-d554-da125561f4a4,1,504965,504999,513141,509083,8142,8176,34,0,0,0
513275,e6a69cf6-c62d-3e03-d22a-5e845f9ec4a1,1,505211,505254,513275,512792,8021,8064,43,0,0,0
513446,d4d7b736-4120-ae49-4f29-d580bf87d026,1,505374,505374,513446,514035,8072,8072,0,0,0,0
513483,d689b63b-372a-858a-9fc4-0512ac1eee4f,1,505456,505494,513483,511537,7989,8027,38,0,0,0
513531,506be163-3a77-9e3d-07ee-ff1fe1d41d95,1,505374,505374,513531,511329,8157,8157,0,0,0,0
513697,a62855e2-84ba-72fd-80e1-e75feb633ae2,8,508922,508922,513697,512469,4775,4775,360,1,0,0
513736,007f6bd0-6525-2940-d7ec-b2ab4b5293e4,8,508922,508922,513736,515219,4814,4814,420,1,0,0
513858,105a34a9-84f4-d276-cecd-5c10fef9d5ce,1,505620,505620,513858,514238,8238,8238,72,1,0,0
513872,6f6a62e3-7108-c26c-4e7e-171372451a77,1,505623,505680,513872,513776,8192,8249,129,1,0,0
514213,d5b6d68e-2a14-a2b1-9b4f-6e53dfb13fc3,1,506064,506064,514213,511263,8149,8149,132,1,0,0
514972,08225318-464b-53f2-6bf7-889a28df781e,8,514033,514033,514972,515178,939,939,0,0,0,0
515042,b6e7dddd-7b4e-0fd4-73f0-61a27b5aab2e,1,498523,498527,515042,514947,16515,16519,4,0,0,0
515295,b6ccece5-7a0e-1bfe-16ba-1b696bf32690,1,498587,498587,515295,512573,16708,16708,0,0,0,0
515447,fa7f7662-eb9e-e2ca-02dc-4dbe5221595c,1,499186,499227,515447,516877,16220,16261,41,0,0,0
515455,50426c91-2e72-efd7-d360-85f910244401,1,498927,498927,515455,521681,16528,16528,0,0,0,0
515544,83d50363-3837-15bf-eb16-79f4fa460054,1,498597,498647,515544,513335,16897,16947,50,0,0,0
515556,f36ff249-14b4-6725-af1f-d21e9e26b61d,1,499120,499167,515556,523049,16389,16436,47,0,0,0
515600,4f0581f6-dc10-6a34-d2ae-65a0e4dfd2e9,1,499120,499167,515600,517097,16433,16480,47,0,0,0
515593,71633a74-654a-6ff4-5e8f-972e4d593c14,1,499179,499227,515593,518404,16366,16414,48,0,0,0
515660,b9f65588-0be6-9706-b851-887c8876dbb4,8,498975,498987,515660,512785,16673,16685,12,0,0,0
515658,5a2ed6c2-4640-f319-faae-d6f073255bc0,8,498992,499047,515658,522340,16611,16666,55,0,0,0
515659,21513795-eec1-ad04-66f5-4f25a3722c5c,1,499029,499047,515659,517430,16612,16630,18,0,0,0
515687,c8b4c241-c0d4-2af4-f659-7e63070a0069,1,499178,499227,515687,522795,16460,16509,49,0,0,0
515648,4a71046d-b13c-a8e1-7748-390c6a0ddc18,1,499499,499536,515648,520096,16112,16149,37,0,0,0
515704,b69d78ca-9336-10f8-781a-fa8c13f4b596,1,499078,499107,515704,507572,16597,16626,29,0,0,0
515688,bbe7450c-a1b9-b7ee-3c24-b1361932c1d3,1,499179,499227,515688,508216,16461,16509,48,0,0,0
515712,0e10eb23-0896-b2f7-5fba-07942b94e406,1,499307,499356,515712,521364,16356,16405,49,0,0,0
515800,37866f34-5fa7-460b-8a49-a3b67ef8d75c,1,499137,499167,515800,523524,16633,16663,30,0,0,0
515757,7cc51149-6e97-b81c-d726-869bc4c467de,1,499187,499227,515757,520379,16530,16570,40,0,0,0
515787,300814d2-cbb5-ab50-cca7-fa3b5d6f07b4,1,499201,499227,515787,516265,16560,16586,26,0,0,0
515772,ff2abdf7-2d43-08b0-5479-594c98490c68,1,499445,499476,515772,511897,16296,16327,31,0,0,0
515842,767805f4-35cb-2430-bfba-fd0e73d2a687,1,499186,499227,515842,513451,16615,16656,41,0,0,0
515845,5d9cddba-6b49-3c5e-b424-ecf36a7c2cfc,1,499360,499416,515845,511281,16429,16485,56,0,0,0
515849,9e3e3bd3-ee12-63bb-9fc1-673baea93789,1,499382,499416,515849,521988,16433,16467,34,0,0,0
515891,f7c3dc66-7fda-f8e0-4eab-1e72c488dc5b,1,499439,499476,515891,514293,16415,16452,37,0,0,0
516009,1e1f83d8-d70e-9627-963b-933bc52bbfb4,1,499400,499416,516009,519537,16593,16609,16,0,0,0
516014,56b5783d-a712-0dfe-0003-60565367210c,1,498977,498987,516014,507591,17027,17037,10,0,0,0
516050,d139b53f-2382-6ff9-b153-09217eaed43c,1,499297,499356,516050,514823,16694,16753,59,0,0,0
516042,c7727807-4524-a8de-36e2-d60f89d00d69,1,499316,499356,516042,515827,16686,16726,40,0,0,0
516036,70bb727a-07f4-fe4b-77fe-ffa140bc3d62,1,499768,499776,516036,514986,16260,16268,8,0,0,0
516100,86939b96-4ed5-b245-5595-7d5f1b3400a6,1,499123,499167,516100,514963,16933,16977,44,0,0,0
516090,3a57ac09-795a-5695-e18f-281159c7ae82,1,499452,499476,516090,509544,16614,16638,24,0,0,0
516101,ef7b50ab-3f76-ceb7-9578-ce6b2cac5acd,1,499629,499656,516101,514358,16445,16472,27,0,0,0
516186,da0f9782-2607-8820-f592-8bead1e54803,1,499296,499296,516186,517003,16890,16890,0,0,0,0
516165,b89764b7-a8b0-056a-721e-2ae8958d861d,1,499446,499476,516165,523684,16689,16719,30,0,0,0
516137,f1944f6c-0d5a-7f30-aa6c-f97b0a95d1e1,1,499863,499896,516137,509629,16241,16274,33,0,0,0
516240,b499e4e8-08ca-5a76-68e6-33a63ad0482a,1,499448,499476,516240,512244,16764,16792,28,0,0,0
516289,823e8c38-0f27-768f-5877-00c0920495bd,1,499898,499956,516289,516870,16333,16391,58,0,0,0
516535,b8e44b7b-98fd-a3b5-9575-cb44d5f8a246,8,508734,508776,516535,516810,7759,7801,42,0,0,0
516566,58b8ebfb-4dbb-58c3-ee62-735c8320fadc,8,508743,508776,516566,515149,7790,7823,33,0,0,0
516722,537163c6-6bc9-2f15-9137-c5c6873e271d,1,500295,500345,516722,516341,16377,16427,50,0,0,0
516938,596537cd-0627-2f82-f947-6347b2be318e,1,500285,500285,516938,524485,16653,16653,0,0,0,0
517036,34077faa-7801-8d81-28ca-fb6bbe9710e5,32,388816,388816,517036,471712,128220,128220,0,0,0,0
517109,bd20c06b-7677-fdd8-8778-9f1b24ded4ff,1,500674,500675,517109,522999,16434,16435,1,0,0,0
517344,b2f089b9-964a-852c-fb1e-e55a37b3ef4d,1,500930,500975,517344,523682,16369,16414,45,0,0,0
517411,05eb7c54-7f1a-1298-870a-6e4886a05e8e,1,500980,501035,517411,509988,16376,16431,55,0,0,0
517783,a077da25-58d2-5613-8ccc-288811a82fa7,1,501140,501140,517783,522414,16643,16643,0,0,0,0
517823,2a53ca70-1637-2087-4ed4-0f6c3a7d2d30,1,500938,500975,517823,523868,16848,16885,37,0,0,0
517852,4ae8285c-17f6-a4cf-224a-d577879a67ac,1,501285,501324,517852,519418,16528,16567,39,0,0,0
517994,001e4962-0003-54b2-3f57-8008b2f1e6e3,1,501407,501444,517994,514835,16550,16587,37,0,0,0
518031,3467f70c-ce8f-984b-54b5-789374f72d9f,1,501615,501624,518031,513092,16407,16416,9,0,0,0
518058,7bafcbcc-541f-bb00-b563-a33cc62f06ff,1,501264,501264,518058,522667,16794,16794,0,0,0,0
518042,91687426-3b43-e0e2-b0dd-04bc928802db,1,501451,501504,518042,524768,16538,16591,53,0,0,0
518175,8fe88ea9-bb39-3f33-d7cd-52cd27842066,1,501360,501384,518175,515732,16791,16815,24,0,0,0
518281,b40d66dd-3ac9-eb16-a070-92c7ee277ff5,1,501365,501384,518281,519924,16897,16916,19,0,0,0
518373,7204e7e1-3578-3061-cb00-2182392c4a2d,1,501565,501624,518373,521550,16749,16808,59,0,0,0
518476,36bdbabf-20c5-5972-8d03-df5fd777b1ee,32,399052,399052,518476,509725,119424,119424,0,0,0,0
518545,118d9d9a-dece-a1f8-3e19-0e81f72cbfc1,1,501859,501881,518545,512768,16664,16686,22,0,0,0
518571,b31d6e22-cc2e-4560-d38c-bef333f6ac67,1,501810,501821,518571,518048,16750,16761,11,0,0,0
518613,d1906428-5db0-8ee1-1df1-9d03f2576076,1,501590,501624,518613,522119,16989,17023,34,0,0,0
518761,814c31b2-aed9-9198-9c74-c9449857448c,1,502336,502361,518761,511435,16400,16425,25,0,0,0
518785,ee56a632-5d69-75e4-6a65-cef49ab6d0a9,1,501931,501941,518785,517666,16844,16854,10,0,0,0
518772,b562a923-14b6-54c4-2225-44b8c4570192,1,502336,502361,518772,524179,16411,16436,25,0,0,0
518864,b63bb6de-2ae5-c7e3-6e88-83255a2b65ab,1,502150,502181,518864,524563,16683,16714,31,0,0,0
518926,11970cc7-4290-274e-4d73-09bddc902b7a,1,501852,501881,518926,526917,17045,17074,29,0,0,0
518909,b67a8172-bc60-3788-9442-ae6b5b330f17,1,502425,502481,518909,517830,16428,16484,56,0,0,0
518964,d6b15981-6b84-76fb-7591-2faf2a6e5a4c,1,502432,502481,518964,516281,16483,16532,49,0,0,0
519018,18b626fe-7665-bbea-72d4-9178c032c50d,1,502555,502601,519018,525036,16417,16463,46,0,0,0
519088,b16c278d-aedf-999e-17c9-e43a84ae34be,1,502375,502421,519088,514522,16667,16713,106,1,0,0
519080,9d11963c-d827-72e1-7ae5-b44eddcf879a,1,502422,502481,519080,511271,16599,16658,59,0,0,0
519067,74e44766-ea01-88c7-e75e-976a5a2f237b,1,502435,502481,519067,512942,16586,16632,166,1,0,0
519199,2b5e4c83-99e2-5008-1462-b49fed693a5a,8,516656,516656,519199,518108,2543,2543,669,1,0,0
519245,2f96530b-d3ab-1c3f-b458-98b0b845e393,8,517604,517604,519245,518937,1641,1641,336,1,0,0
519312,57c54c37-8c48-82f7-5b03-add4bf3ab0da,1,502871,502901,519312,512755,16411,16441,30,0,0,0
519345,314dbc34-5c81-981a-6c17-9e9c0c16d3e7,1,502599,502601,519345,525055,16744,16746,62,1,0,0
519329,716c8cdd-a689-f32c-ff2f-2142dc014a6b,1,502613,502661,519329,517888,16668,16716,48,0,0,0
519665,b13e160b-ca23-3807-c024-cd7b8a151e9a,1,502874,502901,519665,520655,16764,16791,147,1,0,0
519757,dfb5ff86-b06d-c0d5-26b0-7bc18b430745,1,502613,502661,519757,524712,17096,17144,288,1,0,0
519944,f7225aff-7515-26df-b562-b72e899642b3,1,503157,503215,519944,517765,16729,16787,320,1,0,0
519985,50c7c6d7-3398-c9e8-24db-7aa23049fcc0,8,517495,517495,519985,518748,2490,2490,129,1,0,0
520028,c36ad335-4dae-2693-de7a-457791638880,8,508752,508776,520028,517854,11252,11276,24,0,0,0
520064,5c46876c-caff-e132-eeef-def0efe0665c,8,508761,508776,520064,519361,11288,11303,75,1,0,0
520170,6ab66c79-5d49-77ab-cd99-62762745dd4f,8,518273,518273,520170,520262,1897,1897,0,0,0,0
520395,0645ddbc-1794-6e05-5e2e-2eff78aa6915,1,503246,503275,520395,523327,17120,17149,459,2,0,0
520399,02fc6823-b3db-ae46-04f9-8de5811e6b6f,1,503788,503788,520399,512115,16611,16611,322,2,0,0
520475,f79691bb-92cd-4a06-9a81-d73ff2b95927,1,503443,503443,520475,514308,17032,17032,262,1,0,0
520478,617da927-a575-57ed-f442-7dd75de235cd,1,503443,503443,520478,514996,17035,17035,322,2,0,0
520495,72d73571-d52e-bb12-a8cd-021a31f7ee6b,1,503678,503683,520495,515904,16812,16817,372,2,0,0
520518,f06cd00c-5a05-529b-8a6f-d8d145821b5f,1,502966,503021,520518,520429,17497,17552,511,2,0,0
520674,8dc10914-6c62-6aa7-f8d1-aae8700e4b6d,8,499000,499047,520674,527343,21627,21674,47,0,0,0
520712,3b5d2ba8-61d6-43cf-d31f-1ed922eb4986,1,503925,503925,520712,514894,16787,16787,262,1,0,0
520831,628474b8-e0e9-f2dc-8cd5-bcca3cedbfa5,8,499011,499047,520831,520205,21784,21820,36,0,0,0
520997,9dcf3c3f-b57b-1170-9e1b-eb1310c4f8c6,1,504170,504170,520997,518630,16827,16827,334,2,0,0
521244,dbb5d0f9-aee6-5375-5cc4-adcbba9171ed,1,504415,504415,521244,513860,16829,16829,334,2,0,0
521287,8e6a55eb-e177-b7be-81ec-29f5ac18ab42,1,504662,504699,521287,517915,16588,16625,371,2,0,0
521302,4f148ea5-d995-67be-4b45-47e6f063069c,1,520491,520515,521302,521423,787,811,24,0,0,0
521343,605d7c68-aae9-a405-e9c0-0af03906418e,1,520477,520515,521343,521405,828,866,38,0,0,0
521464,6a3c561f-4790-0f0e-08db-e950593432ae,1,520459,520515,521464,521288,949,1005,56,0,0,0
521511,243d9300-02ad-cdde-83af-a81546be81c7,1,520481,520515,521511,521150,996,1030,34,0,0,0
521575,1aff217f-d0c1-e1f7-d8a7-12fbff16e0f0,1,520461,520515,521575,521929,1060,1114,54,0,0,0
521602,8d011e6c-ef9a-3349-d1ad-595b0385d098,1,520468,520515,521602,521478,1087,1134,47,0,0,0
521685,3a0616db-0f76-1580-163d-8b82fba30867,1,504959,504999,521685,523427,16686,16726,374,2,0,0
522040,6d38831d-0c9a-cb60-9506-70a9dc1ca9b1,1,520496,520515,522040,521675,1525,1544,19,0,0,0
522079,be6e1938-a545-a52f-fde5-8e659a578298,1,505157,505194,522079,515271,16885,16922,371,2,0,0
522310,e226975e-9fe4-71b9-b471-e89689c078b3,1,505422,505434,522310,518629,16876,16888,346,2,0,0
522861,88b2d007-2201-c388-20ca-516d74572280,1,506068,506124,522861,514583,16737,16793,450,2,0,0
523085,47864f3d-f07f-79b0-a14e-4b5f5cf1fa61,1,520459,520515,523085,522116,2570,2626,56,0,0,0
523087,0f21d27a-0139-2099-0094-8a5a4e3061dc,1,448790,448838,523087,539331,74249,74297,48,0,0,0
523142,5131da03-eb69-e9ac-3216-87ddeedf47de,1,520458,520515,523142,524114,2627,2684,57,0,0,0
523284,2a4a3149-63b1-05a8-2128-eb084a7c999a,1,520481,520515,523284,522909,2769,2803,34,0,0,0
523314,91a87c1f-3037-b2a5-aa47-5d406f0fb41e,1,520489,520515,523314,523028,2799,2825,26,0,0,0
523398,85ce4148-8094-ad76-4cee-122eb3c8100a,1,522211,522211,523398,523234,1187,1187,0,0,0,0
523910,89d34913-b758-1b81-0d6c-8647527e746f,1,520469,520515,523910,523928,3395,3441,46,0,0,0
524065,df13ea7b-b8b0-2537-5c8d-ed032eb3218d,8,508782,508836,524065,528891,15229,15283,436,2,0,0
524071,9f99c8fc-9d04-0243-fa05-7940e94c700b,8,508772,508776,524071,528678,15295,15299,446,2,0,0
524201,6b03568b-4daf-9991-9182-608f6a330766,1,520470,520515,524201,525928,3686,3731,45,0,0,0
524330,0ac68dc0-0b87-a9be-5b36-13dea787130c,1,520472,520515,524330,523610,3815,3858,43,0,0,0
524410,4dd1c5a2-0292-0aab-49f7-ffe0ac7de8bf,1,520474,520515,524410,522408,3895,3936,41,0,0,0
524419,d2ef9c7e-613d-80c2-a22a-25fd0f2a1e81,1,520464,520515,524419,522685,3904,3955,51,0,0,0
524484,adbf2c7e-6253-ec4f-1522-01b9f3a2843c,8,520012,520064,524484,525486,4420,4472,52,0,0,0
524507,54cadef0-1157-c4b6-5fa9-9c60fa37e81c,1,520474,520515,524507,523006,3992,4033,41,0,0,0
524641,853ad362-e262-0152-f3c9-ee87718595d1,1,520473,520515,524641,524022,4126,4168,42,0,0,0
524643,9a15f6f5-0773-6968-b9ec-e7d39d4eafb0,1,520471,520515,524643,524843,4128,4172,44,0,0,0
524928,d4fbc996-26e0-47c6-d15b-fda0b83f0063,1,522218,522271,524928,524043,2657,2710,53,0,0,0
525326,a1827433-9522-eda1-9462-39dead87f3d7,1,522218,522271,525326,524997,3055,3108,53,0,0,0
525457,a3fc1bfa-edb9-610a-c91f-c5af0ab1c494,1,520462,520515,525457,525425,4942,4995,53,0,0,0
525743,2f26e55a-7b6d-b4c4-6dac-527f7c708586,1,520497,520515,525743,523685,5228,5246,18,0,0,0
525815,e1821eaa-6b83-80c6-858d-1bc5c4b365f9,1,522221,522271,525815,524019,3544,3594,50,0,0,0
525819,dfeb778f-0226-0ca3-1a81-029decdc9da7,1,520476,520515,525819,527996,5304,5343,39,0,0,0
526149,d9acea9f-e865-49d9-cba1-1d307bf20b0c,1,520499,520515,526149,528367,5634,5650,16,0,0,0
526478,0df682ea-fa24-9ca1-23e8-e6800228ad07,32,524270,524270,526478,526242,2208,2208,0,0,0,0
526568,40281391-9df2-fc73-f84c-d3980c093004,1,520486,520515,526568,526407,6053,6082,29,0,0,0
527002,99f5d74f-026d-8738-497e-1b15914fd104,1,520479,520515,527002,525876,6487,6523,36,0,0,0
527053,832870c2-1cd8-40bc-8831-86f5c21652fd,1,520498,520515,527053,525315,6538,6555,17,0,0,0
527267,27336bc9-dbba-f966-ad1a-689a8759b6de,1,520476,520515,527267,528488,6752,6791,39,0,0,0
527300,a4074ec2-9359-25e4-62f5-300eefb4303d,1,520495,520515,527300,530535,6785,6805,20,0,0,0
527698,3592cc6c-78fb-43c9-be0f-acf80542c050,1,448803,448838,527698,518711,78860,78895,35,0,0,0
527849,58b5eaaf-38a0-f99b-a42c-838bff9f320d,1,520497,520515,527849,525872,7334,7352,18,0,0,0
528137,59c13918-b6b0-a726-5039-9f423ec6f665,1,520492,520515,528137,529021,7622,7645,23,0,0,0
529054,fed2b783-bc5d-666a-81d1-77c67952fc0f,1,448783,448838,529054,508337,80216,80271,55,0,0,0
529570,6874eff1-6cce-4d29-562a-37f9640400be,8,381031,381037,529570,497044,148533,148539,6,0,0,0
530064,1f91535e-3789-a02a-0225-b8b1715fa66c,1,520484,520515,530064,531151,9549,9580,816,1,0,0
530067,f920b0cf-51e3-b50d-d8ed-09360f9552b5,1,520493,520515,530067,527220,9552,9574,807,1,0,0
531206,43844449-2100-2f8f-6ea2-5d4ebc26e10d,1,522212,522271,531206,529717,8935,8994,59,0,0,0
531396,ef166674-81a6-7f9a-9213-90718cc7c35b,8,523833,523834,531396,530406,7562,7563,61,1,0,0
531481,c6ca565f-8411-4531-5f1f-4fae4bbd0ebf,1,522212,522271,531481,531708,9210,9269,59,0,0,0
531513,03df97d3-3890-d32a-4b7e-964443ca12ea,8,381042,381097,531513,554033,150416,150471,55,0,0,0
531531,938a9468-7453-e65d-5aff-c139fe4d2f7a,1,520487,520515,531531,526316,11016,11044,813,1,0,0
531507,ca53ddbb-7992-ec61-72d4-5d85dfcb9445,1,522212,522271,531507,529180,9236,9295,59,0,0,0
531570,df118c67-5d7c-b047-8f85-5b4844dccebd,1,522211,522211,531570,528066,9359,9359,0,0,0,0
531606,1c392667-9355-ce00-2188-966e12acccff,8,523843,523894,531606,532011,7712,7763,171,1,0,0
532092,aca4825c-269e-58f6-ef88-44f3913deb25,1,522214,522271,532092,529834,9821,9878,57,0,0,0
532092,661ef2cc-cb5a-a390-791e-379d76704f5c,1,522214,522271,532092,530742,9821,9878,57,0,0,0
532892,ed968e81-57c0-e101-bfdc-68df67fe3c11,8,381038,381097,532892,525139,151795,151854,59,0,0,0
534522,bdb6e680-ec4f-914e-1308-ee3571944cc4,1,520480,520515,534522,535548,14007,14042,820,1,0,0
535034,6e8a1666-86b4-2911-a535-f86c3b6eceac,8,523856,523894,535034,537235,11140,11178,158,1,0,0
536176,71e7f679-4cf2-8c15-70fa-4d187c3772a1,8,523865,523894,536176,532868,12282,12311,1369,2,0,0
536597,7a5f8a17-d73a-2d0b-1e93-bbfaf8702c7b,8,528029,528029,536597,540068,8568,8568,458,2,0,0
537493,9beb8455-bafa-9035-b858-6a0386a4ef70,32,382301,382301,537493,607766,155192,155192,0,0,0,0
537945,4c9dc93c-b7f5-b3ac-880e-fb558de0f010,8,528186,528209,537945,537033,9736,9759,2232,1,0,0
538120,0c7b981e-1d93-7e25-04b4-fa5643bf9523,8,528041,528089,538120,535065,10031,10079,1936,1,0,0
538549,42f09374-8e19-c314-0c38-87b8e6224f69,1,517973,517973,538549,536427,20576,20576,946,2,0,0
538801,3b9baee7-7d90-a4e1-f994-3f278b1d936f,1,517845,517903,538801,532289,20898,20956,932,2,0,0
539247,29f71926-42e2-7eac-e006-50df81586381,1,518073,518093,539247,545276,21154,21174,1026,2,0,0
539320,052765ed-a196-d992-af1a-e95e38a47343,8,528196,528209,539320,536209,11111,11124,3453,1,0,0
540141,b2a0ff1a-99f1-0cd8-5a30-1f02c8aaaccf,8,523877,523894,540141,543902,16247,16264,1755,2,0,0
540213,5b74865b-7b4e-cd57-b894-29983532ea2e,8,523885,523894,540213,539038,16319,16328,1747,2,0,0
540749,5b1005e5-2635-a5ad-1476-4010e1174c66,1,522211,522211,540749,537283,18538,18538,0,0,0,0
541843,1cfa359e-3b81-cab0-3857-34615f4863cf,8,528051,528089,541843,534708,13754,13792,1926,1,0,0
542430,fa7c230f-4da3-dacf-a741-88de2d8d6e9b,8,528061,528089,542430,540776,14341,14369,2370,1,0,0
543249,39f7a642-78a4-cc9c-fd9e-5c8adeefe02d,8,542383,542383,543249,543562,866,866,0,0,0,0
543529,f69c2ed6-1bd1-a6a5-68cb-a1dfd51ffbfe,8,528288,528329,543529,536400,15200,15241,8082,1,0,0
543565,3a11e6ed-f640-a7f7-82ed-9064dc2c57b7,8,528301,528329,543565,533215,15236,15264,8069,1,0,0
543796,cd43a1ab-c3f2-acb6-29c6-b5b0e307d8c5,8,542874,542874,543796,543795,922,922,0,0,0,0
544003,cc5fca33-d1e6-a553-f1b2-0a7e0b660f71,8,542075,542075,544003,543249,1928,1928,0,0,0,0
544832,23739fe7-ddd1-2868-44f0-3f5be09912de,8,528205,528209,544832,534228,16623,16627,5586,1,0,0
545126,80b4931f-98ff-f28f-26bd-d79aff206219,8,544266,544266,545126,545109,860,860,0,0,0,0
545168,16c877e9-c9b6-b6ce-e46e-ead901385fa9,8,499334,499356,545168,546006,45812,45834,22,0,0,0
545458,a3446306-a0b0-1eca-8aca-873cb6e7552f,8,499341,499356,545458,524899,46102,46117,15,0,0,0
546015,e80d581b-f324-a058-4222-58897d98b6b5,8,528216,528269,546015,540133,17746,17799,6777,1,0,0
546275,7b55ddcd-1a8b-aac1-f55a-67a274a69b3a,8,528082,528089,546275,537627,18186,18193,2494,1,0,0
546317,d1f78e4e-c4c4-a450-710e-a06169fef16f,8,528070,528089,546317,545956,18228,18247,2506,1,0,0
546573,be1db367-34c5-1a22-ec86-be907415701a,8,528311,528329,546573,539878,18244,18262,8059,1,0,0
547254,038711ad-c751-8f37-7758-f668769359d6,8,528319,528329,547254,534880,18925,18935,8503,1,0,0
547434,273391e5-8136-f4dc-e804-c7ab822929b9,8,546605,546633,547434,547071,801,829,28,0,0,0
548833,57a49e4b-4b29-eda7-1aa1-9036405a089a,8,547959,547959,548833,548981,874,874,0,0,0,0
549168,0344a683-9a8c-aa40-95c4-44fafe29a3ae,8,548121,548121,549168,549234,1047,1047,0,0,0,0
549253,9338eda6-2b2d-1a24-e3e8-2c6d585f7f91,8,548213,548213,549253,549218,1040,1040,0,0,0,0
549836,35f83c4c-6ca4-a1ed-f2cf-72cc16e04fc6,8,528233,528269,549836,538741,21567,21603,7181,1,0,0
550266,9fb37fef-b39a-32be-078e-145a41e2c2f5,8,549198,549228,550266,550177,1038,1068,30,0,0,0
550664,a72cfe95-16f3-1c4a-3105-924df00d09db,8,528328,528329,550664,547459,22335,22336,8669,1,0,0
550793,1e786fa2-de5c-d5a3-3553-f9c6a9729e19,8,528243,528269,550793,544502,22524,22550,8067,1,0,0
552010,5969a011-c267-e9e3-938d-e86cd096f75f,8,528337,528389,552010,544719,23621,23673,9920,1,0,0
554716,2c6976f1-6cdf-55f4-e405-67635795619c,8,550081,550081,554716,556922,4635,4635,0,0,0,0
555458,98692735-ff68-30a2-d25d-81aa4c3cf681,8,550839,550853,555458,554784,4605,4619,14,0,0,0
561899,aeb4b13c-838b-54b4-909b-fa8d230c77f1,32,498639,498647,561899,567096,63252,63260,8,0,0,0
562874,acb06f5b-5aab-097d-910c-dc31d8fc4966,32,441064,441064,562874,549120,121810,121810,0,0,0,0
563883,5ce8e692-064e-1e70-70cf-2d863b837d0d,32,501321,501324,563883,588608,62559,62562,3,0,0,0
564266,3bd75053-517e-aaa6-406e-b2c68e0b38ab,32,561840,561895,564266,564264,2371,2426,55,0,0,0
565633,528bd2de-1562-e845-c88e-bf4675805d15,32,501519,501564,565633,549812,64069,64114,45,0,0,0
569799,a243cbab-567d-2ee6-e3d6-d3573ffeddba,8,336875,336875,569799,489009,232924,232924,0,0,0,0
578952,ead0a63c-8424-643c-aba6-c69dc505ac21,32,498477,498527,578952,554154,80425,80475,50,0,0,0
580166,ff17bd6f-c984-54fb-2656-1ffcc61c3d58,8,68324,68333,580166,426020,511833,511842,9,0,0,0
580866,b8b017cf-2b23-9a53-a360-0c27afef99b6,8,68271,68273,580866,487184,512593,512595,2,0,0,0
581845,04b98b43-513a-0ab2-bc38-73afde93d448,32,502067,502121,581845,584289,79724,79778,54,0,0,0
582048,cf5cf1dd-5549-1a19-d7c8-6ae22591316b,32,500187,500209,582048,552262,81839,81861,22,0,0,0
582479,e7a92d70-33c7-0f35-ca42-192e82c0ba74,8,68221,68273,582479,666684,514206,514258,52,0,0,0
582486,23cc6ecc-60b6-3cc6-5f58-1cc50c14bea9,32,500149,500149,582486,604288,82337,82337,0,0,0,0
584427,b04a908e-384c-a561-af2b-de5cc17c0907,8,576897,576947,584427,585167,7480,7530,50,0,0,0
584481,4ceed038-37bc-f79a-121a-81d89063cfb7,8,576887,576887,584481,582690,7594,7594,0,0,0,0
586124,a8e03d6b-1511-05eb-0d27-23c3a3e5a05d,32,456341,456393,586124,569235,129731,129783,52,0,0,0
587898,e292939c-20c3-18d5-a5ab-e7f96aac39e9,8,576915,576947,587898,585360,10951,10983,32,0,0,0
587987,6b86a951-b7f7-45b9-fb90-ab3822a11b7e,8,576905,576947,587987,593069,11040,11082,42,0,0,0
588107,a3cf31f8-c845-e9ef-c6a3-cbf1e10c8e36,1,585949,585949,588107,587178,2158,2158,0,0,0,0
588100,a0616b25-638c-6d8e-6a9a-0de2061ead52,1,585949,585949,588100,588128,2151,2151,0,0,0,0
588069,6c32e888-f4bd-7373-de04-aa492f166543,1,585949,585949,588069,588689,2120,2120,0,0,0,0
588099,b5b2446a-e55f-6b6d-9917-a01312d7a1ec,1,585949,585949,588099,587912,2150,2150,0,0,0,0
588069,d411f54e-715c-1d14-dad8-1181d608a0ff,1,585949,585949,588069,588911,2120,2120,0,0,0,0
588090,2ca9ff8f-ca89-4a53-477e-23423081bb69,1,585950,586009,588090,588085,2081,2140,59,0,0,0
588091,aef1100d-fab2-6507-0008-14d97f06d969,1,585950,586009,588091,587720,2082,2141,59,0,0,0
588118,eabb0b14-d72c-ad7a-c8d7-fee6bcdd8708,1,585950,586009,588118,587040,2109,2168,59,0,0,0
588143,011b673c-3c2c-ef2f-2215-ee0d401cd041,1,585953,586009,588143,588507,2134,2190,56,0,0,0
588179,ef2b4115-050a-a77b-3f0b-c49b38a81aaa,1,585950,586009,588179,587585,2170,2229,59,0,0,0
588190,6b79e132-c1dd-30c1-3398-861f8fd4d3b5,1,585953,586009,588190,587954,2181,2237,56,0,0,0
588256,db787079-fcdc-5b25-a627-284208b14a37,1,585954,586009,588256,587544,2247,2302,55,0,0,0
588557,36d47214-d8ff-a063-ec4e-f44ac528ecf1,1,587420,587440,588557,588460,1117,1137,20,0,0,0
590050,d4c037c4-7c4f-c4f3-2617-b8ea9992c403,1,585952,586009,590050,589131,4041,4098,57,0,0,0
590086,3d9bdea5-8e41-54cc-561d-a77b5d524c68,1,585952,586009,590086,588062,4077,4134,57,0,0,0
590123,4edb5282-674f-5777-a66b-d893ec506267,1,585950,586009,590123,589457,4114,4173,59,0,0,0
590153,9edd5a9b-a920-935f-d2eb-985f38cfa8b6,1,585952,586009,590153,591457,4144,4201,57,0,0,0
590126,b141d1f0-7a6c-9048-075e-502673ec1831,1,585952,586009,590126,588884,4117,4174,57,0,0,0
590124,567f2fa9-67ae-cc86-eb61-535fb8f09edc,1,585952,586009,590124,591731,4115,4172,57,0,0,0
591392,74345150-a968-cfa8-74d1-164081999617,32,508402,508416,591392,613332,82976,82990,14,0,0,0
591405,9c7035ea-976f-e89c-a2dc-91de4cda58eb,8,567657,567657,591405,595013,23748,23748,0,0,0,0
591398,2e6103f6-2a24-fb29-8e23-939a3f7e0269,8,576924,576947,591398,596725,14451,14474,23,0,0,0
591433,e9c0cd03-9b97-9c27-7a7b-e33fd13a895f,8,576931,576947,591433,588395,14486,14502,16,0,0,0
591747,4a7ff09e-6cf9-e859-d835-abc1ec02c360,8,567667,567717,591747,594665,24030,24080,50,0,0,0
592470,ea97e3ae-a7e3-f5e1-c88e-19d8bfe06a93,32,513593,513625,592470,590492,78845,78877,938,1,0,0
593492,e8ef04bd-300c-59bd-f2cb-48887c331451,32,508638,508656,593492,591478,84836,84854,298,1,0,0
593839,728adc3d-24a8-0550-cb6e-7c599234c7c4,32,508939,508982,593839,606477,84857,84900,523,1,0,0
594233,2e449b74-aa3b-7e3f-0de1-76796e0cf609,32,591198,591198,594233,593224,3035,3035,0,0,0,0
598741,1d115c12-693c-1915-0a7b-febf09684ea3,1,581928,581928,598741,598705,16813,16813,0,0,0,0
598949,a9b91791-054f-0c2f-77a5-703e5470ea74,1,582371,582371,598949,597643,16578,16578,0,0,0,0
598950,2c7ca24c-2660-3c5c-c9c2-061b6b892151,1,582248,582248,598950,603116,16702,16702,0,0,0,0
599400,432da027-a8c5-792a-e4f9-6eedd192dcc4,1,583347,583404,599400,599473,15996,16053,57,0,0,0
599486,36dfe182-0611-ab16-7a6f-1dae31151c58,1,582713,582713,599486,592179,16773,16773,0,0,0,0
599662,e5e5365a-2269-054d-d786-c04ee0fc3fae,1,583386,583404,599662,591775,16258,16276,18,0,0,0
599703,c9342209-06b3-17e8-81e4-fcc6a5151678,1,583345,583404,599703,593816,16299,16358,59,0,0,0
599734,847dcdd6-411a-2578-3a5e-142b02b8a68f,1,583061,583119,599734,603364,16615,16673,58,0,0,0
599774,a917db45-6590-af8d-ced9-23d625bd8a41,1,583344,583344,599774,594530,16430,16430,0,0,0,0
599833,22845732-f287-070e-b7d9-cd26fa308311,1,583059,583059,599833,593194,16774,16774,0,0,0,0
599819,b6c53b98-a5c6-7409-5ac7-795824937816,1,583367,583404,599819,594318,16415,16452,37,0,0,0
599850,058e44fa-6c65-ffc0-be13-e3215397b17a,1,583346,583404,599850,602995,16446,16504,58,0,0,0
600348,2584e912-55b0-6753-7995-ec3f9328cf63,1,583603,583603,600348,591986,16745,16745,0,0,0,0
600362,da3f43bd-cca7-52fd-bc67-fd48314f30d4,1,583823,583823,600362,601146,16539,16539,0,0,0,0
600487,4cd23528-9d0e-66cb-6221-381394ce24f5,1,584045,584065,600487,598737,16422,16442,20,0,0,0
600547,0cbc946d-c8ee-dd25-7eea-62a7d9e42019,32,389089,389089,600547,642461,211458,211458,0,0,0,0
600670,8fd32e1b-bba4-585f-2d2c-cec8294cd3e1,1,583733,583733,600670,592657,16937,16937,0,0,0,0
600913,735c64d4-989f-73ca-f619-98eeb485dc54,1,584259,584259,600913,598686,16654,16654,0,0,0,0
601056,9771ab1d-d7e5-8438-2357-6198ed6f37cb,1,584005,584005,601056,593391,17051,17051,0,0,0,0
601089,088c773f-6e73-c967-bfa0-25fba2108df0,1,584926,584926,601089,604053,16163,16163,0,0,0,0
601294,08e22b14-468f-a3cf-af81-968cc8fdc2a3,1,584538,584547,601294,603615,16747,16756,9,0,0,0
601349,45e3d4db-2dca-8cfd-cf14-c22768919a50,1,584514,584547,601349,608167,16802,16835,33,0,0,0
601523,0a1092c7-1c52-4935-cca3-94412bd93d32,1,584680,584680,601523,603199,16843,16843,0,0,0,0
601592,ff1630aa-642c-643c-87f3-65b89b6ece02,1,584926,584926,601592,596229,16666,16666,0,0,0,0
601795,35d07b39-1409-3ec2-5a9c-d70b81ffcde6,1,585118,585118,601795,607884,16677,16677,0,0,0,0
602075,e3729afb-5bc4-f273-c236-d295c0695fb8,1,585787,585787,602075,599002,16288,16288,0,0,0,0
602133,761559ac-415d-dcd0-3479-178b71fade8a,32,514457,514457,602133,567430,87676,87676,1816,1,0,0
602987,4a00ac64-245b-6ac3-093e-f4f8023f5d87,8,579044,579044,602987,593965,23943,23943,0,0,0,0
603334,385221fc-974b-3906-f67c-9ca42758c48e,32,597905,597913,603334,602868,5421,5429,8,0,0,0
603807,9f9f6fbe-7bfa-013c-d77d-2ca5a4424db0,8,578825,578825,603807,607752,24982,24982,0,0,0,0
603808,471886d9-893a-9348-035f-2c0648ae3a47,8,578846,578885,603808,602245,24923,24962,39,0,0,0
603933,d2cd66ea-1b13-b5a8-f1ec-2acf230c1da7,8,578861,578885,603933,601153,25048,25072,24,0,0,0
604150,a08f1019-0182-ea71-07f4-d1b32e2d6b83,8,579053,579104,604150,604205,25046,25097,51,0,0,0
604185,a51c67a2-e10d-3cfd-0e98-ddb8bac93cc8,8,578834,578885,604185,604672,25300,25351,51,0,0,0
604259,4169ed13-be0a-f8f5-18f0-56ac07b873ee,8,579062,579104,604259,597779,25155,25197,42,0,0,0
606557,dc3c9f65-e244-716d-93ca-fcc87aaa842c,32,514357,514357,606557,576980,92200,92200,1070,1,0,0
614583,f1e9f9bd-4813-9734-d6f1-bb12d2f98849,8,596312,596312,614583,619536,18271,18271,0,0,0,0
616048,14affcd7-845d-0f4f-beef-6c30e6b520f5,8,327546,327603,616048,752564,288445,288502,57,0,0,0
622786,57e700aa-fc25-a15f-b064-9c85e1da674a,8,621440,621440,622786,622474,1346,1346,0,0,0,0
622871,70d5fc1f-b116-b989-9e7e-7a565b579381,8,621373,621380,622871,622615,1491,1498,7,0,0,0
624738,341e3037-1f83-5e17-d8ff-fd02d021dc98,1,623904,623955,624738,624695,783,834,51,0,0,0
624756,7a04d8fc-1411-8760-1801-1cfb52fd641f,1,623904,623955,624756,625066,801,852,51,0,0,0
624775,43361f25-3897-bfe3-a642-f14a83f522aa,1,623905,623955,624775,624401,820,870,50,0,0,0
624777,ec084346-882b-c051-e54d-1d36808576f2,1,623905,623955,624777,625082,822,872,50,0,0,0
624887,d57c24c9-e45c-93d9-457e-bfdb4011149c,1,623895,623895,624887,624810,992,992,0,0,0,0
626013,cea97194-cbd6-ce75-bf45-4da8414ecf02,1,623903,623955,626013,625586,2058,2110,52,0,0,0
627519,f8cb90b0-83a4-595e-a4f7-b5fda9ef792a,8,609174,609222,627519,631207,18297,18345,48,0,0,0
628066,fb7078bd-6340-254d-5695-a1eaab2cfc98,32,514601,514617,628066,674902,113449,113465,3042,3,0,0
629095,bd932d55-3a98-85a4-285d-ebd608988462,1,623895,623895,629095,629134,5200,5200,0,0,0,0
629136,1ad3f860-3a78-4698-e406-1e17b147f7a5,1,623896,623955,629136,631274,5181,5240,59,0,0,0
629102,644df27a-ba2e-3b7d-3563-bbdbd0ff5686,1,623900,623955,629102,627142,5147,5202,55,0,0,0
629151,cc9e4387-f082-c877-2fc6-2e86769e2dc4,1,623902,623955,629151,629053,5196,5249,53,0,0,0
629186,e581c40b-e99d-fbab-3652-871915f18e3f,1,623899,623955,629186,631304,5231,5287,56,0,0,0
629212,4075d54f-ebcf-8f94-bc1a-494be071fdc2,1,623900,623955,629212,629300,5257,5312,55,0,0,0
629210,ded0abb9-ede7-de2f-18a7-099ab7ce3179,1,623900,623955,629210,629051,5255,5310,55,0,0,0
629233,d4eab36c-f1ab-5d0d-cf58-fa1e9ee320fa,1,623900,623955,629233,629273,5278,5333,55,0,0,0
629251,2426fc0a-94d0-9368-b8c1-3be735a31f3a,1,623900,623955,629251,631488,5296,5351,55,0,0,0
629507,3afb00f9-ac2a-8ede-1b75-0a7657b643c6,8,609162,609162,629507,629159,20345,20345,0,0,0,0
629513,ea318e12-8eb9-e366-fb23-9c894a4e8666,8,601684,601684,629513,634243,27829,27829,0,0,0,0
629552,58254828-dd56-7eaf-8b1f-48b93b72ff18,1,623899,623955,629552,628978,5597,5653,56,0,0,0
629543,df8a40cb-cade-2081-e308-244810292c12,1,623900,623955,629543,626825,5588,5643,55,0,0,0
629580,f96ebcc7-67ae-73db-4298-21d9de531e47,1,623901,623955,629580,631208,5625,5679,54,0,0,0
630188,b3a99768-b304-f7e4-923a-04beedd973fc,1,623895,623895,630188,627179,6293,6293,0,0,0,0
630603,574679fc-904a-b3a5-ad80-a85c328deab9,1,623895,623895,630603,627983,6708,6708,0,0,0,0
630706,97ee66ea-b54d-03d4-8422-5042eb1be442,1,623895,623895,630706,628885,6811,6811,0,0,0,0
631484,21b80e00-138e-a7cb-d038-edd2694cad07,1,630756,630766,631484,631158,718,728,10,0,0,0
631640,713d6909-3d57-98e2-680e-18666f20c7fa,1,623895,623895,631640,628781,7745,7745,0,0,0,0
631662,b588247f-eedc-7fbf-9f38-14683c9c1cd2,8,456333,456333,631662,699763,175329,175329,0,0,0,0
631661,b9b206ec-f6c7-87a0-288e-68fb2d082293,1,623895,623895,631661,631077,7766,7766,0,0,0,0
632241,0fd6615e-c6c5-31f4-13df-62ba381ff62f,1,623896,623955,632241,633941,8286,8345,59,0,0,0
632384,dda358cb-ad4a-6e37-1022-57840fd66b4c,1,623895,623895,632384,631929,8489,8489,0,0,0,0
635059,e17e22cf-bb2b-c475-a525-c6d171d857b8,8,597853,597853,635059,652284,37206,37206,0,0,0,0
636705,fcd3c9cd-6b88-082b-0a3c-a069c134f76e,1,635343,635349,636705,637349,1356,1362,6,0,0,0
636901,238fe648-62dd-adaf-f874-481c68021f9e,1,635343,635349,636901,636139,1552,1558,6,0,0,0
638877,304bce99-5dd3-359a-3b70-28240c0dc584,8,631420,631455,638877,638728,7422,7457,35,0,0,0
640017,46cb307c-913f-48fd-4301-ab72198e3a3a,1,630881,630936,640017,640846,9081,9136,55,0,0,0
640024,397f9ba7-dc46-1101-5abf-8127189f59f5,1,630878,630936,640024,635431,9088,9146,58,0,0,0
640075,6b54c209-aa77-5836-eaea-93f679eabc73,1,630882,630936,640075,641125,9139,9193,54,0,0,0
640089,af976123-8684-2d76-0dcd-7f27322abec8,1,630876,630876,640089,636046,9213,9213,0,0,0,0
640088,f19ea54c-e8f9-46f3-91e6-66877cc9bebf,1,630877,630936,640088,643682,9152,9211,59,0,0,0
640132,d6875a11-824b-4207-cd42-d024117a4942,1,630878,630936,640132,642510,9196,9254,58,0,0,0
640164,e3be9f35-1dc9-91a6-fe8f-123bfd037828,1,630876,630876,640164,643320,9288,9288,0,0,0,0
640164,7d866fbe-614b-1beb-fff9-57b1f1d11d87,1,630876,630876,640164,638719,9288,9288,0,0,0,0
640190,0cc8c807-8174-a096-5a2d-f2b151d9170e,1,630877,630936,640190,644311,9254,9313,59,0,0,0
640166,ce976f2e-4fcf-c110-49db-d7b210aa7cac,1,630877,630936,640166,636761,9230,9289,59,0,0,0
640193,2861d243-6523-65bf-0a63-3da780dc7539,1,630881,630936,640193,635770,9257,9312,55,0,0,0
640184,aa69aac2-c0e3-09ac-fd56-6c8695bcf1b9,1,630882,630936,640184,639634,9248,9302,54,0,0,0
640189,fc713b1b-e329-a51f-c370-f6e705de7ead,1,630882,630936,640189,638991,9253,9307,54,0,0,0
640229,d736466b-222b-0436-87c7-3b310878d2bd,1,630878,630936,640229,636202,9293,9351,58,0,0,0
640245,eff43169-dadd-91de-c809-70bbb446ba8e,1,630881,630936,640245,639187,9309,9364,55,0,0,0
640281,32352fdb-f4f8-5212-20e0-4cd7ac168dcc,1,630878,630936,640281,642332,9345,9403,58,0,0,0
640283,48d5e760-b17a-c315-5ca1-eca40570b7f6,1,630882,630936,640283,635961,9347,9401,54,0,0,0
640275,08ec979a-9cbe-051d-9696-4a9b45dad18f,1,630882,630936,640275,641853,9339,9393,54,0,0,0
640430,ce8a4293-673a-38f7-6193-ab0809d73a75,1,630882,630936,640430,644099,9494,9548,54,0,0,0
640858,e944a2a5-f91c-a3fd-22aa-dd4d0131f948,8,639289,639289,640858,641133,1569,1569,0,0,0,0
641567,ef8aefd8-24d8-0f7e-48e4-bba111f133ad,8,635289,635289,641567,639334,6278,6278,0,0,0,0
641936,249b4a0e-1c1f-989f-dbd6-ed4a55741a55,8,640490,640490,641936,641761,1446,1446,0,0,0,0
641960,9b5fe73e-9b99-2612-3352-eb6c31262a60,8,640431,640490,641960,642536,1470,1529,59,0,0,0
642266,4dda5911-e6cb-3569-97c7-ab331287f53f,8,631395,631395,642266,644401,10871,10871,0,0,0,0
642411,f95c5d21-debe-8bc9-5ee3-6c5bf732e065,32,499531,499536,642411,620398,142875,142880,5,0,0,0
644763,5614a2d3-0974-73e2-78d0-1531878c9231,32,499541,499596,644763,587159,145167,145222,55,0,0,0
647058,8196ed3c-d30b-6c17-a644-190be5484340,8,632625,632625,647058,640392,14433,14433,0,0,0,0
649511,379c2a7a-9c1f-c7f1-d0c1-2a2a624f4792,8,643220,643220,649511,649387,6291,6291,0,0,0,0
650784,64a0fdc8-4813-b8ba-4eaa-09033da802e1,8,643467,643467,650784,648815,7317,7317,0,0,0,0
652429,6c556b84-f69c-511b-5fe2-a07579c2bcb5,8,646153,646193,652429,650673,6236,6276,40,0,0,0
652437,888fed6e-b773-9c47-9f8f-57a40cae965a,8,646133,646133,652437,651564,6304,6304,0,0,0,0
653908,a59b7d72-45ab-6c0d-42b8-f53b2f192ad2,8,646737,646737,653908,655390,7171,7171,0,0,0,0
654467,6398dadb-ff57-dbd7-379f-75ff357f9c30,8,529452,529452,654467,667096,125015,125015,9199,1,0,0
655804,adb53c7b-43b6-368a-3a85-2ff642d3aaf2,8,529484,529512,655804,591787,126292,126320,9299,1,0,0
655865,8dac08c7-93b1-2009-f9dd-c52d6be01cee,8,648610,648610,655865,659324,7255,7255,0,0,0,0
659349,bf6bcbd4-ee6f-e6ca-446f-4fd0db15304f,8,144216,144241,659349,450331,515108,515133,25,0,0,0
660440,17dc2a73-7442-c983-1c4b-269e40a641cd,32,514863,514878,660440,677767,145562,145577,4611,3,0,0
661156,3af87785-8fa7-c6c2-3d5d-8a24f921f178,8,654711,654767,661156,659021,6389,6445,56,0,0,0
661186,d7884b90-f471-016d-ba6d-47aeeacc91a8,8,654818,654827,661186,662108,6359,6368,9,0,0,0
661202,48244d07-67a5-e874-ec65-d11e3078c642,8,654844,654887,661202,659027,6315,6358,43,0,0,0
661271,3d154071-34b2-398e-f437-7816d75cfde4,8,650223,650223,661271,664362,11048,11048,0,0,0,0
661365,8c4d2dae-b7f6-3ccc-282d-c67419d0eebb,8,654143,654164,661365,663939,7201,7222,21,0,0,0
661419,4046249a-a886-15a9-f7a9-fcf1e135711a,8,654171,654224,661419,660917,7195,7248,53,0,0,0
661368,72733cfd-9999-ccc0-7c44-0eb2d31602a3,1,634493,634493,661368,659686,26875,26875,0,0,0,0
661500,9561dee0-77b0-9633-eafb-8da3fccdb72c,8,653908,653924,661500,660953,7576,7592,16,0,0,0
661548,6fd13b5e-8857-d802-4923-d0c9789e44cc,8,653880,653924,661548,662658,7624,7668,44,0,0,0
661587,410bf3d1-20fa-3560-bc2a-03577e4be894,8,653934,653984,661587,659468,7603,7653,50,0,0,0
662324,e3b48576-e9d2-310e-ccd2-3c50afbd8d23,8,654870,654887,662324,662922,7437,7454,17,0,0,0
663706,69f52e16-abe5-94e1-c345-f3174e7db439,8,144181,144181,663706,701837,519525,519525,0,0,0,0
663821,8c2918d1-e402-905f-2aa0-b97dca0ea52e,8,654651,654707,663821,661506,9114,9170,56,0,0,0
663832,599ef0fb-c0d3-b07f-a14e-a7d0b816a4e9,8,654625,654647,663832,662118,9185,9207,22,0,0,0
663828,95cbeb8b-2de9-00c1-011e-921d0743e8c1,8,654685,654707,663828,660359,9121,9143,22,0,0,0
663929,827e51a4-d492-e2d0-de7b-050cb9dde5c4,8,654786,654827,663929,662122,9102,9143,41,0,0,0
664395,0e51dca6-5378-2b7c-cac8-d16e6b8e51fd,8,654052,654104,664395,665180,10291,10343,52,0,0,0
664604,ee8ac382-a1e5-1a8b-fdf5-bdd931308203,8,654107,654164,664604,668311,10440,10497,57,0,0,0
664638,55f81a6f-5f0e-1de2-d933-6f8bf6eb0a2e,8,654078,654104,664638,660844,10534,10560,26,0,0,0
664924,4ded94f4-9355-58ed-b833-b633c39dff73,8,653852,653864,664924,663642,11060,11072,12,0,0,0
666380,a2bc8858-d166-7c65-fcdf-8b990c2568f9,8,654513,654527,666380,665790,11853,11867,14,0,0,0
666390,c2daf0ed-c137-a944-c468-7767952b3d41,8,654569,654587,666390,665118,11803,11821,18,0,0,0
666589,4630cd47-4c3d-afd6-41be-7687c3e1746d,8,654598,654647,666589,663043,11942,11991,49,0,0,0
667719,ddd629e4-be61-19bc-619b-62e265f241d4,8,653964,653984,667719,669393,13735,13755,20,0,0,0
667802,4d9fec20-1414-883d-a0af-0b16dd35585c,8,653992,654044,667802,674164,13758,13810,52,0,0,0
667833,daef3802-1950-555f-7b05-7bd0c9863afd,8,654026,654044,667833,670048,13789,13807,18,0,0,0
668269,7780cc97-60ff-6013-6a6a-37cd896fa553,8,653796,653804,668269,661636,14465,14473,8,0,0,0
668279,524715af-7ee6-990b-932d-6b2fcfc0426b,8,653744,653744,668279,671759,14535,14535,0,0,0,0
668977,c1c2517e-6a3f-7aef-800f-3c74b137351c,8,652800,652800,668977,671874,16177,16177,0,0,0,0
675719,2d341e87-42ec-8acc-c97f-9769b749d03f,8,651624,651676,675719,666076,24043,24095,52,0,0,0
677833,030890e2-74bf-aad3-ec23-8cc1f692a870,1,669835,669835,677833,678442,7998,7998,0,0,0,0
678393,a08eb5e1-b47d-7f4a-ffce-4856fe4605e4,1,670274,670274,678393,676746,8119,8119,0,0,0,0
678758,c063e4ed-5ade-15d6-d1c4-a375204ec480,8,654946,654947,678758,667561,23811,23812,1,0,0,0
678822,35d83110-ef24-d299-c609-fe8dccc7c6c6,1,662277,662277,678822,686004,16545,16545,0,0,0,0
678956,961312ad-ce76-b4db-adc9-f4e3ddca2485,8,654996,655007,678956,670659,23949,23960,11,0,0,0
679026,4e8bafc4-cb20-8d25-1891-f8834c8706bb,8,654974,655007,679026,671657,24019,24052,33,0,0,0
680086,523d6ef8-5646-a1b6-4a42-2ebdd16cad10,8,654923,654947,680086,669529,25139,25163,24,0,0,0
682419,eff1d130-2561-aee6-3708-e237c50e8a5e,1,674301,674301,682419,683107,8118,8118,0,0,0,0
683583,a29d5875-90f0-d802-2aa4-9db928f4100b,1,675426,675476,683583,684194,8107,8157,50,0,0,0
683897,7f337abf-ac03-ad01-ec03-ca00391473c7,1,667603,667603,683897,686269,16294,16294,0,0,0,0
683997,fecf7c8b-e572-2166-51f7-6592f01b6963,1,667432,667432,683997,676684,16565,16565,0,0,0,0
684333,9153e003-46f5-8aa6-3ad7-e670bd0a1d62,1,667759,667779,684333,687020,16554,16574,20,0,0,0
684543,e3a202fd-eb7b-2f0d-2a47-452f26768716,1,667852,667899,684543,677190,16644,16691,47,0,0,0
684589,ad7f0730-37ba-b7ec-dccd-5aec8493e39d,1,668151,668151,684589,682150,16438,16438,0,0,0,0
685125,1cfb0c3f-45d8-8d95-6db7-167ec2054454,1,668317,668329,685125,689995,16796,16808,12,0,0,0
685250,92e075f2-d1fd-f3a6-3b62-da24928c6aba,1,677235,677237,685250,688032,8013,8015,2,0,0,0
685465,489c0d72-da62-6326-6328-9f93a231a9d9,1,669131,669131,685465,680185,16334,16334,0,0,0,0
685555,3f98ce50-c01b-95b0-08ab-3a06e27868f2,1,669008,669037,685555,679294,16518,16547,29,0,0,0
685738,df0b6363-3e6d-48ce-4cff-00d740776c4a,1,669179,669191,685738,692974,16547,16559,12,0,0,0
685758,f2d40f6e-954a-0836-487d-4bfc8b72f906,1,669584,669584,685758,687530,16174,16174,0,0,0,0
685816,b78d3bbf-22e3-f603-7e7d-55f1438ad3d9,1,669433,669433,685816,689768,16383,16383,0,0,0,0
685838,27fd6298-ed10-891f-f054-6821170bdd14,1,669630,669644,685838,685221,16194,16208,14,0,0,0
685872,2f99bc94-54e0-1b03-d21a-93dc0c4d0bfc,1,669584,669584,685872,682152,16288,16288,0,0,0,0
685963,c7c33f17-4d08-5264-8353-61856dc86ca7,1,684496,684496,685963,685726,1467,1467,0,0,0,0
686188,685b58a9-78c2-249a-01f9-214f2406225c,1,669912,669912,686188,684566,16276,16276,0,0,0,0
687302,5b8cd3a4-42ff-d324-00a9-1ca3abebcd9c,1,670708,670751,687302,679095,16551,16594,43,0,0,0
688208,c3677fd9-9d60-f55c-01e5-81705e01bd99,1,680161,680206,688208,688296,8002,8047,45,0,0,0
688310,63022a08-da3a-bcc4-eab7-80311d4cde44,1,671793,671793,688310,686077,16517,16517,0,0,0,0
688780,9898c607-dc44-c0c9-e5f3-6a8ef76d59ee,8,687302,687302,688780,688056,1478,1478,0,0,0,0
688848,21a6f458-064f-a228-3986-9af6443a3ac2,8,687350,687362,688848,689445,1486,1498,12,0,0,0
689586,af1458cf-62c1-ef4c-86cc-db09f881ec7b,1,672937,672959,689586,681780,16627,16649,22,0,0,0
689608,6c847a07-0f28-6fc1-eed3-252a9f16723f,8,682202,682202,689608,693235,7406,7406,0,0,0,0
689665,ff346fe9-8861-b517-fa21-903b82b19a08,8,682228,682262,689665,688595,7403,7437,34,0,0,0
689881,b635592c-bfac-883b-ca04-068ddd87547d,1,673349,673349,689881,682226,16532,16532,0,0,0,0
690334,517d602a-cbc1-2513-e66b-0cc76a9e4054,1,673951,673951,690334,694883,16383,16383,0,0,0,0
690418,e4fcd9e8-2490-38dd-7ece-056377260dec,1,673732,673732,690418,692725,16686,16686,0,0,0,0
690988,719a0d2a-41e3-3d02-3b8a-0161eab0ccb6,1,674623,674623,690988,686766,16365,16365,0,0,0,0
691025,25a3dcf6-a1ed-075b-1ef9-d51fe329c512,8,680016,680016,691025,690005,11009,11009,0,0,0,0
692063,9a503b59-a89e-d739-ccfc-c304fb13c4ee,8,684649,684676,692063,691167,7387,7414,27,0,0,0
692290,66b6fe31-0a9c-f3f4-4d87-80d02dc3e172,1,675604,675654,692290,695881,16636,16686,50,0,0,0
694216,d5201c34-d471-7d8b-a47e-d9ff9befb06b,8,682874,682879,694216,697656,11337,11342,5,0,0,0
694294,9411bd59-11fa-f750-b61e-9e5d873e21b2,1,678037,678076,694294,692736,16218,16257,39,0,0,0
694687,624b1b88-2c1e-3c98-fd2e-1d55757e21aa,8,683652,683652,694687,696760,11035,11035,0,0,0,0
695227,ff17662b-06d9-e391-14ca-74050944c6e5,1,679110,679155,695227,698151,16072,16117,45,0,0,0
695516,4ef4ec7e-bf3b-21fb-1ff2-5e0dfcc8919e,8,684559,684616,695516,699912,10900,10957,57,0,0,0
695547,5d3e4cae-7562-2dff-390b-5083f4f271f7,8,684587,684616,695547,700599,10931,10960,29,0,0,0
695619,4e7ba20c-60ba-f8bc-9870-7b4316023f51,8,684617,684676,695619,692064,10943,11002,59,0,0,0
696209,e0db9308-9844-e343-9fd3-efc0713b4281,1,679911,679911,696209,691388,16298,16298,0,0,0,0
696495,0cd1ed94-a93c-a126-b7fb-86e03db7dd9b,1,680194,680206,696495,692588,16289,16301,12,0,0,0
696665,3ab5dc63-9c41-a3b3-8f6d-2323e280df0b,1,680133,680146,696665,692588,16519,16532,13,0,0,0
696860,3d948f32-04ee-41f5-f27b-26e4c60d8dfa,8,682255,682262,696860,697685,14598,14605,7,0,0,0
697859,d50624d6-6a9f-2613-dacc-0bfc28f724f6,8,697075,697075,697859,698013,784,784,0,0,0,0
698738,fa24f286-3820-d343-3500-0529b5a8db84,8,687810,687810,698738,701586,10928,10928,0,0,0,0
698853,6bfa4a3e-fdcb-6139-02b4-869992b0c7cd,8,698166,698166,698853,698856,687,687,0,0,0,0
698878,3ef2a267-f9bc-d06e-e903-ddd7d2372033,8,684532,684556,698878,700491,14322,14346,24,0,0,0
698983,3b61260f-fc00-5a3c-37e0-829623ec8054,8,684502,684556,698983,702106,14427,14481,54,0,0,0
698989,4d79189d-92ee-1450-fa6f-ea4c5e5dbba6,8,682851,682879,698989,691183,16110,16138,28,0,0,0
699200,c377f0ef-e637-42ea-a8a1-6e75258febe4,8,684677,684736,699200,700170,14464,14523,59,0,0,0
699307,d17e739e-3f3f-a472-0dde-8a723d1587e3,8,682819,682819,699307,703097,16488,16488,0,0,0,0
700041,7fbe64ba-c6f4-fa2b-7fa7-0f7828cbd42e,8,699370,699370,700041,699737,671,671,0,0,0,0
701937,1914d479-9ea9-58ea-be3f-60602b0e581a,1,674434,674434,701937,707296,27503,27503,0,0,0,0
705152,0e9e0a60-c20c-1b4b-ab53-839199f8b866,8,683408,683408,705152,715282,21744,21744,0,0,0,0
707892,450f7128-fcfd-fede-b298-ea0aa5abda7b,8,696851,696884,707892,711929,11008,11041,33,0,0,0
708879,d1300e62-2cfb-641e-1b02-c29637dbb397,8,697841,697870,708879,712808,11009,11038,29,0,0,0
709457,aaf73dac-adc2-ecf7-883f-3134a0900fea,8,698264,698264,709457,705084,11193,11193,0,0,0,0
711645,f9350fc2-cb2c-da3e-ad6b-2d45e2dd8660,8,695445,695445,711645,714746,16200,16200,0,0,0,0
712191,411b1399-e8e6-f528-006b-fc3a0b4a2207,8,709471,709496,712191,711101,2695,2720,25,0,0,0
712221,8d7be55d-8f05-d5d9-aa36-6c3ad0134e67,8,709436,709436,712221,713446,2785,2785,0,0,0,0
712734,a9510051-423a-e529-3f92-c00e50c32d0a,8,709715,709715,712734,712847,3019,3019,0,0,0,0
712814,c33fe513-f6e4-5cdf-35d7-9f82dd3343c3,8,709764,709775,712814,714296,3039,3050,11,0,0,0
713075,68cbbfef-c8b9-af52-cbd2-dd5a1c89a77d,8,600622,600622,713075,667575,112453,112453,0,0,0,0
713210,ddef5b92-f291-2318-85f4-30f20c81cf24,8,635494,635494,713210,705085,77716,77716,0,0,0,0
713235,b14df342-e749-c5c4-f367-3bd3b309faba,8,696824,696824,713235,716734,16411,16411,0,0,0,0
716152,7c0664aa-3ab5-1e50-f2c9-cc0fca7e2d4e,8,713183,713183,716152,716776,2969,2969,0,0,0,0
716203,2be8db63-61f8-0665-cbe8-0fbebb237359,8,713227,713243,716203,717156,2960,2976,16,0,0,0
716167,625e1ea8-c102-da6e-7a9f-143b2dc3d6a2,8,713357,713375,716167,717447,2792,2810,18,0,0,0
716255,53bc4e17-7ed9-98ff-6a57-4a5651515ada,8,713315,713315,716255,715414,2940,2940,0,0,0,0
716685,a86f490e-cca0-91a7-9f1e-2edee29b1251,32,497359,497359,716685,756942,219326,219326,0,0,0,0
716807,3f0e9926-1b68-bdbb-3ccf-d7d2b8ec0c1d,8,713419,713435,716807,718402,3372,3388,16,0,0,0
717917,c9877c38-43f7-80d6-eda1-49db0d2c55f1,8,635495,635554,717917,717658,82363,82422,59,0,0,0
718097,f5c19ff1-069a-4fb9-be14-a4b7bf4e70d9,8,695733,695756,718097,715662,22341,22364,23,0,0,0
718526,33056f33-356f-ad31-8209-284616432294,8,635494,635494,718526,734552,83032,83032,0,0,0,0
718640,16bcbb52-468e-61e5-a19f-e22a778881a1,8,635501,635554,718640,732241,83086,83139,53,0,0,0
718756,9042efc7-18ab-a437-3a34-1cc80a766472,8,716055,716080,718756,718626,2676,2701,25,0,0,0
719026,c01a48b1-6937-6c46-dc3a-bd2a62ccac09,8,716020,716020,719026,717767,3006,3006,0,0,0,0
719477,95c1f578-ab2e-5015-3125-4af3d98d3193,8,697810,697810,719477,713725,21667,21667,0,0,0,0
720962,f6555f0f-feba-4f18-ca09-2da36a6654a3,8,714516,714516,720962,723756,6446,6446,0,0,0,0
721510,e3b53326-7e22-5f21-8817-1be66602a207,1,696152,696152,721510,733067,25358,25358,0,0,0,0
721821,1934850a-e8ff-f869-f759-5b46d1264de7,8,714274,714274,721821,721853,7547,7547,0,0,0,0
722721,9f57411a-2ed4-a97b-1cc6-0b2ed5703cb3,8,715273,715273,722721,722260,7448,7448,0,0,0,0
723195,9b6bc8bd-507c-0388-0e03-1c3627623cda,1,696495,696513,723195,730223,26682,26700,18,0,0,0
723435,4c7b7e32-a422-29af-3691-ed69aa46c05b,1,696465,696513,723435,731213,26922,26970,48,0,0,0
723599,5582350e-e3d5-5b86-73da-0b24f250bf15,1,696453,696453,723599,723351,27146,27146,0,0,0,0
723750,47aadc66-c1b9-f9a5-9f69-f5d2b7680e3d,1,696489,696513,723750,720621,27237,27261,24,0,0,0
723777,e4b24b71-456e-6703-fe43-81f625d2dd5d,8,635495,635554,723777,742634,88223,88282,59,0,0,0
723836,67df989f-3c15-f4de-0ffc-5fbee5e75cba,1,696488,696513,723836,717003,27323,27348,25,0,0,0
724477,4eb1ed2a-78bf-52ff-aa1a-c604e1343536,8,721784,721784,724477,724236,2693,2693,0,0,0,0
724577,1f5b3f8d-faad-a633-21be-9f381e29c15e,8,721647,721647,724577,725650,2930,2930,0,0,0,0
724540,cfc150f3-96f2-05b5-26a9-ded1eac3c934,8,721830,721844,724540,724246,2696,2710,14,0,0,0
724838,9974c84e-5836-5e9e-6ff6-6a794278a00e,8,721696,721707,724838,724517,3131,3142,11,0,0,0
725189,5771f4cf-51af-9035-40be-e2989640f569,8,721913,721913,725189,724022,3276,3276,0,0,0,0
725560,86450a77-932a-72ab-2d9c-2e1229dd3c5f,8,714620,714620,725560,728169,10940,10940,0,0,0,0
725614,e78b7b73-2fce-a49e-c551-24489f48dfab,8,714628,714680,725614,728806,10934,10986,52,0,0,0
725684,1972acd4-728f-f4de-2813-3158e985faaa,8,700619,700666,725684,732753,25018,25065,47,0,0,0
725815,324a803a-7ef1-35fe-7d7d-38cf7f07014d,8,700606,700606,725815,736540,25209,25209,0,0,0,0
726726,99b90023-687f-719c-c45e-a576ec951111,8,715297,715333,726726,728664,11393,11429,36,0,0,0
726777,4bd362de-0191-8e38-e419-3e5263b40bb1,8,715312,715333,726777,730064,11444,11465,21,0,0,0
726849,1621b3fe-ae6f-0fa2-ea2d-97c8a469f111,8,715287,715333,726849,727447,11516,11562,46,0,0,0
727672,9611116b-a54b-ddbb-7c56-ea1b9852bf02,8,715302,715333,727672,733037,12339,12370,31,0,0,0
728707,9ab5b30a-8196-dc19-d757-81696d2ac0fc,8,714081,714081,728707,732806,14626,14626,0,0,0,0
730569,59b7de4b-dbbc-9e37-c6e0-90313eccd90a,8,721121,721153,730569,727963,9416,9448,32,0,0,0
730702,ea9a5102-4557-91ab-9422-8d75e0d0734f,8,721148,721153,730702,732623,9549,9554,5,0,0,0
732115,555dddac-99e0-859c-609b-7c1a93feba88,8,715330,715333,732115,737967,16782,16785,3,0,0,0
732162,1243a7d7-ca22-46d5-fe22-a8c383a022e0,8,715339,715393,732162,732627,16769,16823,54,0,0,0
732343,cf9e18eb-5ef8-3d15-a352-170111d36d40,8,715322,715333,732343,727487,17010,17021,11,0,0,0
733500,e76cc750-566a-3ae3-1c3d-c6fd79ff5f76,8,721093,721093,733500,731595,12407,12407,0,0,0,0
735118,fe53a960-d809-30f0-8022-eb6f9fa64655,32,655187,655187,735118,755535,79931,79931,0,0,0,0
735325,6b1ec96c-8595-c6c3-14f2-125d7bc50aea,8,720932,720932,735325,737266,14393,14393,0,0,0,0
735541,0e33ff8c-a5fb-bedb-a4e8-5719c20e9b78,8,728050,728056,735541,738340,7485,7491,6,0,0,0
737360,9e5fa747-03fe-728a-119c-ce6981bf8129,32,655105,655127,737360,706411,82233,82255,22,0,0,0
738868,d2d72c51-cd16-ae1f-7bfc-8daf96e54d70,32,654756,654767,738868,709407,84101,84112,11,0,0,0
739632,e89c8fca-22ff-e9fc-512e-5e8e4c901c59,8,733154,733154,739632,739925,6478,6478,0,0,0,0
740103,4e114722-c771-df14-3bff-55fd038d60da,1,723338,723338,740103,741807,16765,16765,0,0,0,0
740121,bfc3e5bc-800d-d8dd-541a-1fab8c6c6191,1,723784,723810,740121,740242,16311,16337,26,0,0,0
740352,c9f8892c-f9c9-68ff-9c6e-cbd2771e996c,1,723907,723930,740352,733218,16422,16445,23,0,0,0
740489,dffcde3f-0b8a-7cc7-077e-335fe5669825,1,723880,723930,740489,742628,16559,16609,50,0,0,0
740551,0d43240a-8dfc-fcef-a434-6ef744c88d0d,1,724028,724028,740551,736383,16523,16523,0,0,0,0
740683,704cc8c3-af70-6ace-7c68-5f752ec5ee8a,1,723917,723930,740683,747545,16753,16766,13,0,0,0
740813,33057c2b-939c-5a82-9406-b31cc81e34bd,1,724516,724524,740813,748133,16289,16297,8,0,0,0
740934,ce4d2b97-ed12-1765-072c-365156083dd8,1,724748,724797,740934,745147,16137,16186,49,0,0,0
740965,b06897c7-7919-0580-f636-e36ccf0ebecc,32,655149,655187,740965,741368,85778,85816,38,0,0,0
741024,668a631f-e2f9-d470-1d20-14765a820f9c,1,724677,724677,741024,740506,16347,16347,0,0,0,0
741097,bac2b1e1-4125-f4e2-1894-8127b76091df,1,725052,725067,741097,743871,16030,16045,15,0,0,0
741154,18709d0d-62a1-22f4-400b-c861713812b7,1,724947,724947,741154,741708,16207,16207,0,0,0,0
741243,468943bb-3a87-b4bc-a9a7-22342b2ee058,1,724464,724464,741243,748602,16779,16779,0,0,0,0
741298,ad5e84ea-689f-9d10-3255-c51c646ee45b,1,724514,724524,741298,738043,16774,16784,10,0,0,0
741304,c7735881-dfbe-8420-025e-bdbb21a4f525,1,725030,725067,741304,744668,16237,16274,37,0,0,0
741320,547833ab-fa98-a0fe-37a9-56913907bb02,1,725053,725067,741320,735681,16253,16267,14,0,0,0
741372,6522ab52-4a1b-5865-a3ce-8cd6a6ac512e,1,724692,724737,741372,737272,16635,16680,45,0,0,0
741499,06a0bfb4-5df0-fb26-67b4-37155c9379a6,1,725057,725067,741499,737419,16432,16442,10,0,0,0
741528,8ebbcfe7-11ee-0e9c-e373-848bdfbcec8a,1,725052,725067,741528,737781,16461,16476,15,0,0,0
741614,7d2cb094-deae-4d81-c1a9-630621147929,1,724997,725007,741614,747353,16607,16617,10,0,0,0
741608,0c333eae-ce89-b3d4-5e8a-93c3ecdce9e9,1,725446,725446,741608,741555,16162,16162,0,0,0,0
741635,f650110f-8449-6db2-abad-14637e40a19a,1,725051,725067,741635,747332,16568,16584,16,0,0,0
741747,578640ed-cbd1-e833-efd4-540c89873a80,1,725537,725537,741747,747100,16210,16210,0,0,0,0
741776,a5cbb17a-372e-1b58-a7a0-9ef766668d28,1,725538,725597,741776,748450,16179,16238,59,0,0,0
741904,29f25560-81c7-f30b-5955-5048cf27a449,1,725539,725597,741904,738376,16307,16365,58,0,0,0
742171,5e80cdad-d7ed-953c-4e23-6d9ac4d47f96,1,725543,725597,742171,741314,16574,16628,54,0,0,0
742230,922b6cc2-142f-489d-9da5-0aa7a27bb807,1,725538,725597,742230,742138,16633,16692,59,0,0,0
742345,8c542108-9603-df79-eac5-0d4b9902fea3,1,725538,725597,742345,736533,16748,16807,59,0,0,0
742403,4fe08871-15f5-4aa0-3e42-ee14f70c276c,8,730905,730905,742403,739683,11498,11498,0,0,0,0
742877,2c602f4d-a0bf-8d48-99c2-e92bcd7b5bd3,8,731564,731564,742877,747546,11313,11313,0,0,0,0
742937,06f6bdbe-bd8b-f35d-c5fc-ff79f884f2a7,32,475283,475283,742937,872451,267654,267654,0,0,0,0
743141,c588fef6-44bd-dc5a-aae4-6e4065a1311d,8,731626,731626,743141,743737,11515,11515,0,0,0,0
744276,1e161cb2-36e2-0576-35ed-8ef2eb79a7b1,1,727936,727936,744276,742021,16340,16340,0,0,0,0
746343,b58b82e7-2758-77ee-38dd-cdccb8531458,8,729431,729463,746343,741306,16880,16912,32,0,0,0
746460,89fdb00c-ed23-8378-4be3-e66aca8f9ccb,8,729461,729463,746460,742972,16997,16999,2,0,0,0
746716,dc61f0b4-d9a6-c596-0aee-c599e1bb63f6,8,635503,635554,746716,745799,111162,111213,51,0,0,0
746910,73290262-078b-89da-8ba7-1aac186a2bc2,8,739252,739252,746910,744470,7658,7658,0,0,0,0
747377,79455b37-eeb2-3ee8-60ca-3bb3362d3b14,8,733008,733008,747377,751137,14369,14369,0,0,0,0
747421,befc3195-8723-280b-9a66-3d0a333c82bf,8,733069,733069,747421,740643,14352,14352,0,0,0,0
749164,732a1405-5d5a-5f54-c19f-dfc8745ceb19,8,726642,726642,749164,748488,22522,22522,0,0,0,0
749697,72235a9a-5365-3eaa-70e3-f18b8148774d,8,727603,727603,749697,748505,22094,22094,0,0,0,0
749927,5ab91fbd-b052-df0f-a8d1-87a3354a922f,8,727660,727663,749927,748562,22264,22267,3,0,0,0
750050,44de96e0-dd0d-27dd-ac56-ade449515159,8,727631,727663,750050,749304,22387,22419,32,0,0,0
751032,3616c37c-4800-9596-ae14-aa404dd5dda9,8,728593,728593,751032,743014,22439,22439,0,0,0,0
751905,e8727d9e-dfb5-0929-bd2e-2920ad5f2634,8,729403,729403,751905,749354,22502,22502,0,0,0,0
752851,c339d513-afa2-c76a-29d9-525f793aec89,8,745239,745239,752851,750124,7612,7612,0,0,0,0
754923,1f3ba175-e6ea-2ac4-7818-427595dd68c5,8,420702,420702,754923,780459,334221,334221,0,0,0,0
755087,74f1c689-9a6d-4c4b-3890-135e09bb6d1a,8,743966,743966,755087,758364,11121,11121,0,0,0,0
756086,5c8f6375-a2c6-8f57-f52e-ffa6ed323242,8,741403,741423,756086,761421,14663,14683,20,0,0,0
756393,89b34014-6447-02b9-bda5-dc2287f18545,8,741730,741739,756393,758542,14654,14663,9,0,0,0
756940,3b3f8cf5-9045-d088-ca41-de7ecf1811a1,8,742245,742291,756940,749574,14649,14695,46,0,0,0
756984,72413a2d-cb1a-8877-4436-a3791a80f44e,8,420711,420762,756984,754914,336222,336273,51,0,0,0
757022,5a57ea29-6251-8f4d-d07e-558dcae92154,8,749391,749391,757022,755066,7631,7631,0,0,0,0
757698,7f23a32f-ba18-a17b-7d74-dbf11cedf027,8,621447,621500,757698,768111,136198,136251,53,0,0,0
757706,2fbbbf51-6fc9-24d0-755b-c673b3d948a5,8,621341,621380,757706,708181,136326,136365,39,0,0,0
757771,c5305d2f-e0e2-3223-b415-96a3d05f6669,8,750091,750110,757771,758103,7661,7680,19,0,0,0
757970,aca399e1-0395-8342-45a3-3e2bac282dd0,8,621330,621380,757970,762103,136590,136640,50,0,0,0
758476,629ecdf0-8670-bf5d-83fb-da1d6c9faa95,8,743844,743844,758476,754773,14632,14632,0,0,0,0
758529,387a0203-a4a0-3177-a12d-73877986ee05,8,743892,743904,758529,761067,14625,14637,12,0,0,0
758573,a9ab7301-ea34-eefd-2bdd-f9eff02a0cc9,8,743866,743904,758573,760780,14669,14707,38,0,0,0
758685,2c9708a2-e7b3-49bb-aaa4-cc5ae330ed6a,8,621397,621440,758685,801015,137245,137288,43,0,0,0
758691,6915324c-bd26-366a-5ae6-f4a75e3266b2,8,621354,621380,758691,695793,137311,137337,26,0,0,0
758907,dfceadd0-c01c-77fd-e464-800f0fe5c896,8,621320,621320,758907,795352,137587,137587,0,0,0,0
760357,d824eb54-278c-33bf-5976-f5f9ac1c94f9,8,621414,621440,760357,792011,138917,138943,26,0,0,0
763930,52fd8d5b-04f6-7d68-0126-32587893f0a7,8,755046,755046,763930,759865,8884,8884,0,0,0,0
763944,fd92ea2a-da0b-7ca4-2548-f600e2f27f04,8,755092,755106,763944,767268,8838,8852,14,0,0,0
763944,6f66b39d-a6ba-8cae-6490-bd17ce9be26b,1,757442,757445,763944,761399,6499,6502,3,0,0,0
763929,aac16b42-58d6-e90d-3f0b-dbdaef9e83f4,1,757457,757505,763929,764954,6424,6472,48,0,0,0
763982,e96db244-bc63-a797-c7fe-1c59b903173b,8,755154,755166,763982,762115,8816,8828,12,0,0,0
763974,10d2279d-086f-398c-f5f4-9802c25db35d,1,757443,757445,763974,765020,6529,6531,2,0,0,0
763983,9e22d9bc-9ae2-b6d2-18cd-f714d3ff7e55,1,757456,757505,763983,766696,6478,6527,49,0,0,0
763975,05f02460-438c-6378-e6b9-cb0b7357501e,1,757459,757505,763975,761549,6470,6516,46,0,0,0
764017,454b7d38-c8da-f6b4-18ed-915003c66415,1,757442,757445,764017,762802,6572,6575,3,0,0,0
764017,db0dc112-0123-0278-8d0b-0c010c961c84,1,757442,757445,764017,764863,6572,6575,3,0,0,0
764025,324edaa7-f36e-525b-6b18-d634ef1b64cb,1,757443,757445,764025,761552,6580,6582,2,0,0,0
764049,5b27737f-463b-a616-be21-3a6b567136ce,1,757443,757445,764049,762292,6604,6606,2,0,0,0
764016,21fc7a0e-db8a-e0c4-d716-f3e25b07f521,1,757443,757445,764016,761593,6571,6573,2,0,0,0
764054,40685469-5a88-43ed-6686-1921057de4d0,1,757445,757445,764054,762356,6609,6609,0,0,0,0
764066,57f00393-3893-4037-960c-2e545d30005d,1,757453,757505,764066,762337,6561,6613,52,0,0,0
764057,e4329c84-c3cd-8b60-d82e-a39422098287,1,757454,757505,764057,765433,6552,6603,51,0,0,0
764058,4d2a0724-da92-891e-40d0-c50853a693f9,1,757454,757505,764058,764728,6553,6604,51,0,0,0
764081,9786ef9d-60b5-34d6-ac96-9a011622de6f,1,757442,757445,764081,763955,6636,6639,3,0,0,0
764092,5f7a51ba-7f33-1ead-2808-9c29e55ed31a,1,757443,757445,764092,763915,6647,6649,2,0,0,0
764105,30f20ae6-4ee5-9dad-3bcb-78f0af6b193f,1,757451,757505,764105,765613,6600,6654,54,0,0,0
764175,da9338f6-8995-791d-8ed3-afeff897c7d9,1,757449,757505,764175,762423,6670,6726,56,0,0,0
764174,2cace42c-d7a2-6db7-a2b7-7abd363efe12,1,757449,757505,764174,764985,6669,6725,56,0,0,0
764176,6e92f1de-83bf-8b10-2bae-8604e257417f,1,757452,757505,764176,765634,6671,6724,53,0,0,0
765023,6d1b5b9c-f4dc-7dae-b987-1bae0643ab4d,8,753892,753892,765023,762507,11131,11131,0,0,0,0
765128,de666672-9389-82e0-0b4a-e3a6d777834c,8,757437,757445,765128,768284,7683,7691,8,0,0,0
765363,66722dfa-634d-2c50-28c2-cbfc484411ef,8,757739,757758,765363,762677,7605,7624,19,0,0,0
765876,9526be4f-8e25-2bff-fe0c-97471ac9571f,16,561012,561012,765876,800507,204864,204864,0,0,0,0
766439,38ec71d7-dd9b-6aa4-483a-d196faa5169d,8,758745,758745,766439,765361,7694,7694,0,0,0,0
766467,dcb3debf-47f2-115a-133a-121fcc7d0df2,8,758773,758805,766467,766093,7662,7694,32,0,0,0
766713,abc09a0d-a6f1-3da2-9759-d0babbd2cd6e,8,628723,628745,766713,729819,137968,137990,22,0,0,0
766717,e1c8bda5-3c10-8cb9-67b9-b1f9e5a472ca,8,755580,755620,766717,767315,11097,11137,40,0,0,0
766784,148e0d1e-5071-e6fe-bbea-1575d2b25bdd,8,629993,629993,766784,785605,136791,136791,0,0,0,0
766916,45384b24-8dae-661c-a6bb-a95a39d8ddac,1,760508,760508,766916,768923,6408,6408,0,0,0,0
766917,5c06d8c9-1820-9669-e8ba-07778b4f36e8,1,760508,760508,766917,765560,6409,6409,0,0,0,0
766894,d74c5866-8f1c-b614-386b-35a1ce8987fb,1,760508,760508,766894,769170,6386,6386,0,0,0,0
766932,c102ec3b-329c-bd35-d9da-ea9da5bef82e,1,760508,760508,766932,769695,6424,6424,0,0,0,0
766946,cb7f47c9-60b5-b8dd-7d37-0e2815c83934,1,760508,760508,766946,767950,6438,6438,0,0,0,0
766993,b9883c81-83f5-eff3-d01d-cc67a4276689,1,760509,760568,766993,767567,6425,6484,59,0,0,0
767013,2cf3d8b6-823b-24a4-0c0c-a4d0daf72151,1,760596,760628,767013,766661,6385,6417,32,0,0,0
767083,919e31c8-1a59-b3fa-dfd8-6e7f0c7ed2be,8,628685,628685,767083,725583,138398,138398,0,0,0,0
767071,32e631a9-dea8-2665-ec7a-641c4ed3e5ff,1,760594,760628,767071,768521,6443,6477,34,0,0,0
767152,3e027b1f-e38d-9d98-f39b-fd7bc906f88b,1,760514,760568,767152,769981,6584,6638,54,0,0,0
767142,0538ffa9-cd40-e071-0538-8c79cd7907e7,1,760518,760568,767142,767959,6574,6624,50,0,0,0
767166,ded75190-97b6-6ddf-7e26-96fd5f916dda,1,760575,760628,767166,766244,6538,6591,53,0,0,0
767135,11701ddc-95ea-fedc-6bbb-62c5780ae0ac,1,760590,760628,767135,769964,6507,6545,38,0,0,0
767207,4e3be7b2-ca5a-a416-b95b-fa5cc35e62d8,1,760509,760568,767207,764863,6639,6698,59,0,0,0
767209,931a8fd8-450b-bc4f-a56d-bdb2ca634b88,1,760510,760568,767209,769016,6641,6699,58,0,0,0
767167,75462208-3172-a25b-a1dc-af262782ae78,1,760512,760568,767167,765422,6599,6655,56,0,0,0
767183,21da109b-71a4-1e7c-e1ac-fdb3d70e773a,1,760517,760568,767183,765501,6615,6666,51,0,0,0
767183,421f1de9-2fd4-332e-a71a-059597ff4ccc,1,760519,760568,767183,766922,6615,6664,49,0,0,0
767184,ef8f5c2f-5e73-688b-a5ad-c325526c610b,1,760519,760568,767184,766158,6616,6665,49,0,0,0
767186,8de2fc8d-c055-ceb0-b9ee-224709fccdac,1,760520,760568,767186,764782,6618,6666,48,0,0,0
767179,ed3fa2a2-8eb2-d52f-4f5b-2740520bacdc,1,760523,760568,767179,769163,6611,6656,45,0,0,0
767178,8f6ba093-f836-bd42-797c-070d02b1707e,1,760523,760568,767178,764520,6610,6655,45,0,0,0
767181,2c33e08a-8672-f96f-413b-07383f3f433d,1,760525,760568,767181,769722,6613,6656,43,0,0,0
767182,6f4dd75a-f19e-24ab-090a-a3c69075e069,1,760525,760568,767182,766137,6614,6657,43,0,0,0
767181,4cef5b30-d8d8-467a-9286-62892caeef83,1,760525,760568,767181,765491,6613,6656,43,0,0,0
767176,32a450fb-6645-8cff-e9b6-a838cad8abab,1,760528,760568,767176,765354,6608,6648,40,0,0,0
767177,a41da450-8653-4d3b-296c-6d2e453424db,1,760528,760568,767177,766928,6609,6649,40,0,0,0
767952,297a6125-ec06-9695-4add-e649bbd0891e,1,762901,762901,767952,768271,5051,5051,0,0,0,0
767984,5f4e3f9c-1275-46d6-b8b3-4edccf02bdb8,1,758988,758988,767984,764517,8996,8996,0,0,0,0
767985,41dabbdc-f32a-d9a1-eea8-dac74e531789,1,762905,762961,767985,770006,5024,5080,56,0,0,0
768045,87e5fd7d-83d0-4ee6-6723-d9bbbc78d32b,1,758988,758988,768045,767853,9057,9057,0,0,0,0
768057,eeed8d1d-88ef-b0fb-52b5-065165d141dc,1,763004,763021,768057,766652,5036,5053,17,0,0,0
768058,c28d3086-03b5-22b5-5e7b-8a4647af6161,1,763012,763021,768058,766757,5037,5046,9,0,0,0
768232,be063f44-28e6-9d58-4c10-3b64623d134f,1,758989,759048,768232,771498,9184,9243,59,0,0,0
768286,334c0920-3f94-3466-0910-24e77bdf1628,1,758989,759048,768286,768310,9238,9297,59,0,0,0
768266,05e99fae-b3b2-cd04-3535-898c3628746c,1,758989,759048,768266,764591,9218,9277,59,0,0,0
768268,b092e5d3-da5a-a48c-868a-d1f436151464,1,758998,759048,768268,768856,9220,9270,50,0,0,0
768289,7fc35f14-0e76-b505-328f-b911d31466df,1,758998,759048,768289,771609,9241,9291,50,0,0,0
768240,394db3b4-a3c0-386c-c9f6-8a57c80bca2e,1,759003,759048,768240,765386,9192,9237,45,0,0,0
768316,ec7e91c6-0800-0a94-b2d3-5cb174295188,1,758989,759048,768316,764811,9268,9327,59,0,0,0
768295,1baa324b-df21-84d6-642e-aae2a04b2402,1,758989,759048,768295,764299,9247,9306,59,0,0,0
768350,86010a70-e25f-d611-9d79-0f80b5875e15,1,758999,759048,768350,771294,9302,9351,49,0,0,0
768349,db332345-ade8-4d92-6941-9fbd8dc40c8b,1,758999,759048,768349,768803,9301,9350,49,0,0,0
768318,2620c92b-51d5-db5f-4bbc-ed0fb5e575f5,1,759002,759048,768318,769080,9270,9316,46,0,0,0
768323,76200721-13a3-c73e-aa81-07f04f411f39,1,759004,759048,768323,767703,9275,9319,44,0,0,0
768366,0a7bf7f2-3d49-d1d7-bd0a-239abcd7bda6,1,758989,759048,768366,770381,9318,9377,59,0,0,0
768357,8f99c231-e677-8e35-a3aa-2afd9979337b,1,758995,759048,768357,764294,9309,9362,53,0,0,0
768358,540b61dd-465b-d14b-188b-8277b091b483,1,758996,759048,768358,767908,9310,9362,52,0,0,0
768426,d9b523c9-50d4-e568-9e61-575ca914f701,1,758989,759048,768426,764855,9378,9437,59,0,0,0
768417,ef95d35a-d7e3-4b19-ad02-af6c55cc57fe,1,758989,759048,768417,770220,9369,9428,59,0,0,0
768440,0fb5600a-12d5-e6b5-37d2-358beea28bbb,1,758995,759048,768440,764803,9392,9445,53,0,0,0
768668,d7837d06-1526-8fbc-903c-4965d1e1b440,8,757385,757385,768668,764815,11283,11283,0,0,0,0
768670,ae0cd662-019f-fde2-42a1-8b121abd8389,8,757410,757445,768670,766952,11225,11260,35,0,0,0
768741,bdf1c452-d44f-6578-cb6f-328277e147b6,8,757541,757565,768741,771992,11176,11200,24,0,0,0
768996,67561314-e21b-dad8-d6c1-ea631f625067,8,757717,757758,768996,763720,11238,11279,41,0,0,0
770026,530506a2-2a83-a7ae-0d31-321c0eb570cb,8,758722,758745,770026,764818,11281,11304,23,0,0,0
770748,b4415fe9-81d9-0b3b-386a-4d9c63c606ca,1,764340,764340,770748,770431,6408,6408,0,0,0,0
770825,f7c42540-14eb-fcda-a64e-88d0b66a97eb,1,764341,764400,770825,768073,6425,6484,59,0,0,0
770877,be4097fe-a1da-08a5-d7a8-00b9242e8f55,1,764340,764340,770877,770763,6537,6537,0,0,0,0
770832,72e47ae7-f61d-0738-f62d-f00af591af66,1,764340,764340,770832,770801,6492,6492,0,0,0,0
770827,b219aa6d-0f2d-e639-7f60-6d69f6107fd6,1,764341,764400,770827,771058,6427,6486,59,0,0,0
770900,d50d4252-e272-e218-b471-6f2a37188d41,1,764341,764400,770900,773922,6500,6559,59,0,0,0
770899,e4cd4319-f552-51ec-de6b-51a5257b92de,1,764341,764400,770899,769356,6499,6558,59,0,0,0
770920,39ad65e2-ccc7-7300-2d4a-97b4f0a78c1c,1,764348,764400,770920,772907,6520,6572,52,0,0,0
770920,f0d6fddb-92fa-504c-722b-22cba5c91055,1,764350,764400,770920,773469,6520,6570,50,0,0,0
770940,3b0305cd-d49d-8b27-1f99-ce04f625b970,1,764353,764400,770940,769916,6540,6587,47,0,0,0
770932,f8f89c57-123c-e770-8e24-79e726019167,1,764356,764400,770932,773137,6532,6576,44,0,0,0
770949,50f93ad2-317c-72c2-dc21-2415a306b2fe,1,764341,764400,770949,768781,6549,6608,59,0,0,0
770959,a416b291-cbc0-fa3c-22af-2a77e963494c,1,764342,764400,770959,773380,6559,6617,58,0,0,0
770977,d32b8be3-eaac-fc80-7b37-ae6af749f998,1,764343,764400,770977,769340,6577,6634,57,0,0,0
770968,02073773-82e1-7e9c-a9ee-cd670396d3f0,1,764352,764400,770968,773470,6568,6616,48,0,0,0
770969,1f769f37-f704-0252-ec5d-79290282c3df,1,764355,764400,770969,768519,6569,6614,45,0,0,0
771007,b1e0ab01-56a8-274f-00f9-14bf122a223f,1,764346,764400,771007,773411,6607,6661,54,0,0,0
771006,9b1025a3-89f7-8cf7-c4a6-27f57cbef196,1,764350,764400,771006,773424,6606,6656,50,0,0,0
771031,9aeedfff-f2d3-ce65-6163-2655201834f5,1,764356,764400,771031,774015,6631,6675,44,0,0,0
771075,2a291ea2-e680-159b-1b83-e18b1a3543b5,1,764348,764400,771075,767696,6675,6727,52,0,0,0
773011,50fcdd45-6dac-7e27-fa7e-921fc34e1629,8,765282,765315,773011,770079,7696,7729,33,0,0,0
773066,8241824e-87df-7ea6-4039-5ec0af8aa755,8,765307,765315,773066,771075,7751,7759,8,0,0,0
773111,d8a52295-82a7-c0e9-44f5-f256f8f51175,8,765333,765375,773111,773085,7736,7778,42,0,0,0
773265,e1eba0d7-e707-90b0-81dc-81e0a0902bd4,8,765423,765435,773265,770966,7830,7842,12,0,0,0
773273,db468277-34d1-3432-2bdb-d9366a45cad0,8,765403,765435,773273,769852,7838,7870,32,0,0,0
773382,277da450-b838-7d96-ff62-5492276a62bf,8,765486,765495,773382,775890,7887,7896,9,0,0,0
773439,41dbc918-9729-8a48-f9b1-2bdf38f14931,8,765496,765555,773439,773156,7884,7943,59,0,0,0
773421,ec76741d-03e8-685d-ce9b-e989623521fd,8,765506,765555,773421,774381,7866,7915,49,0,0,0
773503,bd5787da-c9a2-8163-620d-ecfca85b9ee6,8,765691,765691,773503,774494,7812,7812,0,0,0,0
774365,812331dc-1935-1b6c-f4e9-9572de3a0eeb,8,766626,766626,774365,776422,7739,7739,0,0,0,0
774583,01ddd910-8664-e5a3-7b66-efa2f7c430ca,8,766747,766806,774583,776271,7777,7836,59,0,0,0
776402,2f4a1dab-b5df-f070-f856-63945623ad9c,8,765195,765195,776402,776675,11207,11207,0,0,0,0
776618,c5fe5b58-87e9-4307-e8f2-6352e5de7e4f,8,765236,765255,776618,777553,11363,11382,19,0,0,0
776655,837c9e63-13b1-329b-2a63-c44ee5c67b63,8,765258,765315,776655,779479,11340,11397,57,0,0,0
776929,dd7edcf9-fbf0-bc30-da61-73ed594a4f2e,8,765441,765495,776929,781833,11434,11488,54,0,0,0
776934,becc1545-21bc-dcff-20a7-b4a8376b1e42,8,765461,765495,776934,775893,11439,11473,34,0,0,0
776918,e844ba31-0628-0b15-1606-a6df33c42500,8,765538,765555,776918,781107,11363,11380,17,0,0,0
777048,d327e3a3-4ed0-d2e4-bfe1-3bd9d997783d,8,765518,765555,777048,775804,11493,11530,37,0,0,0
777076,97a8ba9c-2de1-e67e-a368-c88b67493e68,8,765527,765555,777076,772482,11521,11549,28,0,0,0
778071,c8422488-e73b-63f3-63cb-b1482062c43e,8,766699,766746,778071,781357,11325,11372,47,0,0,0
778125,72854c02-30fd-4a4d-435a-04db718fbb7c,8,766721,766746,778125,781884,11379,11404,25,0,0,0
778999,4efe4591-64b9-1ffc-2eb7-8b1b12456efb,8,764363,764400,778999,775886,14599,14636,37,0,0,0
779027,44f36f67-9f9f-cd78-719e-5eb1afcb7996,8,764411,764460,779027,781069,14567,14616,49,0,0,0
780348,1360d6b6-ff8a-cb6e-c66a-60658c513a02,8,765372,765375,780348,785552,14973,14976,3,0,0,0
780556,d46f3287-0d35-c979-6107-5f583194cdf0,8,765506,765555,780556,786370,15001,15050,49,0,0,0
780678,6e1ffad0-0601-9d55-27e7-ee49b713f415,8,765484,765495,780678,773545,15183,15194,11,0,0,0
780658,052a6bca-beed-f20b-dd80-39c584d5e55f,8,765549,765555,780658,774748,15103,15109,6,0,0,0
780729,3512902b-0444-e642-8249-dfeb36dd9d1e,8,765568,765615,780729,785141,15114,15161,47,0,0,0
780776,5a417c45-e2fe-45b4-0dda-442f008b8631,8,765559,765615,780776,781989,15161,15217,56,0,0,0
781500,1ef92ea3-f559-b947-9db0-9722f3cf37eb,8,766650,766686,781500,787147,14814,14850,36,0,0,0
781605,ef8f8421-bb28-a937-48c4-3b53dee730eb,8,766677,766686,781605,785259,14919,14928,9,0,0,0
781629,c0fe426c-9be5-9324-ac5d-6644b2852a61,8,766796,766806,781629,775738,14823,14833,10,0,0,0
781605,471f681d-461d-937d-1afc-6bb9943cc1a3,8,766817,766866,781605,774555,14739,14788,49,0,0,0
781870,a5606400-5609-0d10-1b3d-393a798cd4ba,8,766842,766866,781870,787443,15004,15028,24,0,0,0
781905,fb283cf7-2856-d926-832a-ddf4e42e3418,8,766868,766926,781905,786349,14979,15037,58,0,0,0
781908,2f0214e2-17ab-aba2-7f38-71f450c8fb05,8,781026,781055,781908,781975,853,882,29,0,0,0
784184,b6027ca6-3a2e-a5c7-08eb-a0a8fecab879,8,776272,776329,784184,786229,7855,7912,57,0,0,0
785010,6e7659e3-9baf-e924-5da6-01ea61875ae0,1,778527,778552,785010,787817,6458,6483,25,0,0,0
785076,eff06023-6929-8548-c678-ba620de14b43,1,778526,778552,785076,785592,6524,6550,26,0,0,0
785066,8ca6790d-34ec-a6ca-4a48-93977c23ee89,1,778527,778552,785066,786701,6514,6539,25,0,0,0
785114,d10c7983-9123-7a9d-4f77-283d94dbaa54,1,778528,778552,785114,786567,6562,6586,24,0,0,0
785058,8ce3204d-5878-4fbd-ebc8-a0d77a8561c0,1,778528,778552,785058,783599,6506,6530,24,0,0,0
785114,483385ec-bdaa-9bdd-5886-067f15467803,1,778536,778552,785114,785418,6562,6578,16,0,0,0
785098,fc804f90-a76b-9d80-700f-a7aced6daec9,1,778538,778552,785098,783204,6546,6560,14,0,0,0
785089,112a932d-8db0-9292-a5c4-38ccd58fed94,1,778538,778552,785089,787415,6537,6551,14,0,0,0
785099,900e0786-0aa3-ac8a-2e5e-ae54d08cd4b1,1,778539,778552,785099,787478,6547,6560,13,0,0,0
785140,e4bfa939-f947-591a-15bd-5f9de7789b56,1,778525,778552,785140,782583,6588,6615,27,0,0,0
785131,62e1b0ca-bc8b-f50b-1342-9ed601528a02,1,778525,778552,785131,785824,6579,6606,27,0,0,0
785132,6a1afce6-9d6a-2282-e830-fc292f5cc178,1,778527,778552,785132,782742,6580,6605,25,0,0,0
785169,b7a574e4-fb0b-bab1-ae72-0fcc264fb081,1,778532,778552,785169,782014,6617,6637,20,0,0,0
785170,5428400d-113d-001c-ebc8-2ea5ccd4f106,1,778535,778552,785170,783589,6618,6635,17,0,0,0
785169,41cd5207-54e9-dcda-089b-bddd7023028e,1,778535,778552,785169,781823,6617,6634,17,0,0,0
785152,2b38f7f4-3630-6905-eda9-4f40402a5b40,1,778539,778552,785152,786043,6600,6613,13,0,0,0
785153,abef3946-2141-6f4e-1202-5337bf92c619,1,778543,778552,785153,782125,6601,6610,9,0,0,0
785187,6d986e12-6d37-5f0d-fe4a-a0037c06d533,1,778526,778552,785187,787299,6635,6661,26,0,0,0
785179,73f15034-5481-1ad4-d3e0-3734cd11be4b,1,778527,778552,785179,783835,6627,6652,25,0,0,0
785225,82b10891-97d9-0588-6333-257a90bc850e,1,778533,778552,785225,783769,6673,6692,19,0,0,0
786354,4aeed506-2a74-1f92-b1eb-8a398d6a4c9c,8,785452,785452,786354,786685,902,902,0,0,0,0
786845,122f0f94-81d2-645b-8f80-72b9e9f276a9,8,778977,778988,786845,783708,7857,7868,11,0,0,0
787004,f8c4ecff-cf38-44ad-2c95-0efafc78bdee,32,703048,703048,787004,778345,83956,83956,0,0,0,0
787250,ee1ed617-dce1-c40e-9ae6-ee8a264a8353,1,770913,770945,787250,783011,16305,16337,32,0,0,0
787643,e178e8f0-6ab5-4bfa-45c6-dc7842def747,32,781165,781175,787643,788659,6468,6478,10,0,0,0
787687,ac3a15fc-4111-a12e-5206-da89b01dd826,1,770944,770945,787687,784062,16742,16743,1,0,0,0
787673,c65e92fe-9d73-db43-7cf9-c79921f18435,1,771132,771185,787673,793890,16488,16541,53,0,0,0
787768,36571ba5-e221-409e-4d79-5d035e324a39,1,770915,770945,787768,789963,16823,16853,30,0,0,0
787925,c30a5e13-e521-92bb-e6ad-cd35af47ff2f,1,771427,771427,787925,788868,16498,16498,0,0,0,0
788001,380f3257-e2eb-c6ca-dc7a-1771b1d250bc,1,771482,771487,788001,789414,16514,16519,5,0,0,0
788077,5841b548-e47d-85ce-306b-ba502d4aad08,1,771518,771547,788077,783543,16530,16559,29,0,0,0
788198,807f690e-4200-4aca-3358-b2ecc50b9ab2,1,771725,771725,788198,784616,16473,16473,0,0,0,0
788397,b0861535-6c6c-2ded-2d8d-370154dc0efa,1,771734,771785,788397,790716,16612,16663,51,0,0,0
788445,fbf19ea9-6a52-cfdc-558f-8562964671ac,1,772037,772037,788445,783209,16408,16408,0,0,0,0
788531,1e1efa47-4a0d-7cd8-6fca-4dbfedf27628,8,780728,780755,788531,789443,7776,7803,27,0,0,0
788526,5b46118f-127d-556d-8c83-059ae684fcf6,8,780860,780875,788526,786697,7651,7666,15,0,0,0
788502,7d11ef39-3adc-a8c7-ff09-e70c2a48960d,1,771488,771547,788502,784748,16955,17014,59,0,0,0
788500,c245363e-34a6-eaac-418a-775ee8fb5d3e,1,771929,771929,788500,787103,16571,16571,0,0,0,0
788599,db73a0c0-36b0-6ba7-73b0-aaf0e8e23a61,8,780701,780755,788599,788979,7844,7898,54,0,0,0
788557,20763fc9-d81f-045f-1149-9c2ec65bad8e,8,780886,780935,788557,791505,7622,7671,49,0,0,0
788566,54f82f04-ab51-b221-6340-b89fb70f7ebb,1,771427,771427,788566,782021,17139,17139,0,0,0,0
788618,b0c4bb27-83cd-578a-8e89-bf1c1dadf961,1,771852,771852,788618,794262,16766,16766,0,0,0,0
788655,f02df575-4eff-7434-67dc-ec1dd50f4b19,1,772274,772305,788655,787592,16350,16381,31,0,0,0
788742,8186eed6-4ca8-063f-ce65-ac31734d73fc,8,781113,781115,788742,790049,7627,7629,2,0,0,0
788789,92b94a30-b1c2-d289-7d1c-5b7707790d43,8,781135,781175,788789,789609,7614,7654,40,0,0,0
788782,47291e1d-a477-3a78-52c4-c1082f16ec7f,1,772074,772097,788782,787616,16685,16708,23,0,0,0
788785,04ad746b-bff7-5b49-f39e-7cf3fefb4d28,1,772144,772157,788785,782043,16628,16641,13,0,0,0
788859,2c6336ba-1a02-c693-ec7a-4974bc4a171c,8,777755,777793,788859,791109,11066,11104,38,0,0,0
788818,7ed4e93a-5a9c-9194-afd5-4d38f7f75f13,8,777781,777793,788818,784394,11025,11037,12,0,0,0
788821,0466cd04-8a5a-e470-ed37-e6c820ac14c2,1,772112,772157,788821,783733,16664,16709,45,0,0,0
788906,edc94ff9-a0c9-da6a-5596-8559c8bc2c98,8,781040,781055,788906,792411,7851,7866,15,0,0,0
788916,a48043a5-cc6d-9c71-43cb-fd819f49889b,1,772142,772157,788916,782271,16759,16774,15,0,0,0
788884,af0b1215-6ece-727a-a1c7-b57a12374a03,1,772245,772245,788884,786399,16639,16639,0,0,0,0
788891,265d18f6-761a-0820-5767-55746b178422,1,772376,772425,788891,783089,16466,16515,49,0,0,0
789062,4060d9e9-3a5c-cb68-56e5-2992eecb09e5,1,772108,772157,789062,785955,16905,16954,49,0,0,0
789027,6d898394-d5b1-fe46-1a2f-2c528fa0b9d1,1,772145,772157,789027,786202,16870,16882,12,0,0,0
789047,06950031-1383-2214-ff65-7a1e3252671d,1,772526,772559,789047,782037,16488,16521,33,0,0,0
789041,f011494d-3567-6efb-32f6-94069985b988,1,772533,772559,789041,787499,16482,16508,26,0,0,0
789028,2340c857-73e6-33a8-0da4-d12b754235ae,1,772548,772559,789028,780958,16469,16480,11,0,0,0
789134,aabcf909-5d60-89ea-c6e5-de4239244773,1,772499,772499,789134,790828,16635,16635,0,0,0,0
789135,a04f4370-2c92-da23-4c56-32d4af27966d,1,772368,772425,789135,793587,16710,16767,57,0,0,0
789177,eefc5272-7e3c-b939-c475-e2ad476f88e0,1,772386,772425,789177,783895,16752,16791,39,0,0,0
789156,35e274e1-41c3-9685-5ad2-de25649aa3e6,1,772603,772619,789156,793449,16537,16553,16,0,0,0
789245,e5e650c7-db55-2b32-ff43-08894b80dcb6,8,777589,777613,789245,791866,11632,11656,24,0,0,0
789209,4f0718c2-f0e4-e4c5-8c95-bff31bf0ff18,1,772540,772559,789209,781193,16650,16669,19,0,0,0
789290,3e9e998c-805e-9284-7eea-f07553a7fb02,8,777614,777673,789290,783818,11617,11676,59,0,0,0
789305,57e9687c-436d-a10d-b8ec-06fe4a5e84b3,1,772567,772619,789305,788271,16686,16738,52,0,0,0
789343,5725b6c5-2e7f-37d8-4e10-322fb4a4c777,1,772867,772894,789343,787720,16449,16476,27,0,0,0
789442,0b220741-f05a-d420-7390-b6a060312fce,1,772944,772954,789442,792501,16488,16498,10,0,0,0
789444,c063d440-34c6-4309-78b3-bbc173c30ff6,1,772347,772365,789444,795663,17079,17097,18,0,0,0
789495,05b9573d-3d67-5516-4988-ce352bba2b8b,1,772774,772774,789495,793379,16721,16721,0,0,0,0
789447,ddab1a73-0ac8-9ec9-6afb-b138eb6dce90,1,772880,772894,789447,796138,16553,16567,14,0,0,0
789447,346c9f49-ef62-52a6-e7d9-75d42837527d,1,772880,772894,789447,786794,16553,16567,14,0,0,0
789454,dfd0b3e0-5a2e-e6fa-1e6d-602525994912,1,772986,773014,789454,783209,16440,16468,28,0,0,0
789595,8f654132-a9f4-2e23-6b12-bd633900f29b,1,772783,772834,789595,793836,16761,16812,51,0,0,0
789797,4139b191-249a-4ec1-4b16-a3b70b0212b7,1,773354,773385,789797,790637,16412,16443,31,0,0,0
789859,aa6d7584-8846-59fb-b002-2232c5c04ac0,8,782227,782255,789859,787904,7604,7632,28,0,0,0
789862,ad1dacf5-19ea-4ed0-c8cb-c17ae87feb8e,8,788411,788421,789862,790427,1441,1451,10,0,0,0
789880,88dce4df-bd67-ab90-12dc-32746265e55d,1,773298,773325,789880,795203,16555,16582,27,0,0,0
790019,6f2337c1-8d25-f8e1-2624-054343a21d52,8,782390,782435,790019,793446,7584,7629,45,0,0,0
790063,a2cbd5b7-43c2-9fd2-5b1f-0368ccef0219,1,772967,773014,790063,798072,17049,17096,47,0,0,0
790088,aacfa947-dd9c-829a-76fc-5c77751f0dda,1,773617,773638,790088,786008,16450,16471,21,0,0,0
790152,64cc3dc5-a7c9-4eed-c9db-d38739aaeb92,1,773352,773385,790152,788800,16767,16800,33,0,0,0
790164,7e90a659-c1b0-2d73-fb2d-dab9ed4bee75,1,773596,773638,790164,795742,16526,16568,42,0,0,0
790232,0f225a77-728b-10b8-bfde-2c240bbcc28a,1,773748,773748,790232,785444,16484,16484,0,0,0,0
790289,7308f8c8-c68a-f2bc-acff-e2ed53575c83,8,782440,782495,790289,789800,7794,7849,55,0,0,0
790289,e37bad55-1333-e9bb-f147-9ff253329805,1,774089,774093,790289,792354,16196,16200,4,0,0,0
790389,519e19c3-4192-3afe-4224-06ebdddb7769,1,773890,773890,790389,796995,16499,16499,0,0,0,0
790345,a7f3398f-f444-67ef-f116-06675318d0ae,1,773973,773973,790345,786120,16372,16372,0,0,0,0
790438,34e1b06d-daa6-f86e-3db5-1e16b02aa367,1,773578,773578,790438,795816,16860,16860,0,0,0,0
790467,a920f146-2216-b759-29a3-1519b241a4aa,8,782092,782135,790467,790667,8332,8375,43,0,0,0
790541,c77a0940-b1cc-3f7c-61c7-041e67cfffa0,1,773977,774033,790541,794735,16508,16564,56,0,0,0
790670,e769c88d-6317-50bd-aeb9-6a9ef1ce1427,1,773762,773808,790670,793775,16862,16908,46,0,0,0
790652,38aacb89-b5cf-e9f3-f2e9-43a9fb1e1f84,1,774311,774320,790652,793658,16332,16341,9,0,0,0
790727,f142dc1c-0606-8879-7968-e752f73d47de,1,774548,774560,790727,797003,16167,16179,12,0,0,0
790841,280803ad-d256-0725-8890-0afef1332041,1,774119,774153,790841,797791,16688,16722,34,0,0,0
790853,0d04979b-3d13-af9e-55fd-a4416ac5bd2a,1,774322,774380,790853,790931,16473,16531,58,0,0,0
790827,c7a19d75-4d97-f351-9273-bdddc2d30238,1,774360,774380,790827,797902,16447,16467,20,0,0,0
790890,5484a6cd-086a-f9a3-e0f3-a0e9ecb49e6e,1,774550,774560,790890,798394,16330,16340,10,0,0,0
790980,a36975c9-1ad1-e843-563e-787cf58e20c9,1,774388,774440,790980,793893,16540,16592,52,0,0,0
790983,09209977-8f70-c4f3-27c7-89009e6924de,1,774514,774560,790983,798612,16423,16469,46,0,0,0
791078,8746a1d4-9418-59d0-8164-75ee635d306c,1,774275,774320,791078,792798,16758,16803,45,0,0,0
791087,cfd0da66-0a44-4a9f-77a1-1b8e4d9f5527,1,774443,774500,791087,795430,16587,16644,57,0,0,0
791116,03d2be8a-ac12-3657-1960-e01809fa5766,1,774736,774753,791116,783572,16363,16380,17,0,0,0
791181,1e171c05-bd50-1fad-051c-94d7dd7803c1,8,779705,779708,791181,787333,11473,11476,3,0,0,0
791278,affae738-a182-f7a4-0ce5-6ee27fff0773,1,774361,774380,791278,787303,16898,16917,19,0,0,0
791396,1ebb649f-9ff9-79be-3d77-b36f0449464f,1,774914,774933,791396,794955,16463,16482,19,0,0,0
791389,43ee94c2-8ac4-8085-16b5-2fabbb25367d,1,774914,774933,791389,787713,16456,16475,19,0,0,0
791391,6158a7f8-270a-3676-b209-04fb0814b870,1,774922,774933,791391,789925,16458,16469,11,0,0,0
791413,a5ac1446-1ae3-cd8d-6494-376e0927a8a3,8,776246,776269,791413,791232,15144,15167,23,0,0,0
791429,902d9fe4-29db-1298-9ffb-86a2763b43b7,1,774693,774693,791429,784487,16736,16736,0,0,0,0
