time,job_id,num_gpu,submit_time,start_time,end_time,ddl,executed_time,JCT,pending_time,preempt,promote,best_effort_job
912635,0bc6e292-b9b4-36d3-61bf-fb714fe2f053,32,911907,911907,912635,912694,728,728,0,0,0,0
1028507,56a60db5-0776-d49a-688e-8d5d51856418,64,1012685,1012685,1028507,1030737,15822,15822,0,0,0,0
1043231,0faae5bf-b900-4086-aa21-e1537b2cefe1,32,1014180,1014180,1043231,1036687,29051,29051,0,0,0,0
1089981,8be5199e-e212-b2e8-a91a-0e8b424a1f16,64,1086205,1086205,1089981,1090148,3776,3776,0,0,0,0
1109006,de9c8ed1-2efe-3d84-2c30-663928b5cba6,64,1093446,1093446,1109006,1108266,15560,15560,0,0,0,0
1120728,f1899189-3110-7d36-797d-31c403cbe6bd,8,1014228,1014240,1120728,1110075,106488,106500,12,0,0,0
1216134,4af1ff74-751f-fc03-4f5d-f42331e5266a,64,1212237,1212237,1216134,1214194,3897,3897,0,0,0,0
1286928,c88aca21-b1f4-dd88-48eb-14a58f6d56fd,64,1183530,1183530,1286928,1338384,103398,103398,0,0,0,0
1396763,6828e25c-9307-b36e-eeec-de56dd94b1cc,16,1341622,1341622,1396763,1407610,55141,55141,0,0,0,0
1397770,2057111f-243b-b306-93f6-5b6fd84ccc20,16,1342563,1342563,1397770,1416292,55207,55207,0,0,0,0
1403856,c2d0af1f-43eb-756f-0b62-192ae224a224,16,1348404,1348404,1403856,1379803,55452,55452,0,0,0,0
1505570,26a4850d-1a6b-88d2-cad7-5ebe91694fbb,16,1440871,1440871,1505570,1511156,64699,64699,0,0,0,0
1547821,b5230821-2c41-76f7-d045-f17ece2db215,64,1438582,1438582,1547821,1520655,109239,109239,0,0,0,0
1663119,6ced484e-acde-5588-ee92-0236b1ddecb7,64,1647973,1647973,1663119,1660682,15146,15146,0,0,0,0
1690298,924e48b4-504e-4b66-874c-146ccea6c978,64,1686477,1686477,1690298,1689764,3821,3821,0,0,0,0
1706625,fed46e35-1891-c896-a848-849e0dacf645,64,1702798,1702798,1706625,1706421,3827,3827,0,0,0,0
1799846,994d4c03-7154-74b9-70ce-68ab7ec9ef95,64,1795351,1795351,1799846,1801898,4495,4495,0,0,0,0
1811040,fdecc58d-73fe-e1a3-fed0-24cbb6f37bd4,64,1795395,1795411,1811040,1818084,15629,15645,16,0,0,0
1816104,b9e1aa73-bcaa-8722-923f-720a675684ce,64,1811748,1811748,1816104,1815451,4356,4356,0,0,0,0
1956207,c7797848-1c6e-f704-8311-7efcb0b4d74e,16,1955446,1955446,1956207,1955897,761,761,0,0,0,0
1990933,23625303-2ae7-2b5d-dcd2-dfd44c745676,32,1990162,1990162,1990933,1990602,771,771,0,0,0,0
1992603,83d97b4c-b245-ab9c-2b4e-1135d02e4ccc,32,1991177,1991177,1992603,1993275,1426,1426,0,0,0,0
1996273,7b5aaea7-fd77-319f-240e-78ce0690b4f3,8,1994814,1994814,1996273,1996728,1459,1459,0,0,0,0
1996283,cae322c3-6896-a57b-b7e1-1681fe84f0fe,8,1994814,1994814,1996283,1996854,1469,1469,0,0,0,0
1996413,d46b78f3-288c-91cc-ce92-b02181735a2a,8,1994820,1994874,1996413,1996594,1539,1593,54,0,0,0
1996493,e34a4e23-690a-3f42-6bae-63402ef3f589,8,1994814,1994814,1996493,1996954,1679,1679,0,0,0,0
1997033,fb9c7376-9232-cc60-3bae-eb8eed569361,8,1994817,1994874,1997033,1996265,2159,2216,57,0,0,0
1998414,94ca68d9-4d9e-4c77-0f79-4b765c96703d,8,1994819,1994874,1998414,1997268,3540,3595,55,0,0,0
1998416,343e299e-c4fb-9e5f-e231-9899f73d102c,8,1994815,1994874,1998416,1998520,3542,3601,59,0,0,0
1998506,c7bd251a-523f-ded7-3c05-4c3f474d8dca,8,1994818,1994874,1998506,1996661,3632,3688,56,0,0,0
1998627,c9425b82-0c20-1760-c14f-5b9f82a54c56,8,1994814,1994814,1998627,2000015,3813,3813,0,0,0,0
2000143,903ce3b1-6158-0ec7-305c-b0aed795187f,8,1994814,1994814,2000143,1999600,5329,5329,0,0,0,0
2000145,9290a83a-2bef-4363-6b7c-7396f942fcb2,8,1994817,1994874,2000145,1999976,5271,5328,57,0,0,0
2000256,f93adb04-4d24-6ef6-fe50-e2da7bbe4efe,8,1994820,1994874,2000256,1999054,5382,5436,54,0,0,0
2002192,569d7aeb-640e-50e7-6c10-56b347c3c463,32,1995038,1995038,2002192,2002497,7154,7154,0,0,0,0
2005484,c9a692f0-073b-b78d-460a-a7f94a05e06d,8,1992878,1992933,2005484,2009662,12551,12606,55,0,0,0
2011620,bcc93b94-835d-7e20-859e-45bf5b262633,8,1992875,1992933,2011620,2013451,18687,18745,58,0,0,0
2012141,2651daa3-d8bb-1c4e-f3e6-270444087b43,8,1992877,1992933,2012141,2014864,19208,19264,56,0,0,0
2019222,9390e315-023c-ed0d-dc1e-b9f4564fd4ad,16,1959540,1959540,2019222,2016082,59682,59682,0,0,0,0
2020541,f24e1445-43b5-bebb-e789-ff69a7a52a11,16,1961892,1961892,2020541,2017091,58649,58649,0,0,0,0
2027565,75ed76cf-cc29-a582-8167-86fae7e55d10,8,1992873,1992873,2027565,2018980,34692,34692,0,0,0,0
2027785,e7270909-0500-e955-54d7-1e4a13149627,8,1992877,1992933,2027785,2019828,34852,34908,56,0,0,0
2028564,cefc3837-8dec-1c17-d02b-368081196352,8,1992879,1992933,2028564,2036784,35631,35685,54,0,0,0
2030209,c82211cb-e48d-c1a8-420e-199bc44fdf5b,8,1992874,1992933,2030209,2029032,37276,37335,59,0,0,0
2030435,82afea66-55ea-d359-5c78-0e7076032584,8,1992882,1992933,2030435,2038055,37502,37553,51,0,0,0
2030532,10e2a69d-80de-1dbe-4af7-3ae2daf39837,8,1992882,1992933,2030532,2039793,37599,37650,51,0,0,0
2039198,37eb9827-869c-a44f-11d0-dc7af56ccffa,2,2037760,2037760,2039198,2039156,1438,1438,0,0,0,0
2044470,157470f1-be01-0fe7-6b09-ea4293e4d5f7,2,2041478,2041478,2044470,2044185,2992,2992,0,0,0,0
2044502,9ba585ae-cb96-4524-a5a4-14b21956673f,2,2041478,2041478,2044502,2043884,3024,3024,0,0,0,0
2044514,c83ae2b3-f6f4-fc48-e6bd-7f5ecf237be0,2,2041478,2041478,2044514,2044833,3036,3036,0,0,0,0
2044525,fd28750f-5868-3a1b-6ccb-cb41d7b205e5,2,2041486,2041538,2044525,2044149,2987,3039,52,0,0,0
2044541,2838c714-d121-1aed-eb81-e22464535f72,2,2041479,2041538,2044541,2043987,3003,3062,59,0,0,0
2044584,92ef8d59-0ad1-b7b6-6d35-20b7b937c04f,2,2041479,2041538,2044584,2044738,3046,3105,59,0,0,0
2044556,6f6656b4-abd1-4dd5-45d8-1a459a3336ee,2,2041480,2041538,2044556,2045971,3018,3076,58,0,0,0
2044541,f60249b5-2637-fce4-0049-f6b8f7d86a56,2,2041481,2041538,2044541,2043544,3003,3060,57,0,0,0
2044567,f8a5764a-87c5-3450-4c78-7ac622c97943,2,2041482,2041538,2044567,2043852,3029,3085,56,0,0,0
2044578,1ccd3552-b1e0-e9ad-bf80-b3f8b3ebc460,2,2041484,2041538,2044578,2044788,3040,3094,54,0,0,0
2044567,e324f5db-6850-18bf-f5c3-e7f5583d2337,2,2041486,2041538,2044567,2043743,3029,3081,52,0,0,0
2044588,cf61ea35-d636-9272-2309-33ad1b3eaba1,2,2041486,2041538,2044588,2043315,3050,3102,52,0,0,0
2044570,e9f746e7-1fd3-a8d0-77a4-d097aaa22344,2,2041488,2041538,2044570,2043199,3032,3082,50,0,0,0
2044537,e4d479e7-ace8-c3d1-e0b4-3a731eb6dd1c,2,2041490,2041538,2044537,2044634,2999,3047,48,0,0,0
2044560,375af79e-9f3e-0f38-ad73-286bf517aed0,2,2041492,2041538,2044560,2044506,3022,3068,46,0,0,0
2044567,ad3c919f-d0dc-b7a3-ef0a-d184a5ea3158,2,2041493,2041538,2044567,2045447,3029,3074,45,0,0,0
2044548,d05858ea-e1d2-6681-4c9e-7893f1ca8560,2,2041493,2041538,2044548,2043310,3010,3055,45,0,0,0
2044599,16b3c475-4080-9548-0f25-152b27ce0017,2,2041480,2041538,2044599,2044370,3061,3119,58,0,0,0
2044599,ff4b3804-1b58-69fa-8880-f906cef516c8,2,2041480,2041538,2044599,2045977,3061,3119,58,0,0,0
2044640,e566a39e-41a3-e739-6a67-3cffe0e36d7a,2,2041489,2041538,2044640,2043897,3102,3151,49,0,0,0
2045289,32978c7d-37b3-b0f6-0278-2c34ed809b95,2,2042267,2042267,2045289,2045554,3022,3022,0,0,0,0
2045317,a9129abc-cda1-c26e-a17d-b91d07059d15,2,2042267,2042267,2045317,2044618,3050,3050,0,0,0,0
2045317,5f89a98c-2d6d-c2cb-2eee-dca934664ef1,2,2042267,2042267,2045317,2044439,3050,3050,0,0,0,0
2045303,2f7e6184-24e7-3747-cb1f-999b4c6d98a8,2,2042267,2042267,2045303,2046231,3036,3036,0,0,0,0
2045347,b77c1be6-febe-e6a6-9eb5-d8d29620818d,2,2042275,2042327,2045347,2045932,3020,3072,52,0,0,0
2045346,13e7b504-c58a-ac51-2fa8-e33b2a78ae7c,2,2042280,2042327,2045346,2044057,3019,3066,47,0,0,0
2045403,65d77fc8-252a-c83c-1d7b-ca5cf7a87bc5,2,2042268,2042327,2045403,2044622,3076,3135,59,0,0,0
2045403,2c9d9b63-cc9d-c19c-129d-dfde9194d072,2,2042268,2042327,2045403,2046610,3076,3135,59,0,0,0
2045390,c578f4f4-9b18-276a-1d7b-83630db26722,2,2042269,2042327,2045390,2044370,3063,3121,58,0,0,0
2045389,720f1c3d-922d-82ff-c29f-aa8fe4eb5ab9,2,2042269,2042327,2045389,2044985,3062,3120,58,0,0,0
2045381,5eda2838-c7b9-5bd9-55a8-edb9b1a4da6c,2,2042275,2042327,2045381,2044924,3054,3106,52,0,0,0
2045374,6bb17a8b-26c1-18f2-eb1c-0430df114270,2,2042279,2042327,2045374,2045812,3047,3095,48,0,0,0
2045361,5995e5f4-4c85-45c1-b159-f8a48a802429,2,2042280,2042327,2045361,2044397,3034,3081,47,0,0,0
2045373,ea467d0d-ce05-2ac8-9e0e-5cdf89d4d409,2,2042281,2042327,2045373,2045556,3046,3092,46,0,0,0
2045468,9e876040-4c2b-a24c-8446-a29ac6c753a3,2,2042272,2042327,2045468,2045564,3141,3196,55,0,0,0
2045424,5eabfb1c-fda3-7293-d7b3-0cb4bcf71f08,2,2042276,2042327,2045424,2044314,3097,3148,51,0,0,0
2045424,9760dd35-64b4-d5c3-fe5f-b9a285f801f0,2,2042276,2042327,2045424,2046567,3097,3148,51,0,0,0
2045488,d5672f5d-20bb-45b0-a015-7233baf90557,2,2042270,2042327,2045488,2045559,3161,3218,57,0,0,0
2045500,18721154-0dbd-384d-b753-3ff525f50323,2,2042270,2042327,2045500,2047012,3173,3230,57,0,0,0
2045507,08b52947-9814-c00c-027d-df7ed31c63fb,2,2042273,2042327,2045507,2046577,3180,3234,54,0,0,0
2047919,9a86040e-7263-3c6a-e4ad-77b02e32a832,2,2044906,2044906,2047919,2046505,3013,3013,0,0,0,0
2047944,746cff4e-019c-2251-d590-65fa795581fa,2,2044906,2044906,2047944,2047069,3038,3038,0,0,0,0
2047974,505739f3-1031-a582-62d8-84ee5d89378c,2,2044918,2044966,2047974,2047620,3008,3056,48,0,0,0
2047978,563b0ab8-bba9-827b-cb8f-63c28ab1e605,2,2044918,2044966,2047978,2047862,3012,3060,48,0,0,0
2047966,3231dc66-4f9d-d529-5efe-70f7e0cf449e,2,2044922,2044966,2047966,2047469,3000,3044,44,0,0,0
2048008,c4ca0233-4273-9de8-6bad-2b997fa8c425,2,2044907,2044966,2048008,2047859,3042,3101,59,0,0,0
2047982,93be6e0f-6776-4388-8d6f-ccd5d64f7187,2,2044907,2044966,2047982,2047672,3016,3075,59,0,0,0
2048008,1e31db00-d414-5ed2-2395-6ed72357448a,2,2044907,2044966,2048008,2049446,3042,3101,59,0,0,0
2047987,cadc3379-c788-e847-55d1-0dfc9834e02f,2,2044908,2044966,2047987,2048539,3021,3079,58,0,0,0
2048007,99c36e15-2a65-0cdf-8758-5e332674fda1,2,2044908,2044966,2048007,2048996,3041,3099,58,0,0,0
2048028,893e2de8-8509-c3a2-214b-1e1c4b403399,2,2044910,2044966,2048028,2048325,3062,3118,56,0,0,0
2047991,9a7db4b4-ed91-9b55-91c3-3f136540ecd1,2,2044911,2044966,2047991,2047573,3025,3080,55,0,0,0
2048012,af0caa3c-122f-862e-c495-6e6a21cc0211,2,2044912,2044966,2048012,2049128,3046,3100,54,0,0,0
2048022,f3f73d69-c853-05f9-735b-ea93923ad413,2,2044913,2044966,2048022,2048037,3056,3109,53,0,0,0
2048011,6dabedd3-e1de-9299-c0bd-f93969721c75,2,2044913,2044966,2048011,2048599,3045,3098,53,0,0,0
2047999,1b3e2271-1a71-0bdf-7b6d-e07125b08a57,2,2044916,2044966,2047999,2047249,3033,3083,50,0,0,0
2048026,4705ecba-00c4-e208-1e57-29859437ea94,2,2044917,2044966,2048026,2046513,3060,3109,49,0,0,0
2048003,17abe966-517e-c7c8-15cd-3d70e1e3afdf,2,2044921,2044966,2048003,2047493,3037,3082,45,0,0,0
2048033,d6b9bf52-ece0-0105-5500-99df929b958d,2,2044973,2045026,2048033,2047660,3007,3060,53,0,0,0
2048010,0450f237-1feb-fdaf-0f03-8aaf3fec2bfa,2,2044975,2045026,2048010,2046498,2984,3035,51,0,0,0
2048042,2591855b-87fc-7d1a-148f-0e3c8ce90fdf,2,2044907,2044966,2048042,2047060,3076,3135,59,0,0,0
2048044,2c60d815-39a4-c71d-95b4-3eed08db3427,2,2044915,2044966,2048044,2048013,3078,3129,51,0,0,0
2048055,f09d07f1-eac4-c60c-9e4a-9260efd52c09,2,2044971,2045026,2048055,2048564,3029,3084,55,0,0,0
2048086,607cdb47-a24e-fba7-62e8-cada016db752,2,2044971,2045026,2048086,2048848,3060,3115,55,0,0,0
2048076,8fca9026-a738-30e8-1f3d-0200c5acf275,2,2044972,2045026,2048076,2049296,3050,3104,54,0,0,0
2048076,fab522e5-1600-fe9c-15a4-2c522147129e,2,2044973,2045026,2048076,2048519,3050,3103,53,0,0,0
2048055,9e41d0e7-1d0f-c8c2-0f33-7fe5f93268ef,2,2044974,2045026,2048055,2048381,3029,3081,52,0,0,0
2048064,170e0447-1a28-2f20-ce52-9b862433d80d,2,2044976,2045026,2048064,2048277,3038,3088,50,0,0,0
2048085,8d522457-f104-9c45-c4ad-84e48b3b966c,2,2044977,2045026,2048085,2048971,3059,3108,49,0,0,0
2048057,24522ef6-1e5f-de58-7427-eefaf808e17a,2,2044978,2045026,2048057,2047160,3031,3079,48,0,0,0
2048069,250801c0-8d2a-3e18-a51d-7a23d5b483b6,2,2044979,2045026,2048069,2049421,3043,3090,47,0,0,0
2048077,d7561954-d0e1-2881-98c2-fc34ebde34e7,2,2044979,2045026,2048077,2048045,3051,3098,47,0,0,0
2048068,835108d8-9251-eafe-9d7e-5e48c03caa32,2,2044983,2045026,2048068,2049188,3042,3085,43,0,0,0
2048078,a873abc8-15aa-aa3b-b612-3cdad216d058,2,2044983,2045026,2048078,2048120,3052,3095,43,0,0,0
2048078,0bad6367-a3b5-bc49-f05a-fb4adaa51cfb,2,2044983,2045026,2048078,2047985,3052,3095,43,0,0,0
2048059,0702c1db-d2ad-8a48-0dfa-c4c9910af69d,2,2044984,2045026,2048059,2047019,3033,3075,42,0,0,0
2048083,fec52f69-ac43-6e12-1480-eabd9d9f2662,2,2044986,2045026,2048083,2048321,3057,3097,40,0,0,0
2048085,8d7da747-d48d-5f9a-4be1-a297a8222853,2,2044987,2045026,2048085,2046712,3059,3098,39,0,0,0
2048083,d980a784-1857-08fa-426e-08b6a0b58a0c,2,2044988,2045026,2048083,2047039,3057,3095,38,0,0,0
2048084,480a202f-1cde-5b69-f8fb-04f3cbbc04a3,2,2044988,2045026,2048084,2048114,3058,3096,38,0,0,0
2063769,5111044c-10d6-e19e-b52d-b8c8ff5b2d52,8,1992875,1992933,2063769,2084994,70836,70894,58,0,0,0
2063842,6f77cc54-8bb1-07de-faa0-a29745e3e268,8,1992873,1992873,2063842,2077164,70969,70969,0,0,0,0
2065473,99dce819-1841-d873-634d-6e09f0ffd6b0,8,1992875,1992933,2065473,2091487,72540,72598,58,0,0,0
2085087,96be541b-0b0a-e00f-4462-ecae0cce769b,32,2077930,2077930,2085087,2082988,7157,7157,0,0,0,0
2108137,d2d93182-f3c0-1d85-d867-01f3a5120438,8,2070635,2070693,2108137,2123548,37444,37502,58,0,0,0
2108210,8eb232b8-54b5-6b05-ef67-8fc82308961b,8,2070634,2070693,2108210,2091762,37517,37576,59,0,0,0
2108349,fc1b3217-83eb-9e95-d891-0c365dc57345,8,2070633,2070633,2108349,2124330,37716,37716,0,0,0,0
2127087,dad95c71-c688-599b-d111-277c82cc3039,8,2111050,2111090,2127087,2127476,15997,16037,40,0,0,0
2127133,cc1791f8-ac48-0aa4-8ab4-1a8218b8f130,8,2111048,2111090,2127133,2124402,16043,16085,42,0,0,0
2127238,af4219dd-38c6-82d8-673d-78049c5bad2e,8,2111042,2111090,2127238,2129287,16148,16196,48,0,0,0
2135079,471994c9-3d3a-79ab-c33c-518f52eddbdb,1,2134356,2134356,2135079,2135257,723,723,0,0,0,0
2137953,b21d856b-4266-64cf-306c-4d844c60507b,1,2136457,2136468,2137953,2137728,1485,1496,11,0,0,0
2137957,4230411e-c100-dcbc-f93a-d0a8e9d79f8f,1,2136348,2136348,2137957,2138156,1609,1609,0,0,0,0
2138010,2ac3aafc-94fe-0779-d355-652e5ec7a8f6,1,2136349,2136408,2138010,2137839,1602,1661,59,0,0,0
2138016,1a9e82f5-0228-de49-e4c4-e73c4c46bad8,1,2136459,2136468,2138016,2137482,1548,1557,9,0,0,0
2138486,a0b3543a-0fa7-6a5b-9505-5ac72f0b9138,1,2136352,2136408,2138486,2137489,2078,2134,56,0,0,0
2138518,712636bb-a455-ea22-07d0-2e2ce4406398,1,2136359,2136408,2138518,2138594,2110,2159,49,0,0,0
2138534,ac5200b5-029c-fbda-b37b-574e323f9bb2,1,2136361,2136408,2138534,2139259,2126,2173,47,0,0,0
2138641,8d73f2a6-5c49-7ad1-b4b0-601442d6e3c8,1,2136348,2136348,2138641,2138554,2293,2293,0,0,0,0
2138688,b98b9459-7d35-de60-1f45-a6d06af9e1cd,1,2136457,2136468,2138688,2137574,2220,2231,11,0,0,0
2138643,6f97aebd-e15d-9642-0a84-bd349d345ce9,1,2136469,2136528,2138643,2138532,2115,2174,59,0,0,0
2138643,f977de8f-f140-513b-e4cb-bdb8c4beb48f,1,2136470,2136528,2138643,2139463,2115,2173,58,0,0,0
2138728,ba885454-7497-d326-2157-45a0d658db7d,1,2136355,2136408,2138728,2138553,2320,2373,53,0,0,0
2138755,444b9490-4edd-1cfd-f08f-ecf78e525adc,1,2136365,2136408,2138755,2139589,2347,2390,43,0,0,0
2138780,f81379f3-a170-711f-e862-8d4bcc3c33f5,1,2136462,2136468,2138780,2137629,2312,2318,6,0,0,0
2138905,1dbd3a83-176a-5eb8-0f1a-befdf2e3fdc9,1,2136462,2136468,2138905,2138242,2437,2443,6,0,0,0
2138918,f801a8bf-1467-b73a-5507-14a73aac2179,1,2136348,2136348,2138918,2139953,2570,2570,0,0,0,0
2138918,8b75190c-4f26-de21-4e61-2e346548dfc8,1,2136349,2136408,2138918,2140003,2510,2569,59,0,0,0
2138921,4588d5c7-6da2-c9e0-5477-7e31579bca3c,1,2136457,2136468,2138921,2138310,2453,2464,11,0,0,0
2138968,18076bff-bcae-99f6-691a-cd19a2955303,1,2136466,2136468,2138968,2138230,2500,2502,2,0,0,0
2139046,8f47c5ae-6c68-d37a-aba0-24bd99932899,1,2136470,2136528,2139046,2139429,2518,2576,58,0,0,0
2139270,76f1a8e8-455d-c614-0301-a06c54a1c8a6,1,2136353,2136408,2139270,2140082,2862,2917,55,0,0,0
2139348,816caa34-7d96-e941-27cc-c1ddfe5e36e2,1,2136349,2136408,2139348,2140622,2940,2999,59,0,0,0
2139400,fd987761-b0cc-e109-6d37-a68058f99bf7,1,2136358,2136408,2139400,2139119,2992,3042,50,0,0,0
2139409,8b7080c2-7799-f25b-1bd4-a24e66bc6735,1,2136348,2136348,2139409,2139060,3061,3061,0,0,0,0
2139414,a82762b4-7939-09cd-b858-2767d4031364,1,2136456,2136468,2139414,2139575,2946,2958,12,0,0,0
2139493,1d0707aa-59ec-3e63-0b63-981eb1dc3a91,1,2136466,2136468,2139493,2140333,3025,3027,2,0,0,0
2139573,a45ee904-717d-0042-f30d-6ea3951c4200,1,2136351,2136408,2139573,2140696,3165,3222,57,0,0,0
2139538,2d555314-143e-7fb7-2060-8b8d47c57d53,1,2136358,2136408,2139538,2139953,3130,3180,50,0,0,0
2139538,b9725caf-fea4-2063-f16a-83488fc8ed53,1,2136458,2136468,2139538,2139031,3070,3080,10,0,0,0
2139529,4d2cd22d-cfae-af3f-aa46-dd26e07ab79d,1,2136458,2136468,2139529,2139232,3061,3071,10,0,0,0
2139616,a367b563-2f89-4e9b-4b4e-52fd9c83e2d2,1,2136349,2136408,2139616,2139351,3208,3267,59,0,0,0
2139601,a118766a-cc45-a5fe-093a-d01fb18ed96d,1,2136458,2136468,2139601,2140309,3133,3143,10,0,0,0
2139707,6f52449a-8bcf-476c-dbf2-127381734b33,1,2136348,2136348,2139707,2141077,3359,3359,0,0,0,0
2139692,81cf1f8d-a5a4-9785-8211-dfed73be43cc,1,2136469,2136528,2139692,2139493,3164,3223,59,0,0,0
2139728,09e002f0-6191-ee64-332c-dcc7da819b74,1,2136357,2136408,2139728,2138814,3320,3371,51,0,0,0
2139731,5ef59cd3-e078-b2d6-e92c-b8ed8fa05149,1,2136467,2136468,2139731,2138468,3263,3264,1,0,0,0
2139802,ca3a7379-8e75-b4bd-9004-c585fefb5480,1,2136355,2136408,2139802,2140341,3394,3447,53,0,0,0
2139788,1ff49019-ac4a-7701-07d7-a39309cf1063,1,2136464,2136468,2139788,2140220,3320,3324,4,0,0,0
2139960,75b4849c-7b2a-d1ba-1343-d7f932b5e3d0,1,2136461,2136468,2139960,2141236,3492,3499,7,0,0,0
2139981,edb49f8d-e606-b32f-920d-5830ba5b70e7,1,2136456,2136468,2139981,2140561,3513,3525,12,0,0,0
2141539,38a6484c-634c-842f-6584-387553c70de6,8,2111048,2111090,2141539,2135247,30449,30491,42,0,0,0
2141657,d0d74aa0-eecc-f146-5d7d-c0fd74cfb32b,1,2136356,2136408,2141657,2140685,5249,5301,52,0,0,0
2141708,e009a2cd-3157-f09a-3edf-dad0c6988643,8,2111040,2111090,2141708,2139496,30618,30668,50,0,0,0
2141670,3e881490-681d-e32b-05e6-d7080874688e,8,2111046,2111090,2141670,2141524,30580,30624,44,0,0,0
2141679,25b3cc2e-137d-e405-6ccc-0672cfde82ad,1,2136363,2136408,2141679,2140826,5271,5316,45,0,0,0
2141892,9c7e3507-4f9a-c528-0d0b-906366c5558f,1,2136463,2136468,2141892,2139379,5424,5429,5,0,0,0
2141959,8d5af123-085d-07e6-072c-5869d4c933f2,1,2136459,2136468,2141959,2139331,5491,5500,9,0,0,0
2142387,85ce7878-a616-4c23-d039-0646f47a4d1b,8,2111040,2111090,2142387,2150562,31297,31347,50,0,0,0
2142531,7164a9a2-c3d6-0e1e-1992-97677e083461,8,2111050,2111090,2142531,2152140,31441,31481,40,0,0,0
2142756,d5942bb2-7ddf-0270-fc60-037efc6f2e6e,8,2111030,2111030,2142756,2138905,31726,31726,0,0,0,0
2145223,028ccae1-e0b8-7731-3454-4a6a372cba50,8,2111036,2111090,2145223,2133726,34133,34187,54,0,0,0
2145253,3fa58bda-02ab-e229-146f-192895a155de,8,2111042,2111090,2145253,2138120,34163,34211,48,0,0,0
2145482,1e46c88e-2bc0-30e4-f700-942853a0730b,8,2111030,2111030,2145482,2155922,34452,34452,0,0,0,0
2169611,5c57eb93-057e-aa6f-29de-65e62e89a6ed,8,2111035,2111090,2169611,2188951,58521,58576,55,0,0,0
2169836,0917f2d6-121a-eb14-c600-9101b9b0b99e,8,2111044,2111090,2169836,2175870,58746,58792,46,0,0,0
2170190,922e047f-b5c1-2af0-a296-884f541eb2a4,8,2111041,2111090,2170190,2168178,59100,59149,49,0,0,0
2174574,9f9905ad-43c8-4b21-7d3f-9e08968e83ca,8,2111037,2111090,2174574,2158308,63484,63537,53,0,0,0
2175197,8abcb652-ee52-ab7b-4cb0-fe85e4184c38,8,2111031,2111090,2175197,2162708,64107,64166,59,0,0,0
2177662,3ac1b782-d907-7c2d-54bd-fe613abc666c,8,2111043,2111090,2177662,2178491,66572,66619,47,0,0,0
2177973,21a1b343-77a4-802c-d95d-48ed6a020dca,8,2111046,2111090,2177973,2164748,66883,66927,44,0,0,0
2178074,716ebe56-c19a-ab0f-7d72-8f735d3b64ac,8,2111032,2111090,2178074,2175705,66984,67042,58,0,0,0
2178379,b26f8bb2-3178-bdbb-df7f-acac0814b225,8,2111032,2111090,2178379,2181000,67289,67347,58,0,0,0
2191809,e66ccf4a-cb3c-211d-c8f1-68095051b949,2,2190169,2190169,2191809,2191391,1640,1640,0,0,0,0
2194296,e37001f6-d230-8588-2edb-bd896084d671,1,2192557,2192557,2194296,2193835,1739,1739,0,0,0,0
2194325,82dc286e-060c-fba5-4241-e3eb74c8a3a4,1,2192557,2192557,2194325,2194473,1768,1768,0,0,0,0
2194342,d783b9d0-5820-ea4f-cd18-5ea51740e77b,1,2192560,2192617,2194342,2194512,1725,1782,57,0,0,0
2194342,a2cbc85c-3069-ae7c-04a6-dca6f908017b,1,2192560,2192617,2194342,2195066,1725,1782,57,0,0,0
2194341,f3986f93-6dd7-286a-730a-0bb4da8fa656,1,2192562,2192617,2194341,2193817,1724,1779,55,0,0,0
2194349,0fa745c7-341d-706a-75ef-f2a906fe3650,1,2192571,2192617,2194349,2193696,1732,1778,46,0,0,0
2194328,13d69792-126f-f5ed-4485-e60db86ad0f8,1,2192578,2192617,2194328,2193823,1711,1750,39,0,0,0
2194322,724c5cd0-07ac-3372-693e-e2d569b20a83,1,2192578,2192617,2194322,2194389,1705,1744,39,0,0,0
2194341,9b0dfaab-049f-32c7-b1a7-d537b0ec7074,1,2192581,2192617,2194341,2194552,1724,1760,36,0,0,0
2194348,a3c05d75-b3b6-feb4-6bf0-1ba6ed1d3817,1,2192581,2192617,2194348,2194904,1731,1767,36,0,0,0
2194323,baedb7ab-965e-a5d5-0735-93d177329dc5,1,2192583,2192617,2194323,2194335,1706,1740,34,0,0,0
2194347,430d741a-85c5-db09-e812-4d3df4c88b1d,1,2192584,2192617,2194347,2193662,1730,1763,33,0,0,0
2194348,910813b5-882f-dc64-7677-450f674dfb85,1,2192592,2192617,2194348,2194165,1731,1756,25,0,0,0
2194320,f5260cb1-29bd-44d4-b7bb-24ab7447b052,1,2192608,2192617,2194320,2193829,1703,1712,9,0,0,0
2194320,7ee50afd-1f3a-3502-bb1a-56bdafaea21d,1,2192609,2192617,2194320,2194462,1703,1711,8,0,0,0
2194370,2fa227c3-dc57-14da-90ca-beebdb721b14,1,2192558,2192617,2194370,2195114,1753,1812,59,0,0,0
2194371,306542ee-2e51-9870-0191-073f8cfcb112,1,2192558,2192617,2194371,2194646,1754,1813,59,0,0,0
2194377,19f620a2-26bb-f675-ac6a-e5e1443cf3a1,1,2192558,2192617,2194377,2194868,1760,1819,59,0,0,0
2194370,ff69af1c-020a-b8a8-f7a3-79871a8645c4,1,2192559,2192617,2194370,2194075,1753,1811,58,0,0,0
2194363,24812872-e704-db7d-a4e7-13588fb6002d,1,2192560,2192617,2194363,2194270,1746,1803,57,0,0,0
2194382,efc87fc9-fd8e-fc60-b0bb-79d9d9b00417,1,2192562,2192617,2194382,2194530,1765,1820,55,0,0,0
2194381,0be1bd38-a1be-3068-525f-38eb00fc3ce3,1,2192563,2192617,2194381,2194596,1764,1818,54,0,0,0
2194369,4528bbd1-2df1-1e76-cf42-ce0a539e832e,1,2192567,2192617,2194369,2194908,1752,1802,50,0,0,0
2194382,33777a82-32ef-b83d-28d3-e1aac23f2471,1,2192568,2192617,2194382,2193570,1765,1814,49,0,0,0
2194407,994be696-6160-ac3c-fe6f-2cf706db51d3,1,2192568,2192617,2194407,2194780,1790,1839,49,0,0,0
2194368,2e58e57a-4b4a-f20d-26f3-af262cc6c3c2,1,2192569,2192617,2194368,2194398,1751,1799,48,0,0,0
2194359,7d5887a5-a554-8394-f39d-ea6f06919b1d,1,2192583,2192617,2194359,2194403,1742,1776,34,0,0,0
2194371,113a19a0-a8e1-5405-a04f-3f5cefd10af8,1,2192591,2192617,2194371,2195147,1754,1780,26,0,0,0
2194371,1345c526-a4ab-ce56-8d03-bd2fd7169b2a,1,2192592,2192617,2194371,2193909,1754,1779,25,0,0,0
2194383,214990ed-abe0-7080-6961-a383dceea2eb,1,2192593,2192617,2194383,2195183,1766,1790,24,0,0,0
2194371,aab76dd1-152b-5e5f-e499-9ab5002a99b2,1,2192593,2192617,2194371,2193852,1754,1778,24,0,0,0
2194383,61d9e819-c51c-5229-a145-676d17795b66,1,2192593,2192617,2194383,2194103,1766,1790,24,0,0,0
2194398,2bc2bdd4-d736-d90c-a8ae-5c671598203e,1,2192594,2192617,2194398,2193497,1781,1804,23,0,0,0
2194399,0bace8ac-6dac-29b6-36ea-525de0d768bb,1,2192594,2192617,2194399,2193752,1782,1805,23,0,0,0
2194363,55b2f82a-3469-b0de-e442-c26ca27589cd,1,2192594,2192617,2194363,2194889,1746,1769,23,0,0,0
2194374,79cdc59e-7700-2b66-56c6-5adb028dd025,1,2192594,2192617,2194374,2195208,1757,1780,23,0,0,0
2194388,7ab417d6-2975-cef7-9d3f-904a5ca0678b,1,2192595,2192617,2194388,2194138,1771,1793,22,0,0,0
2194398,071a8d53-63e0-7207-113c-b0099cff77c5,1,2192595,2192617,2194398,2193900,1781,1803,22,0,0,0
2194392,17caf26b-cbfe-fd65-623b-34635f6763a6,1,2192595,2192617,2194392,2193929,1775,1797,22,0,0,0
2194399,1a062a0e-ad93-8d1a-2a0d-c97ee85af565,1,2192596,2192617,2194399,2193691,1782,1803,21,0,0,0
2194398,71bfad6c-0eba-6e49-946c-f4bee1344504,1,2192597,2192617,2194398,2193718,1781,1801,20,0,0,0
2194371,14f32e9b-d497-7ff6-7d35-960301903474,1,2192606,2192617,2194371,2193913,1754,1765,11,0,0,0
2194440,c742bbaf-7787-0d52-dd12-bbc65eaae175,1,2192584,2192617,2194440,2194290,1823,1856,33,0,0,0
2194440,97939217-29c8-388c-eb4c-864364e4abc2,1,2192585,2192617,2194440,2194173,1823,1855,32,0,0,0
2194440,6b48d839-3d82-4b77-d7d9-9ccef4084628,1,2192586,2192617,2194440,2193569,1823,1854,31,0,0,0
2194440,b9ba04a8-54e0-8a94-4682-ca38fb780253,1,2192589,2192617,2194440,2193682,1823,1851,28,0,0,0
2194428,922fe35d-2fd1-c775-00b0-2a827054ef5f,1,2192589,2192617,2194428,2195291,1811,1839,28,0,0,0
2194440,29fcd3e2-6ea4-5e17-b28f-c8c688b30922,1,2192589,2192617,2194440,2194713,1823,1851,28,0,0,0
2194440,a830b0ba-d43d-347d-a0c4-e0f916e4e6e7,1,2192590,2192617,2194440,2193702,1823,1850,27,0,0,0
2194419,0a76e404-9bad-a6c6-dd7d-08c960cc7abd,1,2192591,2192617,2194419,2195172,1802,1828,26,0,0,0
2199271,eea0e30e-96be-e52e-65c1-efd6cf1f5a98,1,2196445,2196445,2199271,2199416,2826,2826,0,0,0,0
2203302,05e71b68-0cf8-32b3-0a66-c2113eb4a3ee,8,2037797,2037820,2203302,2261755,165482,165505,23,0,0,0
2205395,bdf1de53-e014-73df-5768-6c78cbf01dcb,1,2202545,2202545,2205395,2204304,2850,2850,0,0,0,0
2222302,e4cb277f-bc95-a041-8cdf-b034e9a84c51,8,2221465,2221465,2222302,2222020,837,837,0,0,0,0
2236920,353fce99-ef9b-b09b-a32c-ceaed7357f9d,8,2111033,2111090,2236920,2218775,125830,125887,57,0,0,0
2238412,840aa19c-c5bb-ff64-10b9-b399bf5d96d6,8,2111048,2111090,2238412,2204844,127322,127364,42,0,0,0
2239064,2d4177f0-156d-e288-a472-1ca1d1a4e006,8,2111037,2111090,2239064,2266583,127974,128027,53,0,0,0
2258084,901b938f-b703-de19-d20f-65b31164d2e6,8,2202349,2202349,2258084,2282148,55735,55735,0,0,0,0
2324663,84471dfa-d11b-946b-e993-f6e9f2007b99,8,2282713,2282713,2324663,2318431,41950,41950,0,0,0,0
2325368,bf1d8f89-847c-cb1d-d104-99485f6da884,8,2285754,2285754,2325368,2339151,39614,39614,0,0,0,0
2336826,c6bdce43-0902-5afd-164e-9cd4cade4865,8,2326526,2326584,2336826,2341744,10242,10300,58,0,0,0
2336847,e958c745-02bb-657d-0225-51d2e44e923a,8,2326532,2326584,2336847,2334434,10263,10315,52,0,0,0
2336900,3e7447a2-a672-d32f-5c9f-0999e869839a,8,2326526,2326584,2336900,2333444,10316,10374,58,0,0,0
2336980,bff9e3b2-8e79-8982-9a5d-5ace61d9407c,8,2326535,2326584,2336980,2333833,10396,10445,49,0,0,0
2337155,3e74ba44-a65e-4003-51bf-4361edb5db91,8,2326526,2326584,2337155,2335710,10571,10629,58,0,0,0
2340591,9a452aca-1d83-85f3-33f8-cf8c4f0b6127,16,2272670,2272670,2340591,2364945,67921,67921,0,0,0,0
2342628,0be08870-ad40-9867-d6c4-222e6bf82001,8,2326525,2326584,2342628,2335416,16044,16103,59,0,0,0
2343163,2fc82f4d-ea48-9dae-2b99-f902836d943f,8,2326524,2326524,2343163,2339248,16639,16639,0,0,0,0
2343534,6fad7460-2ef3-8ed1-8cdf-e58d8252caff,2,2342306,2342306,2343534,2343986,1228,1228,0,0,0,0
2343561,b3953089-2692-a7e6-bb5c-c587d2689ad4,8,2326534,2326584,2343561,2339843,16977,17027,50,0,0,0
2344145,f48783eb-939f-3536-27ba-a3dd2c2bd5a3,8,2326525,2326584,2344145,2343470,17561,17620,59,0,0,0
2345491,147eeb2d-5a39-74e8-55e7-7e009eb01a8e,16,2267445,2267445,2345491,2370977,78046,78046,0,0,0,0
2352876,9619cf44-3ac5-524f-a3a0-51e85f5c6553,2,2345911,2345911,2352876,2353043,6965,6965,0,0,0,0
2365494,9e8fa807-5db9-6490-2c6b-2108ba9b519a,64,2309732,2309732,2365494,2386339,55762,55762,0,0,0,0
2369824,677ee2ce-4a71-fa06-b2c2-dd37635ccc91,8,2366450,2366450,2369824,2369699,3374,3374,0,0,0,0
2369853,0b1f7526-a690-83d0-1850-147b62b97bbf,8,2366451,2366510,2369853,2368537,3343,3402,59,0,0,0
2369846,9eed7567-e3ee-62db-0680-ee6db3831f62,8,2366451,2366510,2369846,2369437,3336,3395,59,0,0,0
2369866,22f5b1a9-3e4f-22ba-7eb3-eae71885048a,8,2366452,2366510,2369866,2369203,3356,3414,58,0,0,0
2369892,aa3b3db7-8a96-b857-fa8f-39237032c8e2,8,2366451,2366510,2369892,2370889,3382,3441,59,0,0,0
2373108,8fd58d21-1eb8-30f6-7d93-e70328e49b27,8,2365827,2365883,2373108,2372911,7225,7281,56,0,0,0
2373265,7e8e148b-0b44-f907-6d59-ae125ac7b94d,8,2365823,2365823,2373265,2370227,7442,7442,0,0,0,0
2373339,76237f14-9d86-a7ff-3758-16cf761df97f,8,2365826,2365883,2373339,2374004,7456,7513,57,0,0,0
2373405,70a5e979-a505-4cab-7ba8-f78b6577b891,8,2365823,2365823,2373405,2374420,7582,7582,0,0,0,0
2384644,603fea1d-b88c-acbc-9383-f05717610223,8,2378132,2378132,2384644,2382110,6512,6512,0,0,0,0
2384680,e2d8d2e6-272a-64fa-0cd4-dd15f592478d,8,2378133,2378192,2384680,2386671,6488,6547,59,0,0,0
2384691,a250b2fc-093e-e080-20a9-20970356f7ab,8,2378134,2378192,2384691,2385285,6499,6557,58,0,0,0
2384741,04ebb4a9-a4e5-65b7-0357-20d193de2f9e,8,2378133,2378192,2384741,2381423,6549,6608,59,0,0,0
2384764,364b9aa2-ec93-53cd-8e9a-8e7293fca973,8,2378134,2378192,2384764,2384923,6572,6630,58,0,0,0
2385118,9a870bf7-b2e9-da66-1bd5-72b4533679f2,8,2379980,2380038,2385118,2386196,5080,5138,58,0,0,0
2385652,036ec6cb-8941-069b-3559-d3c6565a2822,8,2379978,2379978,2385652,2384738,5674,5674,0,0,0,0
2395751,aa9af6c4-3b08-9388-e9d8-34b6072e4e7a,16,2336680,2336680,2395751,2414011,59071,59071,0,0,0,0
2401643,fd39b46b-8cd0-0b4a-b6dc-d204cebb1f39,16,2337806,2337806,2401643,2383165,63837,63837,0,0,0,0
2402517,639b5d1d-1961-5b05-b725-83e4333673e7,16,2337867,2337867,2402517,2429910,64650,64650,0,0,0,0
2406706,85664da4-8422-edc7-00dc-1d6c013c7d7c,32,2405105,2405105,2406706,2407053,1601,1601,0,0,0,0
2414613,9c59d8ee-4ed6-87d9-d498-ede9d28616ac,8,2409910,2409910,2414613,2414299,4703,4703,0,0,0,0
2424605,0394fc90-7ca2-101f-6b77-fbe41e57072d,8,2419726,2419726,2424605,2424020,4879,4879,0,0,0,0
2441353,2f592f3e-1bbd-2513-30bc-76c4e3fa6893,1,2439097,2439097,2441353,2442076,2256,2256,0,0,0,0
2445988,25c298e5-fb34-31dd-671f-a59b8730130c,16,2398929,2398929,2445988,2424531,47059,47059,0,0,0,0
2447068,1dd18fcf-b99b-8d2d-b72a-69289c7871de,8,2446378,2446378,2447068,2447349,690,690,0,0,0,0
2453055,2cd4e76d-f40a-b6cf-31c7-8a33db5983d3,1,2449981,2449981,2453055,2452450,3074,3074,0,0,0,0
2454662,31d46873-c29d-0b1c-8fcb-6df2c5e3b186,1,2452926,2452926,2454662,2454869,1736,1736,0,0,0,0
2454663,113145d2-4346-cce5-8895-d134acb4b5c3,1,2452926,2452926,2454663,2454367,1737,1737,0,0,0,0
2454663,29a7f041-2d51-9614-442a-584a6f8cd15f,1,2452926,2452926,2454663,2454419,1737,1737,0,0,0,0
2454663,47561669-1c89-a238-00df-2b6b77d0da32,1,2452926,2452926,2454663,2455254,1737,1737,0,0,0,0
2454691,0cccf76f-8309-1e3c-c8c4-89bcce4766d1,1,2452931,2452986,2454691,2455393,1705,1760,55,0,0,0
2454718,7f720ffc-9b6d-272f-639b-66512ffbe857,1,2452938,2452986,2454718,2455073,1732,1780,48,0,0,0
2454728,bb10f0be-db76-8604-befa-e203b206da83,1,2452927,2452986,2454728,2454838,1742,1801,59,0,0,0
2454729,df681283-d4be-d77b-8f1f-114793cabbe1,1,2452927,2452986,2454729,2454175,1743,1802,59,0,0,0
2454771,ef3e9770-390a-e185-128d-fb8215ab1a47,1,2452927,2452986,2454771,2455272,1785,1844,59,0,0,0
2454728,c6e79a7b-f712-e813-4e01-009d8d59b363,1,2452927,2452986,2454728,2455431,1742,1801,59,0,0,0
2454728,0289a49c-e036-f00d-64fd-da37ce635ae0,1,2452927,2452986,2454728,2455336,1742,1801,59,0,0,0
2454728,82d3c040-8e69-44d3-523b-505c4127bbb7,1,2452928,2452986,2454728,2454885,1742,1800,58,0,0,0
2454761,3975864c-d9da-9362-da06-e43988d094a9,1,2452933,2452986,2454761,2455025,1775,1828,53,0,0,0
2454762,5468edcc-4256-dc8d-b1bd-d56a5e8fb079,1,2452933,2452986,2454762,2454911,1776,1829,53,0,0,0
2454725,6e0bc459-ce30-36f3-2bb4-ee3817467451,1,2452934,2452986,2454725,2455158,1739,1791,52,0,0,0
2454747,8d84067f-ce58-e7fc-6cc0-e350f7c40cb2,1,2452935,2452986,2454747,2454000,1761,1812,51,0,0,0
2454747,1cea99dc-04ef-61f0-b13c-78db99fc2b67,1,2452936,2452986,2454747,2454052,1761,1811,50,0,0,0
2454731,7e02c8c1-e7c2-caa7-2460-fdd72cedc1f9,1,2452937,2452986,2454731,2454979,1745,1794,49,0,0,0
2454745,c49dc4fc-cc64-1c00-31b4-1e884b0c8c70,1,2452937,2452986,2454745,2455105,1759,1808,49,0,0,0
2454731,fc2edb04-9a18-e0e8-cc42-82cd1474849f,1,2452938,2452986,2454731,2455271,1745,1793,48,0,0,0
2456735,03f2ffe0-c8ef-f82f-7588-73899b5ffa2d,1,2455461,2455461,2456735,2456254,1274,1274,0,0,0,0
2460004,de3d8b14-ab4c-150a-41c3-c01da6bdaf11,8,2451432,2451491,2460004,2459222,8513,8572,59,0,0,0
2461100,39681e1d-898a-7752-9c71-64a818906db4,8,2451432,2451491,2461100,2458973,9609,9668,59,0,0,0
2462668,8bf4a93a-3210-888f-c62c-13c37e390638,8,2451442,2451491,2462668,2462662,11177,11226,49,0,0,0
2462686,bec4ee08-70ec-69c4-124b-035f24b9be69,8,2451444,2451491,2462686,2464018,11195,11242,47,0,0,0
2462992,f4c621ef-e80b-bc7a-5c3d-ae7b2a630401,8,2451437,2451491,2462992,2459630,11501,11555,54,0,0,0
2463097,5fa686f0-961d-4530-a068-f9edbfb9209f,8,2451432,2451491,2463097,2463904,11606,11665,59,0,0,0
2463459,0927d2fc-0306-53e0-4e3a-bb8ae18f8b8e,8,2451431,2451431,2463459,2466213,12028,12028,0,0,0,0
2463501,afb29df9-7ddd-f3dc-ba13-06b5be54b9d8,8,2451436,2451491,2463501,2468231,12010,12065,55,0,0,0
2463523,008a7385-e393-1f65-2cfc-95d73ae28de8,8,2451436,2451491,2463523,2464090,12032,12087,55,0,0,0
2463615,3cff13aa-3c47-7d0c-857e-a11629a8f004,1,2462759,2462788,2463615,2463508,827,856,29,0,0,0
2463740,ef55c8e2-3b16-4e64-9849-73b7cb052418,8,2451435,2451491,2463740,2461843,12249,12305,56,0,0,0
2463816,e726f649-e650-cae5-1b25-97f3dd00a64c,1,2462757,2462788,2463816,2463809,1028,1059,31,0,0,0
2463879,62a73ff5-e498-d1a8-9c02-8ab78068f766,8,2451433,2451491,2463879,2467133,12388,12446,58,0,0,0
2463903,6b7cbb92-0bf9-924d-b1e0-3ca6017b63a5,1,2462755,2462788,2463903,2464141,1115,1148,33,0,0,0
2463889,17a0fba1-1994-0293-fbc6-423eb58a4321,1,2462759,2462788,2463889,2463566,1101,1130,29,0,0,0
2463962,34cec306-c39f-cfb3-65ec-c39cc6079cb1,1,2462754,2462788,2463962,2463610,1174,1208,34,0,0,0
2464152,6086a5f3-e594-2c30-7458-30d691c0e6c0,1,2462756,2462788,2464152,2463424,1364,1396,32,0,0,0
2464175,e756b705-ae40-5d26-e84f-52adf60768a0,1,2462755,2462788,2464175,2463776,1387,1420,33,0,0,0
2464271,0ef6da2a-fcc9-cdf1-0d88-fa936292ac6b,1,2462757,2462788,2464271,2464167,1483,1514,31,0,0,0
2464368,7d525a4e-432c-03e4-6a55-8ea53ea7d639,1,2462757,2462788,2464368,2463770,1580,1611,31,0,0,0
2464425,3c7d53a0-4d56-a834-fa5d-8ae747338a26,8,2451442,2451491,2464425,2461206,12934,12983,49,0,0,0
2464440,987a8f71-00d2-8f9f-f510-3222fab0509e,1,2462758,2462788,2464440,2464113,1652,1682,30,0,0,0
2465065,fef44a33-ae78-dd3f-8b23-96072d5e114d,8,2451431,2451431,2465065,2465402,13634,13634,0,0,0,0
2465348,76b851e9-bfe7-66da-91a8-5948501d5146,8,2451437,2451491,2465348,2461664,13857,13911,54,0,0,0
2466529,a7a3208e-b1fd-e4de-092a-2783e9b50a89,8,2451435,2451491,2466529,2461187,15038,15094,56,0,0,0
2467332,076c1833-ca50-e117-95f9-6dfa933ac61c,8,2380447,2380499,2467332,2477683,86833,86885,52,0,0,0
2467728,ac97e067-48bb-ec17-7ccd-3eb62d51ca94,8,2282057,2282057,2467728,2446903,185671,185671,0,0,0,0
2467810,80210c15-5404-211d-97e3-e23f0c38f74b,8,2381006,2381006,2467810,2483031,86804,86804,0,0,0,0
2469070,6207db63-74e5-e611-2d65-27a15a968960,16,2420400,2420400,2469070,2471810,48670,48670,0,0,0,0
2472210,47218489-5f27-6ba7-9687-0bf14f19f810,1,2465069,2465121,2472210,2474528,7089,7141,52,0,0,0
2472255,1604c332-09a6-1674-cb1f-a32544e5f394,1,2465063,2465121,2472255,2473302,7134,7192,58,0,0,0
2472243,28d217d6-65a6-1c40-f5fe-ea0a5d3da878,1,2465064,2465121,2472243,2473411,7122,7179,57,0,0,0
2472235,60d8039e-92aa-71d5-61e7-2ff58cf50927,1,2465066,2465121,2472235,2475219,7114,7169,55,0,0,0
2472310,c354fc52-5ee8-8627-3ee0-5165383819b8,1,2465061,2465061,2472310,2472187,7249,7249,0,0,0,0
2472291,895d603d-8172-b13b-2c52-75582c77a125,1,2465064,2465121,2472291,2473508,7170,7227,57,0,0,0
2472278,40fea948-d2d9-3f36-cde4-4f3a06633c73,1,2465065,2465121,2472278,2473283,7157,7213,56,0,0,0
2472396,663cf258-e2c5-3f4d-149f-25e36b19b289,1,2465062,2465121,2472396,2470226,7275,7334,59,0,0,0
2472396,e9382f35-8210-1862-d69c-15b2224f6444,1,2465062,2465121,2472396,2471195,7275,7334,59,0,0,0
2472417,7b2ff249-6565-8fc1-fb62-f1dc842a4b95,1,2465063,2465121,2472417,2473402,7296,7354,58,0,0,0
2472586,81edceb3-8bb2-7f15-a045-d9e673ad562d,16,2425207,2425207,2472586,2470549,47379,47379,0,0,0,0
2475592,a522f92f-4b20-d6a2-aa1c-8b533e2e7201,1,2473872,2473929,2475592,2476128,1663,1720,57,0,0,0
2476097,b0f1d209-7943-2f6f-da55-4d255d144588,1,2473872,2473929,2476097,2475980,2168,2225,57,0,0,0
2476169,ff09338c-422a-aaa7-5e2c-5cf900828826,1,2473873,2473929,2476169,2475489,2240,2296,56,0,0,0
2476332,1652142c-4b6e-c9d5-0227-e56b04741ebc,1,2473871,2473929,2476332,2476626,2403,2461,58,0,0,0
2476423,21c4f6d5-95ea-378b-cce3-edb778fd780c,1,2473874,2473929,2476423,2476882,2494,2549,55,0,0,0
2476776,bce642a4-05cd-4d7c-d231-6495e333b8d0,1,2473869,2473869,2476776,2477877,2907,2907,0,0,0,0
2476931,6c83a898-8723-f7f4-f378-c9eebe751767,1,2473871,2473929,2476931,2478294,3002,3060,58,0,0,0
2477428,dcc3645f-2b9e-6568-d8ee-0d81a7bbc32d,1,2473872,2473929,2477428,2476931,3499,3556,57,0,0,0
2477434,8e382a3d-92b8-ef90-8a24-cbe1e0941981,1,2473870,2473929,2477434,2478093,3505,3564,59,0,0,0
2477443,1af0bb95-21c3-90e2-ea8f-37c74432dbd9,1,2473875,2473929,2477443,2477938,3514,3568,54,0,0,0
2479750,9c9425d8-2bba-86f4-c383-1cda626cc54d,1,2473872,2473929,2479750,2477389,5821,5878,57,0,0,0
2489056,dcb8c9a0-d123-0280-f26e-df2e3a37b907,1,2481803,2481803,2489056,2488901,7253,7253,0,0,0,0
2489069,d27ebe78-1e2c-ebca-9295-626be5121da2,1,2481803,2481803,2489069,2491307,7266,7266,0,0,0,0
2489049,73146dae-97a7-0f9d-39f4-4feba61109cf,1,2481804,2481863,2489049,2490848,7186,7245,59,0,0,0
2489061,df5325cf-8255-0a9f-db72-7254ef022c92,1,2481806,2481863,2489061,2488645,7198,7255,57,0,0,0
2489105,7016e105-21c1-06e7-2f74-b072c53ee9f9,1,2481803,2481803,2489105,2488840,7302,7302,0,0,0,0
2489128,b66db5df-4820-9942-88a5-9343c21ca2c1,1,2481803,2481803,2489128,2490754,7325,7325,0,0,0,0
2489117,e147a5cf-4706-8498-d19c-2f8c0b854f50,1,2481803,2481803,2489117,2492616,7314,7314,0,0,0,0
2489117,4a36acf1-f9e5-c053-33cd-a586320c6b84,1,2481804,2481863,2489117,2486955,7254,7313,59,0,0,0
2489121,62e32fa7-f4cd-6362-434a-184284d8ec6a,1,2481805,2481863,2489121,2491236,7258,7316,58,0,0,0
2489102,cc7e66de-3cf7-526e-18ed-c1e686474182,1,2481806,2481863,2489102,2488495,7239,7296,57,0,0,0
2491470,6a3098aa-6729-fb46-4418-dce5fad5ab17,1,2490027,2490028,2491470,2491435,1442,1443,1,0,0,0
2492458,d1303a7a-aca1-9386-7feb-5020e417eadf,1,2490031,2490088,2492458,2492217,2370,2427,57,0,0,0
2492608,a8c649ab-eadd-86c6-dc4d-e578c19473fe,1,2490033,2490088,2492608,2491877,2520,2575,55,0,0,0
2492682,c3b5b2bd-1eec-4d0d-f5a8-edd7c9b49d09,1,2490028,2490028,2492682,2493090,2654,2654,0,0,0,0
2492713,8988266f-8e67-d7d8-431b-dc7053a3b34e,1,2490031,2490088,2492713,2491952,2625,2682,57,0,0,0
2492949,1863f159-5ab2-c279-6e14-5fa48ee58a98,1,2490029,2490088,2492949,2492648,2861,2920,59,0,0,0
2493140,126f28a9-107d-2387-48c2-1370c2a423f2,32,2390946,2390946,2493140,2518198,102194,102194,0,0,0,0
2493336,d2242ae5-7035-dec5-3b10-8cbabfcbaa55,1,2490030,2490088,2493336,2493945,3248,3306,58,0,0,0
2493471,8caf728a-9e58-f8b6-b24c-77826554f48c,1,2490033,2490088,2493471,2492747,3383,3438,55,0,0,0
2493501,b6ef2c43-7b93-9d83-9f13-08200f3b35f9,1,2490029,2490088,2493501,2494116,3413,3472,59,0,0,0
2494003,94eeda02-f9aa-5d6d-b2e9-d9393fbce063,1,2490032,2490088,2494003,2493831,3915,3971,56,0,0,0
2496061,12f04460-d6ad-f137-a196-5413d881a73a,1,2490030,2490088,2496061,2493354,5973,6031,58,0,0,0
2497881,2977fb6e-29d2-95d6-0c03-b6d6f27eec3b,1,2495128,2495128,2497881,2499181,2753,2753,0,0,0,0
2502725,a9fb1b54-8fbd-2cfd-c651-a34f5a0f3cdb,1,2500318,2500318,2502725,2503058,2407,2407,0,0,0,0
2510832,d8a9e06f-3646-7544-215d-8b1eec8c93eb,1,2508242,2508242,2510832,2509678,2590,2590,0,0,0,0
2514088,89797b17-eeb3-ab22-7077-d33ed04cc4db,1,2511973,2511973,2514088,2514020,2115,2115,0,0,0,0
2519248,87c97761-f6bd-df6e-93a7-9138b2093314,1,2515844,2515870,2519248,2519759,3378,3404,26,0,0,0
2538042,c7f2a172-affc-e532-d846-06250effa0c1,1,2534990,2534990,2538042,2538530,3052,3052,0,0,0,0
2538206,9cca1eda-b5d3-6eb6-abab-2bc719e012e5,8,2489561,2489561,2538206,2561683,48645,48645,0,0,0,0
2539253,56689e24-fe39-0df5-fe2e-e0669e30d1d6,1,2536521,2536521,2539253,2538998,2732,2732,0,0,0,0
2539401,0de5fd7b-dcec-2307-b9e2-4cc0ca63d3d0,1,2536000,2536000,2539401,2540723,3401,3401,0,0,0,0
2540159,ee3ada8b-84f9-00cb-42d7-57a83181b49e,1,2536415,2536415,2540159,2539785,3744,3744,0,0,0,0
2543825,2e401311-c973-c84e-2d4c-041374be3766,1,2536634,2536634,2543825,2545751,7191,7191,0,0,0,0
2545150,1e22ade1-a3e6-bbfd-65e2-ebba27ae2220,1,2536292,2536292,2545150,2545859,8858,8858,0,0,0,0
2545481,7c33c04f-32ad-ddad-8914-d0391ee096ff,1,2536115,2536115,2545481,2543956,9366,9366,0,0,0,0
2547322,91a17855-aabd-4589-b736-5e1b36f1374d,8,2518473,2518527,2547322,2543863,28795,28849,54,0,0,0
2547762,3fd6f99e-ea03-486f-57d6-6988013319d1,8,2518468,2518527,2547762,2560902,29235,29294,59,0,0,0
2547766,02b964d6-76d9-6b12-1443-3a8eed5acddc,8,2518467,2518467,2547766,2555094,29299,29299,0,0,0,0
2547913,94e17c88-b37d-5941-aa32-fd19c1e84c4a,8,2518471,2518527,2547913,2533288,29386,29442,56,0,0,0
2548015,17c8bc95-a413-26f8-44a8-ddc2ddf15e0b,8,2518475,2518527,2548015,2543277,29488,29540,52,0,0,0
2548288,95935df6-c6c2-86af-4aff-e799617d7629,8,2518472,2518527,2548288,2542534,29761,29816,55,0,0,0
2550837,05d04902-48d1-be77-1710-d2f519b7a8e8,16,2515387,2515421,2550837,2545758,35416,35450,34,0,0,0
2562555,c14b2769-3192-7584-9fb0-272735496673,16,2515331,2515361,2562555,2569782,47194,47224,30,0,0,0
2563759,74147301-673f-11eb-fe7a-f953b6dd7eec,8,2561731,2561731,2563759,2563163,2028,2028,0,0,0,0
2567646,84fbcda0-164e-03e0-b1aa-6e6de1dc5188,8,2486557,2486557,2567646,2563204,81089,81089,0,0,0,0
2567738,dd53abe1-2b2f-8082-f613-aed3b9da42b4,8,2486570,2486617,2567738,2607631,81121,81168,47,0,0,0
2568509,9d4d8b69-ef8b-3927-de23-f191aaf170f9,16,2515301,2515301,2568509,2563006,53208,53208,0,0,0,0
2593030,001e7006-29d3-74d6-9a59-6f63141ec659,16,2546012,2546012,2593030,2582026,47018,47018,0,0,0,0
2607050,c3155e4b-b51b-8a05-ec4c-89cd6f4b3d1a,8,2573183,2573183,2607050,2609677,33867,33867,0,0,0,0
2609155,993b1792-cfe5-aa88-abe3-ec98c32e6e52,8,2573441,2573448,2609155,2622340,35707,35714,7,0,0,0
2609469,192cc87d-d8c4-198d-58e9-bf3804ae6d5a,8,2573484,2573508,2609469,2604714,35961,35985,24,0,0,0
2630203,0b32b3a6-fe32-d7e1-19cb-2d9ed109fd54,8,2624347,2624347,2630203,2627457,5856,5856,0,0,0,0
2630292,9522496e-a7c8-09be-9082-140aed00e657,8,2624401,2624407,2630292,2632844,5885,5891,6,0,0,0
2630383,f0514b1d-eb61-7b74-cf53-6189d294f5a8,8,2624446,2624467,2630383,2632949,5916,5937,21,0,0,0
2630783,fba837a7-a03c-6494-cc6d-bed4be576fe1,8,2588693,2588693,2630783,2629612,42090,42090,0,0,0,0
2636937,896f07e5-fabb-d975-e789-3317c2afaa5f,8,2632437,2632437,2636937,2636128,4500,4500,0,0,0,0
2651928,da7f6f61-5813-d26f-54d5-a185ce2c1dad,8,2585326,2585326,2651928,2682128,66602,66602,0,0,0,0
2659749,42cc32f8-23c0-990e-a341-0b6f7603ccca,8,2584666,2584666,2659749,2673967,75083,75083,0,0,0,0
2660510,2fbc9834-9dd0-3cde-6d37-45e890a6dffe,8,2573388,2573388,2660510,2617019,87122,87122,0,0,0,0
2666230,673a0c97-987e-828b-4caf-ae2b15caf379,8,2588693,2588693,2666230,2663889,77537,77537,0,0,0,0
2669175,85123413-d9e3-23be-48cc-02e84da29b5e,8,2591835,2591894,2669175,2702482,77281,77340,59,0,0,0
2696567,a4d7809a-5dbc-7f05-ac8f-f1839702d8c1,8,2496633,2496633,2696567,2663491,199934,199934,0,0,0,0
2698372,85fcfa18-189b-67a3-edf8-3de2151d892c,8,2591834,2591834,2698372,2677469,106538,106538,0,0,0,0
2706540,67e69ffe-5dec-aa98-0e4d-f5f680474077,8,2653087,2653087,2706540,2717270,53453,53453,0,0,0,0
2712277,f9848030-9fa9-35b1-2e18-76034ad551ad,8,2681093,2681093,2712277,2715678,31184,31184,0,0,0,0
2715344,8b61d80d-a691-fdda-43c8-1787f422dc84,8,2588693,2588693,2715344,2660348,126651,126651,0,0,0,0
2715440,f716b195-a06f-2919-9b58-0ad0dc3a765a,8,2653087,2653087,2715440,2746493,62353,62353,0,0,0,0
2719667,3556071b-11b9-e1b1-513f-9d0fde550a06,8,2718088,2718088,2719667,2719291,1579,1579,0,0,0,0
2721109,8c494fb2-1ec8-3afb-e79e-9573e33df2e9,8,2719253,2719253,2721109,2721571,1856,1856,0,0,0,0
2722315,b129a6a4-d3c0-d6c5-584e-6851f2b158c7,8,2719300,2719313,2722315,2721797,3002,3015,13,0,0,0
2722700,83eab8b5-d91b-8378-1d6f-affbe06bae1f,8,2719464,2719464,2722700,2723443,3236,3236,0,0,0,0
2722902,3ca0cbd6-78e8-bf15-c775-3db0b795e838,8,2721396,2721396,2722902,2723070,1506,1506,0,0,0,0
2724442,60bf684e-240d-383a-8dd0-64e34b50c34d,8,2627880,2627880,2724442,2688768,96562,96562,0,0,0,0
2733708,3f532270-4432-dbd0-d02f-1905a778f14e,16,2686843,2686851,2733708,2735577,46857,46865,8,0,0,0
2733828,0cdddf92-3711-9879-61a8-d644b002c52e,16,2686791,2686791,2733828,2742903,47037,47037,0,0,0,0
2737108,e26e750f-c27d-2696-bc44-35083a9321f7,8,2736243,2736243,2737108,2736836,865,865,0,0,0,0
2741373,ee2291ef-ab97-37ef-ffc1-9e7bf17a273b,8,2739894,2739894,2741373,2740968,1479,1479,0,0,0,0
2744298,d8ef8f09-4a15-21ff-428c-92a6330e6bd9,8,2742097,2742122,2744298,2744687,2176,2201,25,0,0,0
2745387,8b6acc43-96af-3fcb-b3eb-f780c91d95c7,8,2742001,2742002,2745387,2744102,3385,3386,1,0,0,0
2745405,3990d711-9ace-5bb2-bcf8-0f7f380f52f3,8,2742031,2742062,2745405,2744224,3343,3374,31,0,0,0
2746352,c98a2fa2-3dba-c4d7-935f-52da1f324096,8,2741884,2741942,2746352,2747910,4410,4468,58,0,0,0
2754520,ec8a7209-afd1-3425-dde2-134c1e3a7063,8,2752589,2752589,2754520,2753645,1931,1931,0,0,0,0
2755314,e5642b96-9624-ba9d-1cea-0ac0d466f946,8,2754319,2754319,2755314,2755493,995,995,0,0,0,0
2755455,4a32b32a-aa5f-0169-8afb-9b2db766c0f6,8,2754681,2754681,2755455,2755167,774,774,0,0,0,0
2755835,0af87147-bf44-ea67-f0cf-99906841667c,8,2755142,2755142,2755835,2755577,693,693,0,0,0,0
2762582,c79e46ae-551b-7d7f-668e-43e1182a4ea3,8,2742097,2742122,2762582,2772618,20460,20485,25,0,0,0
2765793,c82d4afa-95be-2ff6-f4ae-5a44cd7b6acd,8,2742098,2742122,2765793,2769869,23671,23695,24,0,0,0
2768806,eaab0629-6a5e-ec28-e86e-8c8db98b06f3,8,2767014,2767045,2768806,2768912,1761,1792,31,0,0,0
2768944,1149544e-2bc1-33fb-a906-5b41b9be1d00,8,2767015,2767045,2768944,2768527,1899,1929,30,0,0,0
2769302,97477da7-3626-2c14-fc19-9ebc97a92b57,8,2767898,2767953,2769302,2769297,1349,1404,55,0,0,0
2769303,10f897ab-5b44-102f-aec1-6f6caea74c2e,8,2767894,2767953,2769303,2769014,1350,1409,59,0,0,0
2769596,5f90ea2c-f9ae-1b30-0af8-75b243fe6d09,8,2766925,2766925,2769596,2770624,2671,2671,0,0,0,0
2769631,202a9ced-885a-fb35-db8e-e298f561f4c3,8,2766928,2766985,2769631,2770835,2646,2703,57,0,0,0
2770267,7f808dbc-adc0-1c1f-e3ea-46a8a6864e54,8,2767893,2767893,2770267,2770017,2374,2374,0,0,0,0
2770282,be007552-f3d6-d5c7-5455-213bf1867d89,8,2767894,2767953,2770282,2769560,2329,2388,59,0,0,0
2770337,4864d025-fe41-8620-45b4-a13e60cd8424,8,2767895,2767953,2770337,2769381,2384,2442,58,0,0,0
2770875,89f515e0-8e1a-4d7d-d525-89b9de1bad90,8,2766931,2766985,2770875,2769257,3890,3944,54,0,0,0
2770880,8643eed7-dd30-24fc-b864-aaf78d73e7aa,8,2766927,2766985,2770880,2771626,3895,3953,58,0,0,0
2770892,f8ed8b6a-4c6c-ed6d-3f7d-d3136f438da3,8,2766930,2766985,2770892,2772138,3907,3962,55,0,0,0
2774396,7f184a88-f02d-81dd-dc64-34ef6714aea1,16,2773509,2773509,2774396,2774704,887,887,0,0,0,0
2775311,72a35369-6de4-6fed-bece-128609f68439,8,2774466,2774466,2775311,2775566,845,845,0,0,0,0
2775419,bcccd4b3-055c-1cac-68ea-0d226c187782,8,2774650,2774650,2775419,2775278,769,769,0,0,0,0
2776759,7af7bd84-0121-221d-129c-717f636dde12,8,2767897,2767953,2776759,2780945,8806,8862,56,0,0,0
2776779,e220134e-7976-3bb0-d7b2-abd8cc3effe9,8,2767898,2767953,2776779,2777587,8826,8881,55,0,0,0
2779661,0b76d6f7-1f02-26eb-254c-f7b62af3d7cd,8,2764761,2764761,2779661,2778163,14900,14900,0,0,0,0
2779687,41e39149-7f30-9761-72bc-e91aae8f191f,16,2336589,2336589,2779687,2729181,443098,443098,0,0,0,0
2781530,a890f9a8-2015-949c-7b75-10b565dcae7f,8,2742030,2742062,2781530,2782729,39468,39500,32,0,0,0
2782285,7259e6c4-d820-1466-4d55-93a365a6b335,8,2742002,2742002,2782285,2773473,40283,40283,0,0,0,0
2782364,61592130-aec5-509c-9226-15b299cd0df3,8,2742031,2742062,2782364,2770926,40302,40333,31,0,0,0
2782705,3eda9150-3993-e371-3c60-ae1c8818d277,16,2337649,2337649,2782705,2916155,445056,445056,0,0,0,0
2782972,537356f2-cc9f-b7d4-1da0-b6add3bb447f,8,2742001,2742002,2782972,2793246,40970,40971,1,0,0,0
2783968,130aef28-f920-31df-0035-c5551bd12715,8,2783186,2783186,2783968,2784110,782,782,0,0,0,0
2784198,643a6898-6e75-d006-f71e-b55d70e3c153,8,2767893,2767893,2784198,2780915,16305,16305,0,0,0,0
2784209,b5ef1ee6-7ff3-a4b9-769f-a399e1bfff1a,8,2767893,2767893,2784209,2784256,16316,16316,0,0,0,0
2784366,9bd39476-17ca-35a2-7ff7-2b2097eea179,8,2767894,2767953,2784366,2787113,16413,16472,59,0,0,0
2784400,61208478-6f18-b134-7618-5aee62ccf3b9,8,2783709,2783709,2784400,2784203,691,691,0,0,0,0
2785557,fc761e36-96ed-e9e9-96c2-eafa2b8f5009,8,2741884,2741942,2785557,2774203,43615,43673,58,0,0,0
2785656,f58f9bdd-d520-aef5-078a-4dcbdac97c5a,8,2766925,2766925,2785656,2785113,18731,18731,0,0,0,0
2786037,f84a9bca-2ab7-413d-c99b-316743b6c14b,8,2766930,2766985,2786037,2791238,19052,19107,55,0,0,0
2786266,1ff868e7-2e48-e95b-dae8-6239f05e6b17,8,2766928,2766985,2786266,2779450,19281,19338,57,0,0,0
2788799,a701e867-b962-a064-08eb-f1789c787640,32,2784636,2784636,2788799,2786769,4163,4163,0,0,0,0
2794287,b2288b79-5e5f-27a9-607a-93ea640ac369,8,2741882,2741882,2794287,2776572,52405,52405,0,0,0,0
2794754,dabd385c-d2c5-69ab-f830-aa05d2d4dd05,8,2766925,2766925,2794754,2793686,27829,27829,0,0,0,0
2795012,a48fb9e9-4876-494b-cd10-4ac646c2f46e,8,2766927,2766985,2795012,2790384,28027,28085,58,0,0,0
2795402,36cf28af-9d64-22ce-e8de-4479911eb1cd,8,2766933,2766985,2795402,2785646,28417,28469,52,0,0,0
2797434,db6fca27-00a5-3ee7-3fc3-8d4c76ae71ce,8,2796721,2796721,2797434,2797390,713,713,0,0,0,0
2798018,f0e67cd5-faae-7f71-0be2-39725d2db4f9,8,2797218,2797218,2798018,2797901,800,800,0,0,0,0
2798380,01910880-0f5a-1a7c-fe4d-b9ea636404e8,8,2796780,2796781,2798380,2797880,1599,1600,1,0,0,0
2798486,b8cf3f6a-c129-ce67-054a-778bc0383a81,32,2787304,2787304,2798486,2796542,11182,11182,0,0,0,0
2798565,9c296b78-90f6-edce-b1f4-e511e6f9c201,8,2795809,2795809,2798565,2797502,2756,2756,0,0,0,0
2799560,17101a77-3d88-eb62-73df-2a11b79257a3,8,2796778,2796781,2799560,2799649,2779,2782,3,0,0,0
2799621,216dfc70-2196-5bee-da35-44b538118828,8,2796779,2796781,2799621,2798266,2840,2842,2,0,0,0
2800768,9f3204af-d414-763f-8898-010d1b9e2c84,8,2796772,2796781,2800768,2802670,3987,3996,9,0,0,0
2809924,0ea20820-67af-dfd7-5a8e-a2f5f556b55c,8,2796775,2796781,2809924,2803912,13143,13149,6,0,0,0
2810765,932df381-39f6-549b-48fb-95d1736d8da9,16,2809743,2809743,2810765,2810849,1022,1022,0,0,0,0
2811620,9c1817a3-5e2f-0318-644a-79cd36b528a4,8,2796776,2796781,2811620,2807628,14839,14844,5,0,0,0
2811827,182ebfd2-90c7-73ba-5db4-eef0afb79cd8,8,2796772,2796781,2811827,2806837,15046,15055,9,0,0,0
2814904,0a7f9c87-55a3-3387-4edd-6053845ba1d0,8,2796839,2796841,2814904,2823310,18063,18065,2,0,0,0
2818068,eb2873e6-e465-aed7-207a-d1d42888c573,8,2796770,2796781,2818068,2826129,21287,21298,11,0,0,0
2818103,518ba376-d76a-bc03-3534-f5214d564ca1,8,2796771,2796781,2818103,2828131,21322,21332,10,0,0,0
2818096,565f8687-3df0-ddc0-d2e8-4094e19d768c,8,2796772,2796781,2818096,2823341,21315,21324,9,0,0,0
2820359,64fff7a6-35ce-bda8-5d3d-c371d6ac0d84,8,2797012,2797067,2820359,2822235,23292,23347,55,0,0,0
2820590,b31b58fa-cffd-1e28-c271-a48f6aed2058,8,2797010,2797067,2820590,2828704,23523,23580,57,0,0,0
2823769,9313ea0f-b5d6-a793-0003-fd3ed49bf21a,8,2798015,2798015,2823769,2820346,25754,25754,0,0,0,0
2826236,af31dee8-81ea-a853-c415-a46760a55b8e,8,2823998,2823998,2826236,2825904,2238,2238,0,0,0,0
2836734,b0e28479-a8f0-d513-6650-bc24f84b241f,8,2827957,2827957,2836734,2841029,8777,8777,0,0,0,0
2837685,61e6b719-c36f-62b6-ab3c-5a669a3b2264,8,2797010,2797067,2837685,2849074,40618,40675,57,0,0,0
2837825,916efd7b-7cc2-89b7-95b4-59923d49e4f8,8,2797007,2797007,2837825,2842617,40818,40818,0,0,0,0
2844728,3fa83ff8-dba4-444b-0892-80fd22bf52d3,1,2841970,2841970,2844728,2844409,2758,2758,0,0,0,0
2845006,c8c67501-b45f-252f-7349-3fec37aa530b,1,2841843,2841843,2845006,2846502,3163,3163,0,0,0,0
2845662,9c137f71-7a77-a4de-c6a1-c1ef2459bf96,1,2841430,2841430,2845662,2844313,4232,4232,0,0,0,0
2845859,3309cd89-f26d-e669-55e3-8f96a2bf0f3d,1,2842421,2842421,2845859,2846183,3438,3438,0,0,0,0
2848912,0a164306-e1ea-dd41-019a-1843d9dbff58,1,2841736,2841736,2848912,2849752,7176,7176,0,0,0,0
2849040,64a70279-8609-a880-ef29-c0f72ebbfe0a,1,2845857,2845857,2849040,2849462,3183,3183,0,0,0,0
2849151,43d8c607-f27a-b635-6064-62aea0683570,1,2845508,2845508,2849151,2850945,3643,3643,0,0,0,0
2849440,3d9ea33b-1de5-0fa3-d033-dd5e798f5e3f,1,2842189,2842189,2849440,2845870,7251,7251,0,0,0,0
2849423,c145419c-74eb-fa0d-f80a-ea0265dec4ed,1,2845991,2845991,2849423,2848595,3432,3432,0,0,0,0
2851027,390bde0d-98e7-d92b-5f53-5718535fc8cc,8,2823999,2824058,2851027,2841550,26969,27028,59,0,0,0
2853331,bc6699ff-bd73-1fcc-31ff-18f9e8a541f8,1,2841618,2841618,2853331,2848604,11713,11713,0,0,0,0
2854588,645261f7-6318-f1d2-9ebe-22d3111f1a28,1,2846103,2846103,2854588,2853035,8485,8485,0,0,0,0
2854683,874ac31d-8ee0-68b6-2a9d-a1f7ec3115d4,1,2845745,2845745,2854683,2856132,8938,8938,0,0,0,0
2855365,f644404d-df36-5764-5b7a-ec0490de2fee,8,2812378,2812378,2855365,2837635,42987,42987,0,0,0,0
2855806,b7636ce8-bd71-77cf-75b7-7e0cba0ca93f,8,2812382,2812438,2855806,2843072,43368,43424,56,0,0,0
2856742,4f52ddca-3b90-6d87-547a-8ad4dcccea61,1,2845624,2845624,2856742,2861666,11118,11118,0,0,0,0
2857433,94deff78-ccaf-a19b-f8e2-74d8f250f86c,8,2856646,2856646,2857433,2857118,787,787,0,0,0,0
2857784,0f735617-9e61-f0dc-cc69-21373df359d6,8,2857086,2857086,2857784,2857779,698,698,0,0,0,0
2860089,9186c2a1-9536-922e-4a02-d7c19859df42,1,2856362,2856362,2860089,2860639,3727,3727,0,0,0,0
2860138,43d10cf2-afce-af1a-1ada-c950efe3155d,1,2857119,2857146,2860138,2859430,2992,3019,27,0,0,0
2860387,ae344b14-505c-6986-97f9-580e6e20cc72,1,2856837,2856862,2860387,2861449,3525,3550,25,0,0,0
2861033,74c9abd9-daac-fe2b-fb32-440ec2d66d46,1,2857097,2857146,2861033,2859114,3887,3936,49,0,0,0
2861207,26ab406f-9927-d85c-39bc-ae35eeba719d,1,2858167,2858202,2861207,2862095,3005,3040,35,0,0,0
2861361,c4811514-2cee-1a3a-f3e9-d42f19960b40,1,2858395,2858395,2861361,2862209,2966,2966,0,0,0,0
2861380,2650d902-16fd-7c70-a960-bd87ba9d64d4,8,2823999,2824058,2861380,2867494,37322,37381,59,0,0,0
2861729,0ae19e7e-1b6d-8927-5315-de9ac4024764,1,2857979,2857995,2861729,2861200,3734,3750,16,0,0,0
2861958,518d38f8-6904-1328-871c-db5df728a97a,1,2858565,2858589,2861958,2861761,3369,3393,24,0,0,0
2862110,4f22fd57-bb5d-13c5-f6cb-407134781d96,1,2858432,2858455,2862110,2860369,3655,3678,23,0,0,0
2862358,bd37414a-4784-259f-a86e-dac1f82e98dc,1,2857935,2857935,2862358,2860151,4423,4423,0,0,0,0
2862498,95c7d0c2-6405-1dd8-1f1d-5ae0d3016d19,1,2858142,2858142,2862498,2861950,4356,4356,0,0,0,0
2862659,3db87d15-32d8-aff9-f9c0-48829b40bb90,1,2858642,2858649,2862659,2861353,4010,4017,7,0,0,0
2864881,66f7d56a-11d9-b407-c335-99550faa4b81,8,2823999,2824058,2864881,2860094,40823,40882,59,0,0,0
2866110,47eb1172-2d47-d84c-143d-9bff1a89383c,1,2857214,2857214,2866110,2862220,8896,8896,0,0,0,0
2866163,7edf1d61-4d55-a67c-c01f-39a647465064,1,2858254,2858262,2866163,2868455,7901,7909,8,0,0,0
2866237,02580dcb-0dbf-38ed-ece3-e35d3a99542f,1,2858320,2858322,2866237,2864387,7915,7917,2,0,0,0
2866448,728ac5fd-fc32-964b-871e-8c56cb3738c2,1,2858529,2858529,2866448,2866510,7919,7919,0,0,0,0
2866663,23b590e1-f34e-9435-8f5d-0e9fc586e43c,1,2856857,2856862,2866663,2865840,9801,9806,5,0,0,0
2867672,d5647056-88de-4047-4543-646b2ddc3792,8,2819863,2819863,2867672,2889615,47809,47809,0,0,0,0
2867710,28de68ab-a992-7ca9-149c-eebdd472511a,1,2857376,2857376,2867710,2862640,10334,10334,0,0,0,0
2867866,eec335f7-57df-4c9a-e7e0-fe2511d67820,1,2858050,2858055,2867866,2863864,9811,9816,5,0,0,0
2867874,24c4e6ca-8a66-1d77-6049-315b00938d5e,1,2857467,2857496,2867874,2863959,10378,10407,29,0,0,0
2869597,5a45b8cc-117d-3f63-8e8b-84ebe9e24240,1,2856748,2856802,2869597,2869468,12795,12849,54,0,0,0
2871856,8503e3b7-1700-7953-e2ae-f5080213d090,1,2865997,2865997,2871856,2873869,5859,5859,0,0,0,0
2872302,1b0e93e1-2be9-4560-d820-d3628a6181ae,1,2866442,2866477,2872302,2872644,5825,5860,35,0,0,0
2872764,07d1316f-821a-8ac9-a957-2b45ed84859d,1,2865781,2865793,2872764,2874631,6971,6983,12,0,0,0
2873222,8844276d-c0a7-b490-ddcc-48a562c8570e,1,2866270,2866297,2873222,2876441,6925,6952,27,0,0,0
2873442,626b6e7a-fe49-d6cd-ca12-516809bdbd25,1,2865902,2865913,2873442,2874745,7529,7540,11,0,0,0
2874058,861d3a8f-d24c-39a6-7776-fc5da2d99503,1,2866152,2866177,2874058,2873050,7881,7906,25,0,0,0
2874189,4fdcb645-44ec-89bb-8688-6817800d198e,1,2865405,2865405,2874189,2870030,8784,8784,0,0,0,0
2874532,305c5d6f-0997-db9a-1fdb-482df69d1805,1,2868638,2868649,2874532,2873708,5883,5894,11,0,0,0
2874811,df61dbe1-b714-6c44-11b2-152483c38648,1,2866416,2866417,2874811,2874744,8394,8395,1,0,0,0
2875329,7232245c-d2c3-51c2-bded-abba4e1a7019,1,2868357,2868402,2875329,2874395,6927,6972,45,0,0,0
2876136,1f5c5c10-76be-9057-8002-a34fd3b060d8,1,2868226,2868282,2876136,2872408,7854,7910,56,0,0,0
2877444,76890ed4-3a6f-d931-5358-30aa928b9e4d,1,2868562,2868589,2877444,2879040,8855,8882,27,0,0,0
2884339,3dc1e882-0712-2fb9-dcd6-f58eb457bba6,1,2865847,2865853,2884339,2885400,18486,18492,6,0,0,0
2884522,d7a7d4f6-f5b7-7414-90a6-c5b41a70bcdb,1,2866032,2866057,2884522,2889764,18465,18490,25,0,0,0
2884872,5aae363d-198a-f6fd-657c-280127edb5db,1,2866314,2866357,2884872,2885447,18515,18558,43,0,0,0
2888257,478fcedd-7134-1dec-89f6-53a97324c2bb,1,2868682,2868709,2888257,2891520,19548,19575,27,0,0,0
2888933,115ca802-4310-357d-ec80-1a6f0a1dee98,1,2868222,2868222,2888933,2883277,20711,20711,0,0,0,0
2891548,72176085-f3fd-dabb-3e8b-a891d5c4b30a,1,2868529,2868529,2891548,2887615,23019,23019,0,0,0,0
2893381,bf5e39fb-14b3-f352-6d6a-53cb2f991807,1,2868333,2868342,2893381,2887506,25039,25048,9,0,0,0
2895338,8c128604-2acc-8fee-91c9-67441c67d4d6,1,2865733,2865733,2895338,2902534,29605,29605,0,0,0,0
2896765,607cbd33-84dc-ff4d-8c6d-5cde04a7083d,8,2895973,2895973,2896765,2896728,792,792,0,0,0,0
2897181,31c1b3f3-a2a5-c00c-b6fa-64725436273c,8,2896440,2896440,2897181,2896911,741,741,0,0,0,0
2897374,809c109e-37d0-d024-543f-b0866e4ffb1c,1,2866178,2866237,2897374,2912426,31137,31196,59,0,0,0
2917895,10681724-edcc-6a95-61aa-142d4dec48e4,8,2913779,2913779,2917895,2918379,4116,4116,0,0,0,0
2928460,87e504ce-1c17-9c69-9535-99c6c379b61d,8,2881936,2881936,2928460,2910578,46524,46524,0,0,0,0
2928555,dac7bffa-d55a-3290-430c-a1a07946293c,8,2881937,2881996,2928555,2909252,46559,46618,59,0,0,0
2929019,80cb135d-2d78-da72-fdeb-d029785218de,16,2922213,2922213,2929019,2926157,6806,6806,0,0,0,0
2929898,88fc929a-4dda-6b87-4291-b38ce4e7e7a3,64,2915143,2915143,2929898,2922772,14755,14755,0,0,0,0
2933495,25b1ad19-c8b9-3543-d956-3604cdf94cb5,1,2927414,2927421,2933495,2933109,6074,6081,7,0,0,0
2933589,784aed02-8c62-6a8f-349e-b0da7e509ec4,1,2927510,2927510,2933589,2934303,6079,6079,0,0,0,0
2933665,65108b6f-aedb-d272-8ef2-6cacca32c1eb,1,2927530,2927570,2933665,2934512,6095,6135,40,0,0,0
2934160,4cd3dfc4-d17e-cecb-9a49-192f7732c94b,1,2928087,2928087,2934160,2936407,6073,6073,0,0,0,0
2934356,fdba93eb-78e1-5240-9077-1f715ee76dc6,1,2928260,2928260,2934356,2932595,6096,6096,0,0,0,0
2934617,898a52e0-c50e-6599-4914-4c1b728c0b4a,1,2928141,2928147,2934617,2931793,6470,6476,6,0,0,0
2935264,d586ff50-7002-4916-6112-8e82969c8d45,1,2927056,2927056,2935264,2936915,8208,8208,0,0,0,0
2935369,e7718e1b-d1df-4ff0-75f3-2c8e83fc7a2b,1,2927893,2927893,2935369,2935652,7476,7476,0,0,0,0
2935476,59432772-64ba-82bf-9c99-f2bc55dcb8a8,1,2928027,2928027,2935476,2938285,7449,7449,0,0,0,0
2935899,3a099c80-4d16-7503-9aad-dae806c6b8c2,1,2926742,2926742,2935899,2937583,9157,9157,0,0,0,0
2936714,3cbb32de-5a37-fe11-6b9c-7d7c8b713ce4,1,2927913,2927953,2936714,2940251,8761,8801,40,0,0,0
2937253,a9cf94bc-4565-740a-a411-9211f42f6497,1,2927091,2927116,2937253,2932410,10137,10162,25,0,0,0
2937665,38124f7f-8c46-b173-9699-e962319a009f,1,2933338,2933338,2937665,2937207,4327,4327,0,0,0,0
2944971,b03d3665-5c93-e629-e106-ae3288fb044a,8,2882024,2882056,2944971,2919717,62915,62947,32,0,0,0
2945498,bca50ac2-9852-3535-9e6d-3d623ca97d02,8,2882025,2882056,2945498,2917692,63442,63473,31,0,0,0
2948151,59432577-221c-08a3-6559-925520b203ce,1,2927777,2927782,2948151,2946435,20369,20374,5,0,0,0
2949271,0ce3dcce-0b2a-2994-4cff-a0376feb3d46,1,2927686,2927722,2949271,2953582,21549,21585,36,0,0,0
2949971,0693d01a-cfd6-bb31-0fcc-85202c2de0bd,1,2928480,2928520,2949971,2941368,21451,21491,40,0,0,0
2950303,b66e58a8-7642-1a9f-0dcb-48113f1ad220,1,2927662,2927662,2950303,2944165,22641,22641,0,0,0,0
2950419,34cc97ac-07bb-a5df-2861-536f4abc5d91,1,2946498,2946498,2950419,2951218,3921,3921,0,0,0,0
2950953,c5eba017-fe0e-eda1-c01b-07c40ce356ea,8,2924269,2924326,2950953,2937766,26627,26684,57,0,0,0
2950964,de14b989-4c91-372f-5ef7-c9e1ea882491,1,2928267,2928320,2950964,2949342,22644,22697,53,0,0,0
2951181,f41facd1-1344-c2f6-469a-cda367d73e57,8,2924267,2924326,2951181,2937979,26855,26914,59,0,0,0
2951202,331212d1-4cdc-4dcd-7df5-e219468a4cd3,8,2924267,2924326,2951202,2955343,26876,26935,59,0,0,0
2951344,a5fb9e9a-4ab7-d5e0-f814-af2e81e26ceb,8,2924266,2924266,2951344,2964272,27078,27078,0,0,0,0
2951464,817b6767-56e8-0e7e-25f9-79cda1010d68,8,2924267,2924326,2951464,2950145,27138,27197,59,0,0,0
2951450,8e562fbe-7a9d-bea0-415b-4add69e34120,1,2947568,2947568,2951450,2949521,3882,3882,0,0,0,0
2951491,688cce17-6d2d-2c6c-43b6-6a270e2d79ba,8,2924268,2924326,2951491,2939728,27165,27223,58,0,0,0
2951546,620072e0-4cc2-b118-a24e-ae81da2534f2,1,2947595,2947628,2951546,2953221,3918,3951,33,0,0,0
2951725,4d617ffb-d8d3-ac89-810a-9f84cd4ebc4b,1,2948282,2948282,2951725,2952113,3443,3443,0,0,0,0
2952351,eeb44055-ea62-8d3d-80a2-4679ed95e829,1,2928526,2928580,2952351,2955622,23771,23825,54,0,0,0
2952426,6c05df93-969c-382a-bb9e-88f856ebd83a,1,2948151,2948151,2952426,2953887,4275,4275,0,0,0,0
2952760,a6145f1b-79a3-b6a8-9f23-a1b588e65e96,1,2948409,2948409,2952760,2951336,4351,4351,0,0,0,0
2953363,b2092e71-208f-a98c-ee2c-92b2d9b97b79,1,2927301,2927301,2953363,2955722,26062,26062,0,0,0,0
2953423,c04cf6e6-cf6d-28c3-f661-cfdb7537fb16,1,2927309,2927361,2953423,2946773,26062,26114,52,0,0,0
2955662,61d81be9-a250-ed78-7e22-32796e71ad1d,1,2948528,2948528,2955662,2952710,7134,7134,0,0,0,0
2955764,2a64d46b-ceac-d779-9538-e0354157abec,1,2948643,2948648,2955764,2953566,7116,7121,5,0,0,0
2956135,9770d013-b080-e995-7ea7-ccb8b0ad194d,1,2948561,2948588,2956135,2958681,7547,7574,27,0,0,0
2956321,23baa2ca-a90a-e1cd-f4ac-51f0fcf086c5,8,2952643,2952650,2956321,2956755,3671,3678,7,0,0,0
2956330,5dba2337-c3c2-7248-3af6-527f78bbd251,1,2948833,2948890,2956330,2952697,7440,7497,57,0,0,0
2956488,ffa6df21-6057-8624-eba6-71024b16d8a8,8,2952663,2952710,2956488,2957347,3778,3825,47,0,0,0
2956567,fd0be52c-971b-a682-6c4d-181069793532,8,2952651,2952710,2956567,2955113,3857,3916,59,0,0,0
2956592,ffc9cf29-7dbd-40f0-1544-59026bfebd17,8,2952625,2952650,2956592,2954742,3942,3967,25,0,0,0
2956721,78bf9e23-00e2-f562-bea3-2d3485c8363f,8,2952626,2952650,2956721,2958412,4071,4095,24,0,0,0
2956739,45f97eab-b43c-dbe2-e3fc-722194fe41ec,8,2952627,2952650,2956739,2956854,4089,4112,23,0,0,0
2956761,1e4f1499-b0a9-f87f-9ea7-86bc6fdab002,8,2952627,2952650,2956761,2955937,4111,4134,23,0,0,0
2956736,a9dfcc0c-68db-76b3-982d-f0788a51451c,8,2952648,2952650,2956736,2956364,4086,4088,2,0,0,0
2956750,d34585a2-c6d1-30fa-5f14-4f16e7744ce2,8,2952682,2952710,2956750,2955134,4040,4068,28,0,0,0
2956820,85a33467-b110-f489-1022-c8a1042ac25f,8,2952656,2952710,2956820,2956284,4110,4164,54,0,0,0
2957993,cc1de42d-07bb-d002-b1af-6608abfc8586,1,2948830,2948830,2957993,2961375,9163,9163,0,0,0,0
2958551,13a2dc03-e14b-400f-d873-56e93262188f,1,2949273,2949331,2958551,2957492,9220,9278,58,0,0,0
2959552,1f92bdc9-9883-7e3e-a4c6-34ce3dad2abf,1,2927170,2927176,2959552,2952236,32376,32382,6,0,0,0
2962449,d10320a3-8a21-d06c-b13e-3f6d0062cf68,8,2881936,2881936,2962449,2940779,80513,80513,0,0,0,0
2962877,cb53e1ae-daed-71e5-929a-3babd08e6441,8,2881936,2881936,2962877,2938120,80941,80941,0,0,0,0
2968083,8eba0d06-0a18-6676-f473-c022981b99f9,8,2882024,2882056,2968083,3003181,86027,86059,32,0,0,0
2968111,1e557621-d1f7-ab45-045f-1770536b0351,8,2882026,2882056,2968111,2969594,86055,86085,30,0,0,0
2972473,e84dfaa4-4fa6-897e-b96f-52663d77546e,1,2964687,2964726,2972473,2969394,7747,7786,39,0,0,0
2972559,2e89bdbd-5369-1c45-077e-0371ed140bfa,1,2964771,2964786,2972559,2971587,7773,7788,15,0,0,0
2972627,78df7714-aa97-ff51-65fe-3fdd4273f09d,1,2964797,2964846,2972627,2973946,7781,7830,49,0,0,0
2973212,b58d4c97-59df-5bb2-588a-7de79f57dbfc,1,2965462,2965462,2973212,2970274,7750,7750,0,0,0,0
2973316,c6e4472d-983a-cd16-ba66-f439ee62af25,1,2965582,2965582,2973316,2976107,7734,7734,0,0,0,0
2973334,c2b35e09-7f10-1f15-6cea-8e8a34c3ab73,1,2965492,2965522,2973334,2971642,7812,7842,30,0,0,0
2974347,4516bb39-9674-5e86-e94f-82d936f4dd3b,1,2965024,2965026,2974347,2971530,9321,9323,2,0,0,0
2974518,36c84263-fae9-bf9d-7d8b-d58a22a7899d,1,2965177,2965206,2974518,2971230,9312,9341,29,0,0,0
2974548,fff03027-32ef-5b5d-5571-7909016643b7,1,2965138,2965146,2974548,2977729,9402,9410,8,0,0,0
2974579,f31b74f8-163b-6001-17f9-31b676b3c18e,1,2964211,2964211,2974579,2973715,10368,10368,0,0,0,0
2974674,df2ff029-d5ce-9fac-58cd-9df3110024b8,1,2965259,2965266,2974674,2973793,9408,9415,7,0,0,0
2974720,666ef491-88dc-fe09-4413-377b38d52946,1,2964403,2964403,2974720,2970496,10317,10317,0,0,0,0
2974716,cebbdf91-7c7d-7f90-595e-f944c64be810,1,2964404,2964463,2974716,2975564,10253,10312,59,0,0,0
2974716,3a5b10ff-8076-8a77-b25a-2225885f40aa,1,2965287,2965326,2974716,2971329,9390,9429,39,0,0,0
2974744,8953cabc-94de-d20d-bbaa-e0a4660f1b0b,1,2965372,2965386,2974744,2975459,9358,9372,14,0,0,0
2988432,82d621dd-f00a-8b85-7c50-1ef8bb94c73b,8,2987233,2987233,2988432,2987825,1199,1199,0,0,0,0
2988880,80851d53-2d82-ab6a-49bc-819e9d180608,1,2964887,2964906,2988880,2977477,23974,23993,19,0,0,0
2988932,d439566a-c402-ba0b-b889-2fafc691a1ad,1,2964909,2964966,2988932,3000567,23966,24023,57,0,0,0
2989085,f3fd80f2-0423-793f-de3a-564a8bf63e19,1,2965034,2965086,2989085,2980182,23999,24051,52,0,0,0
2990630,354f9914-5698-07e3-f16d-a24334def7ee,1,2964546,2964546,2990630,2992770,26084,26084,0,0,0,0
2991373,c67e0a01-1d34-2563-894f-f117d952e7bc,8,2989726,2989726,2991373,2990847,1647,1647,0,0,0,0
2997088,530a542a-8f05-f94e-d9a1-9ca8f3177bab,1,2964561,2964606,2997088,3006977,32482,32527,45,0,0,0
2997132,b056fa5a-4317-abe4-7f33-922b11ed5768,1,2964661,2964666,2997132,2994851,32466,32471,5,0,0,0
3014922,fd7e1648-bc29-7d8d-915b-3aca208d0d01,8,2960857,2960861,3014922,3038152,54061,54065,4,0,0,0
3016655,91d5bfdd-00eb-85a9-eb7c-5618b12a8b02,8,2960835,2960861,3016655,2994055,55794,55820,26,0,0,0
3019009,76949bb0-e7b0-e27d-244b-405aed7cb20d,32,2900005,2900005,3019009,3028333,119004,119004,0,0,0,0
3019919,53fdb674-87f7-66a9-b0a9-5fc90f1f43a7,8,2960862,2960921,3019919,3043994,58998,59057,59,0,0,0
3027334,d0b2b078-d393-6f3e-5a5f-838f23ee4016,8,3021492,3021492,3027334,3028472,5842,5842,0,0,0,0
3029429,01a9abd0-ed71-d874-9dc3-a0c622d635b7,64,2769802,2769836,3029429,2960242,259593,259627,34,0,0,0
3032046,9aba4c01-4042-0d1f-ca40-00c5355b8d83,8,2960834,2960861,3032046,3052814,71185,71212,27,0,0,0
3033056,d64894cd-2766-fe92-d873-6d60b7f23862,8,2960855,2960861,3033056,3015286,72195,72201,6,0,0,0
3034399,684b1568-d42d-2055-30c4-31e62efe4238,8,2960874,2960921,3034399,3063292,73478,73525,47,0,0,0
3034679,3bf5337a-224c-eee6-1936-059ccea35945,8,2755603,2755603,3034679,2949795,279076,279076,0,0,0,0
3034686,130f0872-966f-3d47-8321-4b1455928cd5,8,2960836,2960861,3034686,3059604,73825,73850,25,0,0,0
3035292,94b58d54-67a2-4ab3-daf6-009939dd843f,8,2960801,2960801,3035292,3051422,74491,74491,0,0,0,0
3035543,e849c066-bee2-1b33-e104-bf7ab9312771,8,2960842,2960861,3035543,3028014,74682,74701,19,0,0,0
3038729,677a72f6-6e0c-42e9-f817-9896c6b98ce2,8,2960866,2960921,3038729,3043359,77808,77863,55,0,0,0
3038738,25db9dbd-817f-8e3b-9a1a-59cf9b480ff5,8,3034242,3034298,3038738,3039675,4440,4496,56,0,0,0
3038827,eb67a72c-8ee0-314d-de2a-7affabe5a807,8,3034239,3034298,3038827,3038764,4529,4588,59,0,0,0
3038833,90266418-cc45-e20c-f48f-854e5562c4f4,8,3034239,3034298,3038833,3040144,4535,4594,59,0,0,0
3038874,224a94a5-763a-2eaa-7340-fa855b2955f1,8,3034238,3034238,3038874,3037563,4636,4636,0,0,0,0
3040450,69ccaeb0-a4a5-308d-4aec-4d62f30fa5b6,8,3034241,3034298,3040450,3039809,6152,6209,57,0,0,0
3040442,cc62f748-54b4-a8a6-d9d2-c70309ac7ba5,8,3034244,3034298,3040442,3038277,6144,6198,54,0,0,0
3040499,da2855e3-61df-d243-38e1-a05d9785db5a,8,3034243,3034298,3040499,3043488,6201,6256,55,0,0,0
3040499,50029c14-39a8-4a83-88cc-f7ad3b54a3f0,8,3034244,3034298,3040499,3039988,6201,6255,54,0,0,0
3048347,46e95aec-0cfb-2d8a-fa8a-7ad235362888,1,3040537,3040595,3048347,3050249,7752,7810,58,0,0,0
3048395,9cb076a2-0e55-1d71-871e-b65c600c8bc0,1,3040645,3040655,3048395,3044864,7740,7750,10,0,0,0
3048520,6ef68419-8a39-3869-3bec-a80c87280662,1,3040756,3040756,3048520,3050174,7764,7764,0,0,0,0
3049611,8f57cd9e-1b30-9e97-8125-aedbf0884735,1,3041872,3041872,3049611,3047668,7739,7739,0,0,0,0
3049709,42d4c734-8ed6-5860-18da-fb7a4af3e1d7,1,3041987,3041987,3049709,3046409,7722,7722,0,0,0,0
3049813,92eae3b6-45c9-db9b-0b29-fc3a0a5ac47d,1,3042097,3042097,3049813,3051083,7716,7716,0,0,0,0
3050187,01f73517-7c4a-42db-6105-06680e49a743,1,3039842,3039874,3050187,3051880,10313,10345,32,0,0,0
3050213,53054058-80e2-ee40-3b89-1988c04d3cca,1,3039954,3039954,3050213,3054107,10259,10259,0,0,0,0
3050405,ea88d27d-17a6-1711-7256-9d7c8c8a22f6,1,3040075,3040075,3050405,3049100,10330,10330,0,0,0,0
3050554,c37e9c25-5d5e-d747-b83d-f10179ece854,1,3041207,3041207,3050554,3053516,9347,9347,0,0,0,0
3050595,9a9eb406-d591-01ce-f18f-2155865b0427,1,3041316,3041316,3050595,3047403,9279,9279,0,0,0,0
3050819,2412a2ab-9c4a-b63d-1c9e-78442e27a7f7,1,3041429,3041429,3050819,3048749,9390,9390,0,0,0,0
3050920,be6826d2-4aac-3fb6-cb14-5c963fa8a0e3,1,3041543,3041543,3050920,3048745,9377,9377,0,0,0,0
3050966,fafb6c18-f190-4cec-c2d4-54e1017f040e,1,3041654,3041654,3050966,3051311,9312,9312,0,0,0,0
3051106,82ca3ac9-2867-9c72-ef24-5e07158327a4,1,3041763,3041763,3051106,3048345,9343,9343,0,0,0,0
3052968,ed1d6d27-03ae-fa62-764d-a24314faa0f5,8,3039819,3039874,3052968,3049470,13094,13149,55,0,0,0
3053211,a53a43d6-1ef5-40d6-f5d9-89367085770f,8,3039820,3039874,3053211,3049350,13337,13391,54,0,0,0
3053245,77cf865f-71fe-d889-1af9-469ad55957c2,8,3039824,3039874,3053245,3046603,13371,13421,50,0,0,0
3053313,4b045067-1481-b96b-477c-bc8ca5f604d7,8,3039818,3039874,3053313,3058492,13439,13495,56,0,0,0
3053548,0207006d-e883-a4f4-b29f-2d6b8915a364,8,3039820,3039874,3053548,3058070,13674,13728,54,0,0,0
3053701,9c88f367-c46e-30a4-9086-b124c7422b51,8,3039816,3039874,3053701,3056361,13827,13885,58,0,0,0
3053939,d2bfbcf2-d709-acc3-0461-a44d20f985d8,8,3039814,3039814,3053939,3048722,14125,14125,0,0,0,0
3053950,58029d89-6ab5-84fd-914b-254e39873b7f,8,3039825,3039874,3053950,3050246,14076,14125,49,0,0,0
3061810,309a11ec-706e-b43a-89e2-3a88d1cc7531,8,3059682,3059682,3061810,3062731,2128,2128,0,0,0,0
3061927,2bd6f0fb-ee3c-8687-b704-eced5b9df42d,8,3059683,3059742,3061927,3061574,2185,2244,59,0,0,0
3064871,16ac92bb-f9f6-c49c-8eb7-ae33a848096e,1,3040871,3040871,3064871,3056968,24000,24000,0,0,0,0
3065016,26366874-b225-18de-b6e2-887aefe61690,1,3040985,3040985,3065016,3066038,24031,24031,0,0,0,0
3065169,99d2f7f2-eb1f-283e-856b-1c79a4f17bc1,1,3041095,3041095,3065169,3055360,24074,24074,0,0,0,0
3066838,5997fbb0-f7b9-a2e2-fe9b-f2d55de1d542,8,3039823,3039874,3066838,3059545,26964,27015,51,0,0,0
3067252,63203fa9-0bf3-ee35-d392-5553ceef3ff2,8,3039816,3039874,3067252,3066407,27378,27436,58,0,0,0
3067399,ab204463-d92c-c6c8-5da7-f990d59ec42e,8,3039816,3039874,3067399,3074680,27525,27583,58,0,0,0
3067456,3c7bfe7e-8b95-e8ea-8070-9d9517eaa7fa,8,3039823,3039874,3067456,3071053,27582,27633,51,0,0,0
3068527,3c9b7cd1-983e-5d3b-b176-6ffc05fbd075,8,3039819,3039874,3068527,3054888,28653,28708,55,0,0,0
3068879,27facb5d-c74d-2800-be1e-0254e35aac0c,8,3039816,3039874,3068879,3069618,29005,29063,58,0,0,0
3069054,c76e8e04-1b64-ef32-5aa2-88e1609c6c82,8,3039816,3039874,3069054,3054399,29180,29238,58,0,0,0
3069167,9eead5de-f5b5-777f-041c-4ba30bb90921,8,3039816,3039874,3069167,3072760,29293,29351,58,0,0,0
3069461,227763f8-fb63-4b0b-539e-a196aa386ce6,1,3040192,3040192,3069461,3075683,29269,29269,0,0,0,0
3072745,3b4c0646-d38a-9b74-ddd8-6b0e6d0faded,1,3040302,3040302,3072745,3062023,32443,32443,0,0,0,0
3072855,139b4c16-fbca-ebdc-46ab-fedd21491f7c,1,3040415,3040415,3072855,3078841,32440,32440,0,0,0,0
3073116,10e681fd-a127-f663-8db4-daaa831fe884,8,3059687,3059742,3073116,3076981,13374,13429,55,0,0,0
3073247,b252456e-ffc9-ff30-9f9a-8a331ad6ff7b,8,3049923,3049923,3073247,3082668,23324,23324,0,0,0,0
3073264,4d25d614-53aa-b43a-7a9b-2b2c0b191955,8,3059686,3059742,3073264,3079633,13522,13578,56,0,0,0
3083004,ada4b5fd-b198-cd6d-df1e-e6b3c8663c6e,8,3059684,3059742,3083004,3074329,23262,23320,58,0,0,0
3083126,c2a663d6-d34c-41f2-2746-cfa4724eb58d,8,3059685,3059742,3083126,3087879,23384,23441,57,0,0,0
3084313,9ecc4181-f256-aa65-e7eb-7bae6e143f9d,8,3059683,3059742,3084313,3086619,24571,24630,59,0,0,0
3084761,2c0ef6cf-727d-264a-4cc4-a7e5fd25bca9,8,3059683,3059742,3084761,3081993,25019,25078,59,0,0,0
3087234,20b8d865-580e-60e4-3f02-7521c8ba5226,8,3086263,3086313,3087234,3087451,921,971,50,0,0,0
3087312,5be330e5-2a5e-b81a-02c2-7ee1ff57c8d4,8,3086253,3086253,3087312,3087334,1059,1059,0,0,0,0
3087333,deef7995-1f88-4ed9-cefa-bf951227557d,8,3086262,3086313,3087333,3087306,1020,1071,51,0,0,0
3087365,d4796110-b35e-85f5-e7f2-f49d41a51d1f,8,3086265,3086313,3087365,3087648,1052,1100,48,0,0,0
3087350,18ab202b-df7a-d7b0-3044-f29765623354,8,3086274,3086313,3087350,3087356,1037,1076,39,0,0,0
3087412,944bad04-9161-cc6c-9f41-dfcfcdccb9d9,8,3086273,3086313,3087412,3086899,1099,1139,40,0,0,0
3087383,0ef40214-014b-6836-47ad-fc55c99cb5f3,8,3086274,3086313,3087383,3087671,1070,1109,39,0,0,0
3087396,aecb9625-66c6-ea9b-dd43-fb548b8961fa,8,3086287,3086313,3087396,3087027,1083,1109,26,0,0,0
3087478,c768edb9-05d8-e146-17f4-2764de1a8a8e,8,3086266,3086313,3087478,3087218,1165,1212,47,0,0,0
3087619,3834e80b-6638-6c22-a1d2-80a21038f8e4,8,3086255,3086313,3087619,3087073,1306,1364,58,0,0,0
3090005,f60fdbf2-23b8-f542-6602-3be329fda256,8,3085961,3085961,3090005,3090503,4044,4044,0,0,0,0
3090174,6431d4a9-ca1e-f8d9-44ed-bacfd8c42832,8,3089286,3089286,3090174,3090095,888,888,0,0,0,0
3094286,ec1aa530-c0ff-0bc4-df44-9bffbad65109,8,3093115,3093115,3094286,3093980,1171,1171,0,0,0,0
3094341,751095ed-9864-dc1a-c827-1dd98da18439,8,3093115,3093115,3094341,3094740,1226,1226,0,0,0,0
3094329,81d9cff9-9de2-d8ca-4edc-3a083442853a,8,3093246,3093295,3094329,3094737,1034,1083,49,0,0,0
3094304,2fb1eb40-4f26-fedb-10d2-8a3220c6270a,8,3093262,3093295,3094304,3094645,1009,1042,33,0,0,0
3094397,e61c4368-72f1-f318-6c4e-77f738da98b0,8,3093115,3093115,3094397,3094570,1282,1282,0,0,0,0
3094420,d5471932-3e03-a5ea-63bd-916be674b2ca,8,3093129,3093175,3094420,3094483,1245,1291,46,0,0,0
3094491,f6d2a20d-b3d5-1708-5d1a-f023a73ff524,8,3093265,3093295,3094491,3094404,1196,1226,30,0,0,0
3094578,31faf7e0-38e5-156d-07c0-c4df88c8e83a,8,3093214,3093235,3094578,3094277,1343,1364,21,0,0,0
3094532,fd9c70c3-2972-3882-a6d9-d3d105ddf023,8,3093247,3093295,3094532,3094732,1237,1285,48,0,0,0
3094631,65a815a3-7833-eece-08e5-ed83f8d4866f,8,3093252,3093295,3094631,3094222,1336,1379,43,0,0,0
3100613,b8d7e825-bd6f-6707-b17d-64df35e8f24a,8,3099508,3099549,3100613,3100634,1064,1105,41,0,0,0
3100643,0c0575ab-2dce-3207-400e-45409492ba69,8,3099489,3099489,3100643,3101056,1154,1154,0,0,0,0
3100669,4db70660-6388-3dea-e698-a3767afb83cc,8,3099675,3099675,3100669,3100370,994,994,0,0,0,0
3100823,51cb3f06-1435-67ed-0cff-84c2eb41ce2f,8,3099572,3099609,3100823,3101171,1214,1251,37,0,0,0
3100828,22cdf6a0-1899-9d8c-7f02-671ba6eb5efa,8,3099578,3099609,3100828,3101374,1219,1250,31,0,0,0
3101006,68151f14-d6b6-fb16-1d8d-7b02bc5d618f,8,3099760,3099795,3101006,3100647,1211,1246,35,0,0,0
3101050,28fa0a73-1646-113d-dc76-39e58a799c75,8,3099696,3099735,3101050,3100745,1315,1354,39,0,0,0
3101113,140f9b24-fcc9-66c6-3c19-ef424cb9c5c6,8,3099681,3099735,3101113,3101426,1378,1432,54,0,0,0
3102843,dbafd3b1-50ff-1ea7-03f5-dc20d065699a,16,3066602,3066602,3102843,3091751,36241,36241,0,0,0,0
3110536,4400592c-a0b3-35c7-8fe1-f0505cf9d973,1,3104353,3104353,3110536,3108585,6183,6183,0,0,0,0
3110639,d1d46f58-2b72-8139-af61-997d61275e64,1,3104464,3104464,3110639,3113570,6175,6175,0,0,0,0
3110967,8e416029-58b4-8e1d-9e13-87b03f12cf6c,1,3104129,3104129,3110967,3114010,6838,6838,0,0,0,0
3111468,7f4a3544-817c-781a-6fbc-2464ea524c69,1,3103254,3103254,3111468,3112969,8214,8214,0,0,0,0
3111560,dc404104-91af-4892-240f-f1c4e5ae01ed,1,3103366,3103366,3111560,3109514,8194,8194,0,0,0,0
3111693,b9668355-6f72-bb3c-9885-e9901e668738,1,3105506,3105506,3111693,3111264,6187,6187,0,0,0,0
3111814,cd68f11c-a4b0-190d-dd40-111ab276d819,1,3105619,3105619,3111814,3113797,6195,6195,0,0,0,0
3111850,76c397c2-2dbd-c89a-75b3-452a32562c45,1,3104573,3104573,3111850,3114703,7277,7277,0,0,0,0
3111928,5cff7279-0c12-ea1d-a300-df89da07aa8b,1,3104015,3104015,3111928,3108324,7913,7913,0,0,0,0
3112291,7745c60d-1349-ca14-bd89-99f5d2704c62,1,3103507,3103507,3112291,3110572,8784,8784,0,0,0,0
3112323,c1204784-51e5-0918-df04-ea9f4505f98e,1,3105381,3105381,3112323,3113967,6942,6942,0,0,0,0
3113514,82e89b5e-4bcb-68bd-bfca-79d85f42cf6b,1,3104240,3104240,3113514,3112115,9274,9274,0,0,0,0
3113658,defc4d67-d8b3-680d-69ac-2a33c0e7d2f1,1,3105270,3105270,3113658,3115622,8388,8388,0,0,0,0
3113717,a0d60422-1a32-d219-2eb1-3e3cd3cb6d14,16,3066640,3066662,3113717,3098472,47055,47077,22,0,0,0
3113866,37f15695-ef67-e86a-b93a-502f7a1e827a,1,3105050,3105050,3113866,3114207,8816,8816,0,0,0,0
3114428,48f89e30-5f39-69ad-5918-a225ff7f84ec,1,3105160,3105160,3114428,3115638,9268,9268,0,0,0,0
3128607,c959dbb9-52b6-73d4-2481-216b988fd26b,1,3104687,3104687,3128607,3136334,23920,23920,0,0,0,0
3128629,5cdbb28b-be6e-2511-0b2a-a744e14f043f,8,3075781,3075822,3128629,3129413,52807,52848,41,0,0,0
3128697,ea3dbc37-67e8-8ce0-4c44-2d17d98d2038,1,3104796,3104796,3128697,3128318,23901,23901,0,0,0,0
3128836,d353db1c-3d59-6f7b-3377-4ed1b039ba0d,1,3104908,3104908,3128836,3130330,23928,23928,0,0,0,0
3129691,759f52c9-9232-0a95-fae0-1ea2ce4771b8,1,3103619,3103619,3129691,3132664,26072,26072,0,0,0,0
3130288,295c1b59-3807-9a8e-7e3b-eb35e1ebef9c,8,3075850,3075882,3130288,3110143,54406,54438,32,0,0,0
3130875,6c589836-3a04-e4d7-2113-6ce039ba7d2f,1,3124411,3124411,3130875,3131858,6464,6464,0,0,0,0
3130965,af7da5d4-238c-929d-3c2f-5047d205bba8,8,3075656,3075658,3130965,3145764,55307,55309,2,0,0,0
3131430,68efd18f-2266-a77f-0a2d-8b6671819d9d,1,3125367,3125367,3131430,3134261,6063,6063,0,0,0,0
3131481,9ac1b7f0-a5b0-6be6-4d63-96fe022f6ca5,1,3123338,3123338,3131481,3132621,8143,8143,0,0,0,0
3131496,454e1370-28d8-fdf4-3710-3c3f90a58dd6,1,3124279,3124279,3131496,3132482,7217,7217,0,0,0,0
3131501,e2e6e895-55e1-0b39-6afd-5fed17f20b40,1,3125479,3125479,3131501,3130943,6022,6022,0,0,0,0
3131627,d0ce2457-5cdd-0f45-3588-93f1280b0996,1,3123451,3123451,3131627,3132329,8176,8176,0,0,0,0
3131721,e97e55d4-46b0-eed1-c2d4-705de1661e4d,1,3124540,3124540,3131721,3131090,7181,7181,0,0,0,0
3131853,496d4895-c8d7-f25c-823b-576b0ead4e04,1,3123226,3123226,3131853,3130786,8627,8627,0,0,0,0
3131987,b81cc43b-f99a-3620-6ee2-f9bf8ad303b1,1,3124172,3124172,3131987,3135596,7815,7815,0,0,0,0
3132356,a68f75ac-7491-6018-2dc8-4e80a90bdc3a,1,3125593,3125593,3132356,3130378,6763,6763,0,0,0,0
3132788,f805d526-5e5a-e447-e282-20cd8ea359f9,1,3124988,3124988,3132788,3134373,7800,7800,0,0,0,0
3133078,4c60429b-a17c-d064-698a-488827f49771,1,3123939,3123939,3133078,3132722,9139,9139,0,0,0,0
3133307,e1ea1d2e-9874-4952-93ed-4b5c2c4276b2,1,3124063,3124063,3133307,3133566,9244,9244,0,0,0,0
3133357,b8d8e96c-ca54-c1d7-a2ab-a713e5a79d2f,1,3125100,3125100,3133357,3130776,8257,8257,0,0,0,0
3134296,81a4dce0-c800-9f5e-3139-c12d3881efd7,8,3075606,3075658,3134296,3125670,58638,58690,52,0,0,0
3134360,0247b04d-6361-6032-0b73-633f9e269012,1,3125213,3125213,3134360,3133472,9147,9147,0,0,0,0
3134663,86413c79-e90f-0aac-e82a-e2455a422292,8,3075762,3075762,3134663,3127805,58901,58901,0,0,0,0
3134797,fe318a9e-8e49-9061-d805-aa2b2d6436ea,8,3075858,3075882,3134797,3106137,58915,58939,24,0,0,0
3136249,945dbe02-6b43-88f5-97ea-6d52f84dca4b,1,3103790,3103790,3136249,3123842,32459,32459,0,0,0,0
3136342,34460c61-1bf1-b7e1-17f1-33972905fe7d,1,3103902,3103902,3136342,3151232,32440,32440,0,0,0,0
3142580,b3aa475c-af31-4f40-5e8f-7d7e3c36c559,16,3120256,3120256,3142580,3152715,22324,22324,0,0,0,0
3147550,68c5eddc-3253-f9fa-5c42-952b923cddb6,8,3075614,3075658,3147550,3133417,71892,71936,44,0,0,0
3148491,47e75b71-0a9d-484c-915c-a65d8f359e6c,1,3124654,3124654,3148491,3148963,23837,23837,0,0,0,0
3148565,a3ffcbbd-8480-36ad-080c-cf788a178298,1,3124768,3124768,3148565,3140418,23797,23797,0,0,0,0
3148662,26a97770-7983-efc0-8eda-75d9bc41c770,8,3075613,3075658,3148662,3127850,73004,73049,45,0,0,0
3148672,3ccb9897-cadb-11c4-a00d-1e18aeadc03f,1,3124875,3124875,3148672,3148300,23797,23797,0,0,0,0
3148857,356bf588-32c2-c61a-9553-507b4a8c6e28,8,3075598,3075598,3148857,3173526,73259,73259,0,0,0,0
3151050,d99598fb-9eea-7337-8646-f5c1ea89cc6d,8,3075598,3075598,3151050,3132077,75452,75452,0,0,0,0
3155921,94a9922e-f67e-d93e-0d78-343ad6d21b30,1,3123567,3123567,3155921,3169503,32354,32354,0,0,0,0
3156001,e0f0c823-d077-8d1f-7079-04e00ef92e30,1,3123694,3123694,3156001,3143521,32307,32307,0,0,0,0
3156102,bb4400f1-8baa-fca5-a47d-5fb6893bfecf,1,3123811,3123811,3156102,3163036,32291,32291,0,0,0,0
3173644,dde630e0-cbee-2346-5d1c-153ef6ebcacf,8,3171441,3171441,3173644,3174504,2203,2203,0,0,0,0
3176116,3c64b7e5-54ef-e054-0206-ad9d9be6aa29,8,3174627,3174685,3176116,3175383,1431,1489,58,0,0,0
3177262,89d5e178-cf99-8da3-4f94-2b3ece05a281,8,3174625,3174625,3177262,3177254,2637,2637,0,0,0,0
3177315,e47472d0-77e0-ad89-1197-aeb02ee49d62,8,3174626,3174685,3177315,3177187,2630,2689,59,0,0,0
3177848,b51f34b7-dba0-aa70-b32e-ddf2c1dd9365,8,3174626,3174685,3177848,3179341,3163,3222,59,0,0,0
3178146,292254f9-37cc-a228-020f-8fa553fdd1f7,8,3174627,3174685,3178146,3178892,3461,3519,58,0,0,0
3178253,efd1422e-eb42-8215-4c3d-8a3535b92983,8,3174626,3174685,3178253,3178907,3568,3627,59,0,0,0
3181859,66c7f340-7f14-ebb6-f78c-0ea03e2358f8,64,3149071,3149071,3181859,3196640,32788,32788,0,0,0,0
3193540,24516596-e7dc-5d43-e5b5-64c91a56b638,16,3062950,3062950,3193540,3195868,130590,130590,0,0,0,0
3193587,26b16c7c-5189-579a-7934-2fbd46296ada,8,3187366,3187409,3193587,3193949,6178,6221,43,0,0,0
3193658,f14dfb3e-fe3c-f361-e44d-9a28d739a70f,8,3187358,3187409,3193658,3196403,6249,6300,51,0,0,0
3193659,d7ee15bc-6ecd-8788-a31f-6c0fca66b8b7,8,3187360,3187409,3193659,3194816,6250,6299,49,0,0,0
3193601,55a28f90-ada7-93f0-e579-77ec48164644,8,3187362,3187409,3193601,3191648,6192,6239,47,0,0,0
3193607,f7f9efbc-4ba7-0c70-16a5-4aa01e1296dc,8,3187368,3187409,3193607,3195024,6198,6239,41,0,0,0
3193715,d298404d-96f6-2fa1-1951-9ab3bf5eaf8e,8,3187362,3187409,3193715,3195251,6306,6353,47,0,0,0
3193755,d772aea9-ec14-7855-94d9-6516897a68c9,8,3187349,3187349,3193755,3191896,6406,6406,0,0,0,0
3193760,7161c888-32c5-2d76-370e-bb11affee02e,8,3187385,3187409,3193760,3194287,6351,6375,24,0,0,0
3193770,7e29bddc-fd5c-d74e-8778-dbe69b29f76e,8,3187387,3187409,3193770,3191342,6361,6383,22,0,0,0
3193786,050fd4d6-70fe-4ca2-8cec-314982f8065a,8,3187351,3187409,3193786,3195628,6377,6435,58,0,0,0
3193819,f4e1048a-f417-adc9-f954-018b6be4d062,8,3187367,3187409,3193819,3192410,6410,6452,42,0,0,0
3193793,68353c7e-3eb0-59ec-4e6f-c9d441bff5b9,8,3187371,3187409,3193793,3196025,6384,6422,38,0,0,0
3193784,c8cd015b-5dc8-38f0-8c8d-f318b7609e4c,8,3187375,3187409,3193784,3196095,6375,6409,34,0,0,0
3193823,00cdcce8-17ed-ceb8-1739-1cff8cc99052,8,3187382,3187409,3193823,3192274,6414,6441,27,0,0,0
3193813,7b03f61b-5705-a33e-52f0-2148016d0426,8,3187383,3187409,3193813,3192680,6404,6430,26,0,0,0
3193888,0a4434d1-994a-c61f-5110-7df927d23eca,8,3187351,3187409,3193888,3194841,6479,6537,58,0,0,0
3193843,5577526f-6096-26ba-b03a-c41d3e9011e8,8,3187353,3187409,3193843,3194677,6434,6490,56,0,0,0
3193851,62c57829-6210-b734-9ded-b8538658c2e5,8,3187365,3187409,3193851,3195639,6442,6486,44,0,0,0
3193848,1307afb6-728e-a994-37df-79d830bd373a,8,3187380,3187409,3193848,3194952,6439,6468,29,0,0,0
3193856,8c9bcaa6-07aa-240c-5762-0a6f6f24564d,8,3187387,3187409,3193856,3192135,6447,6469,22,0,0,0
3193893,5f541a0d-7b4b-4a29-1991-61163aa4fcd6,8,3187388,3187409,3193893,3193448,6484,6505,21,0,0,0
3193936,f5e1ab65-8bd2-96cc-31cf-3224f0cb8112,8,3187354,3187409,3193936,3192650,6527,6582,55,0,0,0
3193950,df3bd35c-35c5-edf0-f43f-847a29baadcc,8,3187357,3187409,3193950,3191035,6541,6593,52,0,0,0
3193914,44d44eca-976b-5158-ea93-26f6ec221123,8,3187373,3187409,3193914,3196883,6505,6541,36,0,0,0
3193937,acdb425c-cff4-40eb-0730-24e4263490a1,8,3187380,3187409,3193937,3191829,6528,6557,29,0,0,0
3193955,666a7861-1494-1dbd-ff6f-4f21ce64a89a,8,3187384,3187409,3193955,3192404,6546,6571,25,0,0,0
3193922,d650e1f3-2231-5476-c005-05394e3b744f,8,3187389,3187409,3193922,3193700,6513,6533,20,0,0,0
3193986,4a95c90d-7c17-5917-d30a-835ddcea8b59,8,3187350,3187409,3193986,3195333,6577,6636,59,0,0,0
3193975,86451dda-fbe2-2c49-35fa-d47f9f0590b5,8,3187363,3187409,3193975,3190641,6566,6612,46,0,0,0
3193999,70d21fea-eba5-c500-df55-6ba6896d3a54,8,3187365,3187409,3193999,3193690,6590,6634,44,0,0,0
3193996,00bae133-babf-9447-e855-6690f4d85745,8,3187372,3187409,3193996,3192949,6587,6624,37,0,0,0
3194001,53921935-d6f8-d94c-39fa-35e6c98afa08,8,3187393,3187409,3194001,3195961,6592,6608,16,0,0,0
3194035,ff2d10f4-1555-6b95-f377-7cff1987e58e,8,3187350,3187409,3194035,3191053,6626,6685,59,0,0,0
3194062,81b89c44-ee28-c856-4fc6-0d4370ba8e9c,8,3187375,3187409,3194062,3193819,6653,6687,34,0,0,0
3194027,67f396b4-0510-9ebf-b347-fd7bf0e3b50f,8,3187375,3187409,3194027,3195031,6618,6652,34,0,0,0
3194024,bfcc8e33-c7da-450f-0bab-99ee6a3990da,8,3187382,3187409,3194024,3194317,6615,6642,27,0,0,0
3194071,fbb8d9fe-d0cb-16e9-bbc2-b67c9eec1868,8,3187392,3187409,3194071,3195674,6662,6679,17,0,0,0
3194113,eebd342d-22d9-1b18-0680-55f355114558,8,3187353,3187409,3194113,3191065,6704,6760,56,0,0,0
3194098,a203b5c1-5de1-3be7-1721-04cb6e21b4a2,8,3187356,3187409,3194098,3191510,6689,6742,53,0,0,0
3194092,21d7ef88-448e-8408-2cce-bc8640ac9243,8,3187370,3187409,3194092,3193971,6683,6722,39,0,0,0
3194128,37d9f94a-87e8-23e5-f4ae-6f01bfc3535d,8,3187376,3187409,3194128,3192397,6719,6752,33,0,0,0
3194081,a8c5840f-aa54-e68f-a927-4d42288a2e51,8,3187391,3187409,3194081,3191534,6672,6690,18,0,0,0
3194169,b14aba86-dbd0-afca-6c07-86be0819f509,8,3187349,3187349,3194169,3195354,6820,6820,0,0,0,0
3194170,be07d0c9-7154-5572-7aac-3fd3bc376bf5,8,3187357,3187409,3194170,3197161,6761,6813,52,0,0,0
3194163,20cbbd96-6699-aac3-b8f8-d92a3b6c28c5,8,3187371,3187409,3194163,3193182,6754,6792,38,0,0,0
3194281,7671b52a-293d-ffae-876d-9b132958d9ab,8,3187355,3187409,3194281,3196317,6872,6926,54,0,0,0
3194353,ec7448f9-5b60-47b0-1777-676070fff474,8,3187372,3187409,3194353,3195505,6944,6981,37,0,0,0
3194376,c5bde81d-cb7a-b831-ee65-3bb6ec981b8e,8,3187379,3187409,3194376,3191213,6967,6997,30,0,0,0
3197704,297eb3ce-11e3-d175-70ad-20702ca0ed97,8,3194874,3194874,3197704,3198807,2830,2830,0,0,0,0
3198171,e6184043-f9db-00b0-e40f-1972ea94a772,8,3194875,3194934,3198171,3198981,3237,3296,59,0,0,0
3198178,7a8f5fad-3c80-54cd-eacb-832956f4927f,8,3194877,3194934,3198178,3196871,3244,3301,57,0,0,0
3200261,b4c2d392-bbe3-a2f6-6f12-546d84061322,16,3087635,3087679,3200261,3170777,112582,112626,44,0,0,0
3203165,14c6e496-9146-f70a-269d-2c2229861808,8,3097946,3097946,3203165,3193160,105219,105219,0,0,0,0
3239683,7fc4bd3f-84c0-abed-d732-bacd8090661f,16,3203429,3203429,3239683,3233753,36254,36254,0,0,0,0
3240579,053b2764-6293-35dc-8fe5-bfbed66ec8bc,16,3204376,3204376,3240579,3249858,36203,36203,0,0,0,0
3241173,c75e769c-22e8-843e-1b4c-80a75b13d748,32,2769776,2769776,3241173,3250855,471397,471397,0,0,0,0
3255043,fba86e1e-34a1-48ba-1c7f-bd64ac5d2bd1,8,3201345,3201399,3255043,3243001,53644,53698,54,0,0,0
3255169,a1d60cf1-8a95-e0d8-4794-c44dab583656,8,3201344,3201399,3255169,3229285,53770,53825,55,0,0,0
3255322,121374ec-d9f5-6388-d202-5cd5d0b8bcbb,8,3201138,3201149,3255322,3277234,54173,54184,11,0,0,0
3255688,64836ec2-00b6-2158-0540-38d7399b747b,8,3201091,3201149,3255688,3270556,54539,54597,58,0,0,0
3256450,a71dc051-b1c8-0969-72da-c793663c36c1,8,3201438,3201459,3256450,3255002,54991,55012,21,0,0,0
3256820,411feb55-410c-de46-4762-fc232c189303,8,3201346,3201399,3256820,3284158,55421,55474,53,0,0,0
3257533,0eca3630-7342-64e1-6957-a9dd5258e6d8,8,3201339,3201339,3257533,3276615,56194,56194,0,0,0,0
3258179,3b8879a2-6078-ba69-40f8-95ff23352f7f,8,3201442,3201459,3258179,3234795,56720,56737,17,0,0,0
3266478,00256416-b908-803c-73e0-72cb05fd35aa,8,3201089,3201089,3266478,3252199,65389,65389,0,0,0,0
3270649,4e85661e-3bc6-c4e2-6dd5-346eab2f4642,8,3201089,3201089,3270649,3260934,69560,69560,0,0,0,0
3283648,82b3158f-7d03-3875-3b3a-ef0a5557bd35,16,3073528,3073528,3283648,3348890,210120,210120,0,0,0,0
3285934,c002c7fc-eb0a-97f7-1578-320ef4ca37a4,8,3200171,3200171,3285934,3289532,85763,85763,0,0,0,0
3289613,619c03d1-9362-2966-5f07-fe07f0a0a77d,16,3102349,3102349,3289613,3234373,187264,187264,0,0,0,0
3305189,2a966a13-be04-d96e-adb3-5ea8a43a5eda,16,3191918,3191918,3305189,3337863,113271,113271,0,0,0,0
3316860,2a8d16b0-30e8-c669-0fa3-3a9a453e50e0,8,3274891,3274921,3316860,3298420,41939,41969,30,0,0,0
3326979,a03f137f-f14d-a3ea-9faf-c17e92a2319d,8,3274853,3274861,3326979,3323469,52118,52126,8,0,0,0
3328064,ea8b34b9-e6c7-e728-f157-8055c5a79a96,8,3274824,3274861,3328064,3323554,53203,53240,37,0,0,0
3328192,0809c464-fc90-d88a-e33b-b3e0d5f00f27,8,3274498,3274498,3328192,3348395,53694,53694,0,0,0,0
3328568,eb536282-2aee-f929-b424-a7a0bd1e9e72,16,3322349,3322349,3328568,3328219,6219,6219,0,0,0,0
3329502,f46a9817-194a-589d-4f3f-be079dba68ea,8,3274741,3274741,3329502,3334604,54761,54761,0,0,0,0
3329721,b575dd69-0b61-89c4-844a-a5c98e56dda6,8,3274743,3274801,3329721,3306443,54920,54978,58,0,0,0
3329874,52ed2487-8aa9-d39a-726f-f6fdcec98bf1,8,3274743,3274801,3329874,3304591,55073,55131,58,0,0,0
3330124,0956f0e5-ef0c-1132-4151-55db179c0a64,8,3274514,3274558,3330124,3336542,55566,55610,44,0,0,0
3330537,4c03e875-a8bc-30fa-5e24-67ba1130521c,8,3274742,3274801,3330537,3315344,55736,55795,59,0,0,0
3332159,92f72f86-3958-289b-1e05-4c8a28605c20,8,3274519,3274558,3332159,3344217,57601,57640,39,0,0,0
3349826,2adff941-93c2-9f31-a495-dbf92632fa9d,8,3071983,3071983,3349826,3255740,277843,277843,0,0,0,0
3366709,094f5166-0bae-6d2b-fbec-e5d5a8856294,1,3360162,3360162,3366709,3367032,6547,6547,0,0,0,0
3367074,f6423513-9ba1-43ac-649e-2575339c0ee9,1,3359605,3359605,3367074,3367417,7469,7469,0,0,0,0
3367166,d5b26840-f4b3-593f-0b38-2c494853338d,1,3359716,3359716,3367166,3370115,7450,7450,0,0,0,0
3367233,b43e9061-171d-a81d-b57e-526c1627999a,1,3359943,3359943,3367233,3370420,7290,7290,0,0,0,0
3367337,0777cad1-c900-20bf-f1b1-59b61e8c8499,1,3360054,3360054,3367337,3364258,7283,7283,0,0,0,0
3367751,f3098246-33ca-623f-f301-13f042bffd8b,1,3359833,3359833,3367751,3370039,7918,7918,0,0,0,0
3368287,17664a5a-f24e-2477-2f51-5686a88db0f3,1,3360782,3360782,3368287,3371378,7505,7505,0,0,0,0
3369499,00e5ebaf-2eb0-6b1e-ea7e-ee0b677ebe4d,1,3360668,3360668,3369499,3368097,8831,8831,0,0,0,0
3370272,1a06cff0-73f5-6452-6899-25840ade0b41,1,3360929,3360929,3370272,3365925,9343,9343,0,0,0,0
3375621,9d482c49-f53f-d2d3-4df6-720520ff622c,8,3369647,3369647,3375621,3377232,5974,5974,0,0,0,0
3376053,6d1b5e96-6e64-8ec8-15db-0b31f6c84ff5,8,3371183,3371241,3376053,3376357,4812,4870,58,0,0,0
3376167,129b1e2d-74a4-1600-af56-2306276c01fb,8,3371181,3371181,3376167,3376304,4986,4986,0,0,0,0
3376241,ee6d7a27-e95b-9b7b-e585-fc3d7bf7202e,8,3371183,3371241,3376241,3376317,5000,5058,58,0,0,0
3376618,4a7109c6-74f8-9694-7c95-9cad75e7f531,8,3371181,3371181,3376618,3376630,5437,5437,0,0,0,0
3376627,03617d89-f038-419a-084d-93a646a968c5,8,3371183,3371241,3376627,3377622,5386,5444,58,0,0,0
3376744,30084a02-a090-3f90-3fc5-43c97c479df2,8,3371182,3371241,3376744,3375387,5503,5562,59,0,0,0
3377133,dc8f79c8-bd95-5829-e72c-f300c917a68e,8,3371182,3371241,3377133,3375965,5892,5951,59,0,0,0
3377539,1f737931-b137-d223-bbeb-914b115626bb,8,3371183,3371241,3377539,3378098,6298,6356,58,0,0,0
3377585,b2f9fa1a-53c5-4448-b61c-c55b8fd0720c,8,3371183,3371241,3377585,3380301,6344,6402,58,0,0,0
3378923,9b9abb6d-dc95-4d75-944f-12fc22f1e7d4,8,3371184,3371241,3378923,3380956,7682,7739,57,0,0,0
3379794,517eb16a-9922-2b37-2d9e-b2d25adea2a4,1,3360547,3360547,3379794,3382938,19247,19247,0,0,0,0
3383502,92010309-1588-6873-2729-26b0ee0b683a,32,3337444,3337444,3383502,3397968,46058,46058,0,0,0,0
3384233,96bfbee0-09a2-7373-32fd-73447862f1cf,1,3360318,3360318,3384233,3372340,23915,23915,0,0,0,0
3384370,4b50045e-fd93-34a1-e5af-12b1d83c575c,1,3360436,3360436,3384370,3386997,23934,23934,0,0,0,0
3419121,72be5fb8-52dc-383c-236b-f12c181d8b09,8,3414148,3414148,3419121,3419825,4973,4973,0,0,0,0
3419145,2e5b80a1-57a2-5d1c-24e1-d1d903f10ab7,8,3414148,3414148,3419145,3421541,4997,4997,0,0,0,0
3419600,0ae95eb4-842a-ebac-6c7e-80ad29709912,8,3414149,3414208,3419600,3418114,5392,5451,59,0,0,0
3419600,a44a0d54-472a-9d93-2c6e-7aa80e81a1fd,8,3414149,3414208,3419600,3417463,5392,5451,59,0,0,0
3419613,f8736e59-062b-d6f0-8ea4-17feb85f0883,8,3414152,3414208,3419613,3418719,5405,5461,56,0,0,0
3419759,a8b931bb-7c60-e5a9-761e-8bb724c0c086,8,3414151,3414208,3419759,3418452,5551,5608,57,0,0,0
3419963,811143a5-0a00-ab04-f359-77e1f1cdf51a,8,3414148,3414148,3419963,3417475,5815,5815,0,0,0,0
3419991,32a6f3f1-2c46-e25e-77b5-520fb02ed1d7,8,3414148,3414148,3419991,3422597,5843,5843,0,0,0,0
3420075,1f1d1b20-be91-dd2a-bf02-4c09051d1800,8,3414154,3414208,3420075,3417489,5867,5921,54,0,0,0
3420112,b6a9e66b-19b9-1096-246c-4e5b7f25d908,8,3412061,3412061,3420112,3423845,8051,8051,0,0,0,0
3420476,0ab6c155-2e42-d010-e9cd-10722127130e,8,3410988,3410988,3420476,3416667,9488,9488,0,0,0,0
3420499,0f3b5f06-6de2-8a01-d12d-bd50902ead79,8,3414149,3414208,3420499,3417730,6291,6350,59,0,0,0
3420532,9c6c3c4e-8f5b-8149-eb67-212a29b76b37,8,3414151,3414208,3420532,3420096,6324,6381,57,0,0,0
3420490,62fc194b-649d-72ad-4556-b8a2db747f33,8,3414152,3414208,3420490,3420006,6282,6338,56,0,0,0
3420859,922d2afe-4d7c-a758-a305-5dbfabb5fd1e,8,3411029,3411048,3420859,3417598,9811,9830,19,0,0,0
3432631,c2174dbb-e10d-b2b1-9881-3adcad45c94d,16,3428641,3428641,3432631,3433951,3990,3990,0,0,0,0
3432753,a4afade6-ca60-0b2d-09c6-28ddbff090b9,16,3428977,3428977,3432753,3431543,3776,3776,0,0,0,0
3444892,a2b89e20-ef0f-3c04-a9e7-78cbcbba7e58,8,3442388,3442391,3444892,3444788,2501,2504,3,0,0,0
3447972,352b6689-a39c-d730-0f62-06f19403ad3d,8,3442390,3442391,3447972,3445608,5581,5582,1,0,0,0
3448321,0ead2ebd-4662-477c-6eec-28adf5c4dab4,8,3442387,3442391,3448321,3450100,5930,5934,4,0,0,0
3448286,3fa916f9-eeb1-ecb9-7008-f9e0c28c36b8,8,3442389,3442391,3448286,3450469,5895,5897,2,0,0,0
3448422,d92757a8-6ece-6ce9-9112-448d473407a3,8,3442346,3442391,3448422,3446126,6031,6076,45,0,0,0
3448408,fbff1829-aea3-798b-00bd-204e32714f01,8,3442384,3442391,3448408,3445690,6017,6024,7,0,0,0
3448594,ddc096d2-25fc-850a-be17-56edf0553964,8,3442344,3442391,3448594,3445657,6203,6250,47,0,0,0
3448643,82b91686-7126-c537-8bb8-14ccda3069f5,8,3442350,3442391,3448643,3447671,6252,6293,41,0,0,0
3448679,d619e0ce-69d5-ddf5-1d95-cdeac417fe56,8,3442332,3442391,3448679,3449135,6288,6347,59,0,0,0
3448671,19d6cf82-25b9-6454-0bfe-68af3a87b3e2,8,3442337,3442391,3448671,3449233,6280,6334,54,0,0,0
3448702,a1b95e07-af38-0794-e0eb-16f1d3e8947f,8,3442378,3442391,3448702,3448104,6311,6324,13,0,0,0
3448758,542fbdd4-e714-e1a3-5bf9-bfad03b93598,8,3442340,3442391,3448758,3447955,6367,6418,51,0,0,0
3448767,6ce87f51-1eb2-c170-31e2-d719f2034fe7,8,3442344,3442391,3448767,3445658,6376,6423,47,0,0,0
3448798,209f9f95-9f04-fdd0-1337-27c0c533fd1e,8,3442350,3442391,3448798,3446983,6407,6448,41,0,0,0
3448892,1374975f-6081-f8de-6e74-745d0af15cc2,8,3442344,3442391,3448892,3448072,6501,6548,47,0,0,0
3448862,96f22a06-15c5-fe34-f183-0345a4229f14,8,3442384,3442391,3448862,3450639,6471,6478,7,0,0,0
3448860,aaae3222-3f19-ed0f-54c3-9b6d0e31275c,8,3442385,3442391,3448860,3450231,6469,6475,6,0,0,0
3448914,2c81a569-8cde-5998-6a24-7a0cf2247b8d,8,3442349,3442391,3448914,3448180,6523,6565,42,0,0,0
3448939,d9e07cbd-1734-2957-0341-1e59a5680f62,8,3442354,3442391,3448939,3447043,6548,6585,37,0,0,0
3448928,9d470a35-c816-3c27-7c3c-4c2fa40e0199,8,3442389,3442391,3448928,3451774,6537,6539,2,0,0,0
3449013,0abdbcd1-782c-cfec-9e5d-78a1c5bdb495,8,3442390,3442391,3449013,3448288,6622,6623,1,0,0,0
3449006,52c5be0f-f2e3-e19a-f57a-7220763a4e61,8,3442394,3442451,3449006,3451820,6555,6612,57,0,0,0
3449071,3c573da8-0abe-20fe-8375-9222f74c72c0,8,3442332,3442391,3449071,3445983,6680,6739,59,0,0,0
3449053,3b38102b-7bdf-1546-e4a8-844f7d94a6ce,8,3442336,3442391,3449053,3449343,6662,6717,55,0,0,0
3449025,c7f06fea-94e0-8798-0852-02b0cc4f2da9,8,3442343,3442391,3449025,3451485,6634,6682,48,0,0,0
3449021,d46a537b-bc0b-55fe-5713-412e8bceda58,8,3442373,3442391,3449021,3449465,6630,6648,18,0,0,0
3449021,4acafd79-ec60-6353-f12d-2edce6b03b0d,8,3442375,3442391,3449021,3447870,6630,6646,16,0,0,0
3449060,513be62e-d9ff-cacd-7284-03566d1eb9b4,8,3442390,3442391,3449060,3449230,6669,6670,1,0,0,0
3449122,aa8b73eb-3cde-0596-4cac-dd3d1ae5b384,8,3442336,3442391,3449122,3450618,6731,6786,55,0,0,0
3449133,e9f35e11-928a-44dd-8ace-87b74250f956,8,3442339,3442391,3449133,3447358,6742,6794,52,0,0,0
3449081,f68d6979-7fe4-c461-24e1-ed797d99e386,8,3442377,3442391,3449081,3449947,6690,6704,14,0,0,0
3449106,32e72520-4d83-b055-17ac-720e0626d3be,8,3442379,3442391,3449106,3452132,6715,6727,12,0,0,0
3449102,4f3c0388-ec61-23eb-733c-4dee97d47986,8,3442395,3442451,3449102,3446297,6651,6707,56,0,0,0
3449158,b10e91b4-6ae5-cc9d-79d3-cba066a0835e,8,3442332,3442391,3449158,3451244,6767,6826,59,0,0,0
3449144,4f3b81d6-3745-abe5-bfd0-96b42c85ab3f,8,3442341,3442391,3449144,3450133,6753,6803,50,0,0,0
3449163,d2b2cf4b-489d-3b8a-bab0-dbe0438e1bb9,8,3442349,3442391,3449163,3446110,6772,6814,42,0,0,0
3449157,071c641d-2242-1baa-9ac6-2e25cf3cc829,8,3442380,3442391,3449157,3449437,6766,6777,11,0,0,0
3449147,b381e8b0-38ca-4da7-01f0-98fca45ccc55,8,3442393,3442451,3449147,3448593,6696,6754,58,0,0,0
3449199,78f8ebed-05cb-5465-1e8f-ada4b4c77a96,8,3442331,3442331,3449199,3449396,6868,6868,0,0,0,0
3449225,be60808d-bcb3-9076-7688-f76ea504ee5a,8,3442334,3442391,3449225,3447315,6834,6891,57,0,0,0
3449237,b7696e0e-c07c-5f32-3e5f-e7f59252a620,8,3442351,3442391,3449237,3447670,6846,6886,40,0,0,0
3449222,5f9094ca-e18e-763b-0d57-aef54aecb057,8,3442393,3442451,3449222,3447126,6771,6829,58,0,0,0
3449370,a31ffadd-0170-3874-3e89-7b355b2dec8c,8,3442339,3442391,3449370,3450848,6979,7031,52,0,0,0
3449371,5ff2b09f-084a-2ec4-3b91-80f58daf7c97,8,3442380,3442391,3449371,3452283,6980,6991,11,0,0,0
3450468,1ec83ceb-c201-526f-2924-b4722363bd37,8,3442339,3442391,3450468,3449702,8077,8129,52,0,0,0
3450476,b3f731b7-1375-9f4a-7243-3e5365410267,8,3442381,3442391,3450476,3453647,8085,8095,10,0,0,0
3450705,9a8b8524-4fac-a0ff-1385-3f450ed57c8c,8,3442375,3442391,3450705,3453639,8314,8330,16,0,0,0
3450734,509ac91f-31ea-b1f4-2364-8766a43a4bdd,8,3442376,3442391,3450734,3449693,8343,8358,15,0,0,0
3454378,496ff6e3-0495-061f-9080-810858904829,1,3448027,3448032,3454378,3456299,6346,6351,5,0,0,0
3454437,891a9b5b-9763-43b4-b209-683eb7cc7157,1,3448163,3448163,3454437,3457431,6274,6274,0,0,0,0
3455658,04579d6f-93d3-125a-3a56-04b37acd003a,1,3448277,3448277,3455658,3452484,7381,7381,0,0,0,0
3456532,b9def348-4ea7-2fb3-0dbb-d8ed4ebed7c3,1,3448909,3448954,3456532,3458906,7578,7623,45,0,0,0
3456636,9564a7bd-c5de-72fb-dd31-5c0b530f7e66,1,3447759,3447759,3456636,3454470,8877,8877,0,0,0,0
3456968,2978ad8f-0cc0-623f-6221-6ec62e5a7731,1,3447603,3447603,3456968,3459429,9365,9365,0,0,0,0
3457275,c53a8da2-2f2f-f254-a22f-3da5dab2a215,1,3447890,3447890,3457275,3457590,9385,9385,0,0,0,0
3457541,a84f3d75-69f8-76b9-481d-07d0ec2fb9e6,1,3449017,3449074,3457541,3457502,8467,8524,57,0,0,0
3457494,e62e54eb-878a-b369-e2e4-4a013e889897,1,3449726,3449726,3457494,3458462,7768,7768,0,0,0,0
3457608,b87618a0-e519-1db0-b64c-99ed963a4320,1,3448750,3448774,3457608,3459878,8834,8858,24,0,0,0
3457709,454c976e-c5bc-10a9-6cf4-090928349f05,1,3449861,3449861,3457709,3454241,7848,7848,0,0,0,0
3457844,931b5970-e946-033f-79b2-2b20db8d1836,1,3449974,3449974,3457844,3459696,7870,7870,0,0,0,0
3458790,250b0aeb-fa76-81da-fbb6-4c040dc56a75,1,3449392,3449430,3458790,3457596,9360,9398,38,0,0,0
3458894,1b2b5f8b-a27e-5970-0452-ba518223c495,1,3449501,3449501,3458894,3458439,9393,9393,0,0,0,0
3458959,bd86a1ab-c16f-5ca3-7854-f2ce102c89ba,1,3449611,3449611,3458959,3458871,9348,9348,0,0,0,0
3460025,3977c6c3-4f75-d392-fca7-e61410b7ca01,1,3450469,3450528,3460025,3461533,9497,9556,59,0,0,0
3460059,6bda623f-aca9-b4d8-8381-863cfb0cd85d,1,3450613,3450613,3460059,3462806,9446,9446,0,0,0,0
3460801,0c2fded5-1f74-c09c-b01c-5226e3786121,1,3450729,3450765,3460801,3458869,10036,10072,36,0,0,0
3461474,558c7208-283c-a7ec-d8b4-f757d91ade99,8,3459499,3459499,3461474,3461185,1975,1975,0,0,0,0
3461740,92dba65f-ec35-ed88-1431-9083ce60cada,1,3459847,3459847,3461740,3461390,1893,1893,0,0,0,0
3464726,f55c6af8-c6b4-4036-baca-2a87766afbe7,1,3463047,3463051,3464726,3465108,1675,1679,4,0,0,0
3466077,1f7e09de-b799-08b6-8095-fa69db07a2a9,1,3459549,3459559,3466077,3465439,6518,6528,10,0,0,0
3466472,260027aa-197d-dceb-f498-816e61cb03f3,1,3459436,3459436,3466472,3466041,7036,7036,0,0,0,0
3466681,3e4c23fb-1f0b-1094-597c-e0cf50ad9cd5,1,3459680,3459691,3466681,3469192,6990,7001,11,0,0,0
3466862,d0a05417-2bac-7c89-31d8-3f7868437031,1,3459229,3459229,3466862,3470312,7633,7633,0,0,0,0
3467692,a33f06f4-fe87-9e56-cc7f-7718509e1cc2,1,3460201,3460201,3467692,3466282,7491,7491,0,0,0,0
3467789,31ccd55c-18db-494a-56f2-ce968d1d122a,1,3460080,3460089,3467789,3468009,7700,7709,9,0,0,0
3467937,6fa760a9-c19b-fe2a-7517-6bfad298345c,1,3448519,3448522,3467937,3464551,19415,19418,3,0,0,0
3467941,0963c291-242f-478f-77f3-cc6c766b6138,1,3460449,3460449,3467941,3468567,7492,7492,0,0,0,0
3468601,084a4052-4913-a18b-ddcf-f347b5d84cae,1,3459139,3459139,3468601,3468639,9462,9462,0,0,0,0
3468706,1a0c0048-7108-f569-108d-6ac75baca439,1,3459321,3459321,3468706,3468963,9385,9385,0,0,0,0
3469164,05aa0cd3-5eb4-5406-4919-d9ff57dfba1d,1,3468119,3468132,3469164,3469612,1032,1045,13,0,0,0
3469246,91be48c3-2329-9406-5bac-0279a66b3d83,1,3460327,3460327,3469246,3468688,8919,8919,0,0,0,0
3470254,0852a95e-9015-144f-f539-1cd538e8279f,1,3462171,3462171,3470254,3469360,8083,8083,0,0,0,0
3470442,9155ed93-626d-7bf1-17a3-f0bed9b37816,1,3462290,3462290,3470442,3473263,8152,8152,0,0,0,0
3470495,af61e25e-ec68-74df-1c63-c39b6675b033,1,3462413,3462413,3470495,3467386,8082,8082,0,0,0,0
3470941,ee426792-ce2c-36df-0051-01e5a7b85447,1,3467892,3467892,3470941,3471621,3049,3049,0,0,0,0
3471149,276a3335-0a6d-bd8b-1136-5b345b867d34,1,3464349,3464349,3471149,3469328,6800,6800,0,0,0,0
3471396,62d0abcd-bc3f-512e-89f3-2a99dfc735f8,1,3464244,3464244,3471396,3473969,7152,7152,0,0,0,0
3471485,031831eb-a720-52b4-102f-236d44270572,1,3463782,3463782,3471485,3468977,7703,7703,0,0,0,0
3471636,e7269390-c235-25c0-c16f-584add1b469d,1,3464132,3464132,3471636,3470182,7504,7504,0,0,0,0
3471813,28e9209e-2470-5fcc-62cc-a6611a2a69d9,1,3461841,3461841,3471813,3471565,9972,9972,0,0,0,0
3471803,d90a8d20-de53-42d6-9e2f-d4afb18fbcd3,1,3462059,3462059,3471803,3467968,9744,9744,0,0,0,0
3471878,bfe9efdb-4a57-b541-4387-4957d4d61370,1,3461953,3461953,3471878,3472891,9925,9925,0,0,0,0
3472409,20448d4c-c732-ca9b-c992-e0cc244a9ac8,1,3464720,3464720,3472409,3472237,7689,7689,0,0,0,0
3472657,4459e2fd-2350-9275-8cef-f4f40efdcce7,1,3448402,3448402,3472657,3482551,24255,24255,0,0,0,0
3472911,950f5eff-dc51-36e4-d912-d963d32a9e06,1,3448632,3448654,3472911,3484026,24257,24279,22,0,0,0
3473164,e2eb0222-26c6-8746-0391-ddc53e33a833,1,3462925,3462931,3473164,3475689,10233,10239,6,0,0,0
3473215,4410d892-7419-6962-1f8f-a9dd7daf8db1,1,3464845,3464845,3473215,3475482,8370,8370,0,0,0,0
3473370,55409902-4997-9fe3-231e-388af82dd1f5,1,3465080,3465080,3473370,3469506,8290,8290,0,0,0,0
3473404,07b38e70-7ffd-fae1-8cb9-8201a8d705bf,1,3463205,3463205,3473404,3470763,10199,10199,0,0,0,0
3473633,2964aa99-1728-c576-452d-52fac0ae3ba6,1,3463902,3463902,3473633,3473876,9731,9731,0,0,0,0
3473949,45bbfb02-f99c-f98f-62d8-d220bd36a04a,1,3469030,3469030,3473949,3474051,4919,4919,0,0,0,0
3473952,4bae2c00-eb3f-4202-4579-609a3b1dfabe,1,3464024,3464024,3473952,3477676,9928,9928,0,0,0,0
3474657,ed0c082b-cb78-57a9-4410-710eca3761d2,1,3450222,3450222,3474657,3473165,24435,24435,0,0,0,0
3474756,2b31b5e7-40ed-4d57-04a6-24f3231830a3,1,3468228,3468252,3474756,3474549,6504,6528,24,0,0,0
3474826,1ac62a63-feca-6f41-d908-d31984584019,1,3450348,3450348,3474826,3484117,24478,24478,0,0,0,0
3474825,79b25e7e-73eb-73ce-262e-df5e0f4fbd2b,1,3464972,3464972,3474825,3470097,9853,9853,0,0,0,0
3474904,c3d1b0b7-be94-ee36-5229-e29b56430354,1,3468463,3468492,3474904,3474861,6412,6441,29,0,0,0
3475050,e28b40c6-852f-88aa-0e2d-df52fd8190c8,1,3450096,3450096,3475050,3477840,24954,24954,0,0,0,0
3475209,b04fd83c-1773-3d21-e906-222b8a00cf6f,8,3459632,3459691,3475209,3474830,15518,15577,59,0,0,0
3476193,9635dc67-ad5a-e575-565d-6ed039b05c64,1,3468349,3468372,3476193,3476649,7821,7844,23,0,0,0
3476970,a6d50103-18b6-85c5-86df-605bb0cebeff,1,3468907,3468907,3476970,3476224,8063,8063,0,0,0,0
3477354,db82b67d-dd7e-0ae6-369d-5ad492b5a7e3,1,3469851,3469880,3477354,3474699,7474,7503,29,0,0,0
3477538,f8e8e938-b2df-f2fe-9c90-282181a8d2b0,1,3469139,3469166,3477538,3479575,8372,8399,27,0,0,0
3477688,05476e17-0f9b-0aca-0081-a70437c200e3,1,3467998,3468012,3477688,3475186,9676,9690,14,0,0,0
3477826,446f0620-c580-bccf-4440-77d24ec24fb4,8,3459632,3459691,3477826,3476227,18135,18194,59,0,0,0
3478132,0279d6d8-e869-28cd-0f0c-b156ffc6ce15,1,3469739,3469760,3478132,3481228,8372,8393,21,0,0,0
3478296,a7b414b4-4e32-b993-e014-ec53f87c318a,1,3469963,3470000,3478296,3480373,8296,8333,37,0,0,0
3478432,b8c4535c-44ac-1bbe-fd88-857bcc282628,8,3459631,3459631,3478432,3479741,18801,18801,0,0,0,0
3479311,71b78d57-3f7b-877d-b4b5-11b93a573c6e,1,3469344,3469346,3479311,3483352,9965,9967,2,0,0,0
3479378,67f7aba4-0617-4c62-a243-b9ab2b0e817c,1,3469633,3469640,3479378,3475119,9738,9745,7,0,0,0
3479630,fe8c686a-9bdf-9c67-62f9-11de087fcdef,1,3469520,3469520,3479630,3481827,10110,10110,0,0,0,0
3480191,b1195d16-9aec-319f-f38e-f31f08ae64bb,1,3470470,3470502,3480191,3479319,9689,9721,32,0,0,0
3480662,68fd1179-75d9-2768-f5ca-07f4b34d8b83,1,3470718,3470718,3480662,3483922,9944,9944,0,0,0,0
3480708,8baf1516-0b6a-9167-2b6d-ee52058e2844,1,3470591,3470591,3480708,3478844,10117,10117,0,0,0,0
3481318,8d80c2fe-b7b1-0072-3436-873728ffa490,1,3474818,3474837,3481318,3478676,6481,6500,19,0,0,0
3482394,c07ec4c4-b6b4-aaa5-39c4-2eed297f8f1e,1,3474596,3474596,3482394,3484517,7798,7798,0,0,0,0
3482971,4d9e6b9f-a3ee-785f-134a-fb2395ce2483,1,3474704,3474717,3482971,3483831,8254,8267,13,0,0,0
3483141,d8a29687-d5fd-1cce-1627-a8eeff7d485c,1,3475003,3475003,3483141,3479021,8138,8138,0,0,0,0
3483432,dfe9a6ee-4300-6c97-c0f3-beb154959740,1,3475493,3475493,3483432,3486308,7939,7939,0,0,0,0
3483898,607b7b22-2d18-01d7-602c-98871cecb536,32,3289137,3289137,3483898,3504754,194761,194761,0,0,0,0
3484058,e6af993c-700f-8e85-2ea7-56a8229ea406,1,3474485,3474485,3484058,3486527,9573,9573,0,0,0,0
3484195,9258b0c0-af58-1559-a186-ef6ff0d20481,1,3464457,3464457,3484195,3484121,19738,19738,0,0,0,0
3484185,2e0c881c-1068-2337-ee5e-ccf7df4924f2,1,3474372,3474372,3484185,3483582,9813,9813,0,0,0,0
3484522,ccaeb64c-74c2-a11d-a3dc-896e902369ab,1,3475597,3475597,3484522,3486929,8925,8925,0,0,0,0
3484780,060556e8-d798-1e8b-5a1a-e46111ba91f9,1,3476758,3476758,3484780,3481510,8022,8022,0,0,0,0
3484853,8f45c269-6b52-59dc-e0d8-b49272896055,1,3459969,3459969,3484853,3476819,24884,24884,0,0,0,0
3485082,db2be1be-ba73-5eb2-999f-46ebbcb760a9,8,3476337,3476378,3485082,3480792,8704,8745,41,0,0,0
3485210,9d70773e-dcd9-f69f-7897-59ef170d5c13,1,3476887,3476901,3485210,3481374,8309,8323,14,0,0,0
3485376,eb6d3598-232f-9fbe-aa5b-e35369331443,1,3476996,3477021,3485376,3488473,8355,8380,25,0,0,0
3485427,f60ad0a3-8eee-fe95-5987-67113c20fe71,1,3475702,3475717,3485427,3485613,9710,9725,15,0,0,0
3486251,66f0c1f5-28ca-1d6f-744a-7cf510ca8162,8,3476215,3476258,3486251,3482777,9993,10036,43,0,0,0
3486505,14ceea13-c6ae-96ec-47fd-54eea4728ffc,1,3464582,3464582,3486505,3480765,21923,21923,0,0,0,0
3486545,db0dc10e-1ca4-8caf-59c1-3fccf5fe9cc4,1,3476624,3476624,3486545,3486082,9921,9921,0,0,0,0
3486591,2e206e6f-7e46-0b4e-c213-89d9fdc642fe,1,3476514,3476558,3486591,3490841,10033,10077,44,0,0,0
3486831,21a44c4a-097c-763b-61dc-1d581ca88afb,8,3476267,3476318,3486831,3490723,10513,10564,51,0,0,0
3486948,4128b138-bf99-a6e3-6347-8b41f2023981,1,3476405,3476438,3486948,3491680,10510,10543,33,0,0,0
3487406,c5bc4663-f995-ae6a-4c68-36090c39de51,1,3477761,3477761,3487406,3486906,9645,9645,0,0,0,0
3487432,dd90fef2-fbf7-ad20-6a7e-95d258fe79a1,1,3462525,3462533,3487432,3486412,24899,24907,8,0,0,0
3487499,f3151b0a-fd13-5ac5-e6cf-af54ca9dc28c,1,3477519,3477519,3487499,3486048,9980,9980,0,0,0,0
3487470,d8ccacd5-b35c-348c-3193-4d22976611ee,1,3477640,3477640,3487470,3486188,9830,9830,0,0,0,0
3487651,ca7d60a1-d6f3-0b49-6168-2935b8b91656,1,3462644,3462653,3487651,3495080,24998,25007,9,0,0,0
3487916,e7e4a92a-138c-549c-c53a-cbfc8bc7393e,1,3462800,3462811,3487916,3475831,25105,25116,11,0,0,0
3488339,a6792090-5160-d305-6dcd-8d4318ecae05,8,3459503,3459559,3488339,3501782,28780,28836,56,0,0,0
3488708,d351df5f-310b-82d7-90b9-ae31c46ac405,1,3468796,3468817,3488708,3483824,19891,19912,21,0,0,0
3488778,afd0c396-bb31-caeb-c8ce-14bb7dc63851,8,3403177,3403177,3488778,3521262,85601,85601,0,0,0,0
3490103,51c680ca-57a6-e460-1b66-f3d3e6afcce9,8,3459500,3459559,3490103,3486019,30544,30603,59,0,0,0
3490106,4a13b17c-8d93-8a1b-e5d2-5bc33c3826aa,8,3459505,3459559,3490106,3499461,30547,30601,54,0,0,0
3490300,6dabaa1c-5868-e32a-44c7-71063811f9e9,8,3459499,3459499,3490300,3490176,30801,30801,0,0,0,0
3492548,e0ad8c81-f297-ca6e-28f3-0754358e5535,8,3459502,3459559,3492548,3504020,32989,33046,57,0,0,0
3493084,75766872-d5cb-20a3-69cb-fc4e2f4bc0ce,8,3459508,3459559,3493084,3480067,33525,33576,51,0,0,0
3493142,51f8deb6-3404-07f4-8a48-28afe4ff5eec,1,3468577,3468577,3493142,3494884,24565,24565,0,0,0,0
3493261,b8ee0ec6-2b0a-0050-235a-a8e9838fd802,1,3468682,3468697,3493261,3481940,24564,24579,15,0,0,0
3493353,0cc6f6d1-6d66-392c-ac05-ad5c43089e1c,8,3459500,3459559,3493353,3485264,33794,33853,59,0,0,0
3493379,02e842bb-9391-6c8b-5628-c13eea9b85eb,8,3459504,3459559,3493379,3503673,33820,33875,55,0,0,0
3494031,3c675934-95e7-8fd0-433f-ed33a7b4d7c9,16,3492740,3492740,3494031,3494344,1291,1291,0,0,0,0
3494820,f8930a13-d770-17c8-c053-9b74fa00a281,1,3470073,3470073,3494820,3506246,24747,24747,0,0,0,0
3495025,eb19071b-0b35-e0a1-3fa5-e99ffb23a4b7,1,3470355,3470355,3495025,3483289,24670,24670,0,0,0,0
3495347,210f0001-d832-c732-30f6-99cdb4456f0d,1,3470207,3470256,3495347,3505348,25091,25140,49,0,0,0
3496054,1b35caa1-c146-7fee-0235-1b4f59b164ca,8,3459506,3459559,3496054,3478342,36495,36548,53,0,0,0
3498552,af6c9f36-64f9-2ef3-c072-15b1c544966b,1,3475219,3475269,3498552,3506338,23283,23333,50,0,0,0
3499498,cb3ada7f-a10d-0623-6046-2998e37f24d7,1,3475109,3475123,3499498,3503495,24375,24389,14,0,0,0
3499661,fa709240-af8f-c8b4-d01d-cc22e22a75cc,16,3466820,3466820,3499661,3496470,32841,32841,0,0,0,0
3499776,16d49f2d-103b-a2ed-d540-d6f59f8c9841,1,3475326,3475329,3499776,3487589,24447,24450,3,0,0,0
3500150,e5b2fd55-b0a5-c3c1-3409-1297031fdae1,8,3485960,3485960,3500150,3506444,14190,14190,0,0,0,0
3500417,2086ba87-0bf2-598c-21be-4ca5cadaf90f,8,3485961,3486020,3500417,3498877,14397,14456,59,0,0,0
3500455,7024cf94-0830-8982-56fc-1a769e1d5748,8,3485966,3486020,3500455,3501257,14435,14489,54,0,0,0
3500723,0f57bc75-07af-b918-5020-036f9adbb8f1,16,3467289,3467337,3500723,3495208,33386,33434,48,0,0,0
3501168,e69cf4c8-72d6-27e9-95af-bf6fc7b0a9e2,8,3485997,3486020,3501168,3493659,15148,15171,23,0,0,0
3501321,14420114-dfe7-04a4-3225-70ff20baeb3f,8,3485964,3486020,3501321,3506501,15301,15357,56,0,0,0
3501351,acb0bce4-164c-0e98-e25f-f355f8f43249,8,3485962,3486020,3501351,3502254,15331,15389,58,0,0,0
3501801,8d4363a2-3f2d-1955-78f3-0ce351ef467b,1,3477113,3477141,3501801,3510130,24660,24688,28,0,0,0
3501955,877477ad-94a2-2b24-c028-286b5402b337,1,3477290,3477290,3501955,3509086,24665,24665,0,0,0,0
3502389,4baec9a5-274c-51a1-04d4-0f6a622361ee,1,3477409,3477410,3502389,3507824,24979,24980,1,0,0,0
3503882,908bb7f9-9d91-21b2-9ea6-23257e91eec8,8,3485966,3486020,3503882,3509280,17862,17916,54,0,0,0
3503943,922731e9-3aaf-6187-6638-4b25a9f9f36c,8,3485960,3485960,3503943,3499271,17983,17983,0,0,0,0
3503950,dbe79ccb-f600-2685-ddbd-3afbe5f3fcb9,8,3485965,3486020,3503950,3509802,17930,17985,55,0,0,0
3504567,4f848c31-7954-af2d-a819-d4b9b1a6aed3,8,3459501,3459559,3504567,3522377,45008,45066,58,0,0,0
3504909,e090c65f-715c-8f85-4d52-9e8a4b5f9c24,8,3485963,3486020,3504909,3507064,18889,18946,57,0,0,0
3504974,12a34b04-a15e-cdba-682c-3bb2583f66bd,8,3485962,3486020,3504974,3500412,18954,19012,58,0,0,0
3505065,8ce285db-db30-e078-c435-0ad5c04675c7,8,3485963,3486020,3505065,3496180,19045,19102,57,0,0,0
3535414,1aca9cf6-7ab6-1c3c-d667-159d22021f9f,8,3520112,3520112,3535414,3533378,15302,15302,0,0,0,0
3535437,19f58e82-5008-606f-dbf5-aafeb67a3c07,8,3520109,3520112,3535437,3528300,15325,15328,3,0,0,0
3535511,f4de6a69-6494-446a-3f00-5dab4a490f80,8,3520117,3520172,3535511,3542327,15339,15394,55,0,0,0
3536210,f70a1523-17d8-e814-b669-c307487a2d8b,8,3520054,3520112,3536210,3535662,16098,16156,58,0,0,0
3536267,f3d210db-e41f-ba4b-90c4-e57a97da6c23,8,3520053,3520112,3536267,3528434,16155,16214,59,0,0,0
3537203,502e5598-3c3c-3182-2024-4fcf25445d8c,8,3536562,3536562,3537203,3537499,641,641,0,0,0,0
3537460,d61a4a69-30bf-9bd2-223b-da76bcaf0ee3,8,3520053,3520112,3537460,3543601,17348,17407,59,0,0,0
3537524,ee409f44-c959-4659-db59-1d884b0af1e0,8,3520052,3520052,3537524,3529045,17472,17472,0,0,0,0
3537911,6b161276-d8e8-ea7d-6459-1a9b82673f9a,8,3520056,3520112,3537911,3546707,17799,17855,56,0,0,0
3539062,edfc1ab2-c198-6cfb-65cf-9236bdce8c96,8,3520053,3520112,3539062,3537620,18950,19009,59,0,0,0
3540646,9a18e6bb-71f6-f1a8-86f7-3047c0bdbeaf,8,3520109,3520112,3540646,3539083,20534,20537,3,0,0,0
3541523,3dfa45fa-1da6-f0f0-0a53-d7c4f68fa05b,8,3520107,3520112,3541523,3541896,21411,21416,5,0,0,0
3542263,5fb14f5b-81c0-ca3f-f8f7-03ec70bb034d,8,3520109,3520112,3542263,3546717,22151,22154,3,0,0,0
3542264,14fe9960-a539-6212-634a-35ebec2be308,8,3520111,3520112,3542264,3539065,22152,22153,1,0,0,0
3543030,efa107ee-ed75-5494-064b-4edc101905bf,8,3520114,3520172,3543030,3542533,22858,22916,58,0,0,0
3545044,676e34be-78be-c228-c455-da792a4150de,8,3520107,3520112,3545044,3551020,24932,24937,5,0,0,0
3547202,596bf99f-a111-9bb1-3952-0c712e31e772,8,3520113,3520172,3547202,3548185,27030,27089,59,0,0,0
3548998,64bb419d-dbc4-ccdd-5554-5bb97622f59a,8,3520113,3520172,3548998,3556825,28826,28885,59,0,0,0
3550343,496b75fe-cc5b-59b5-2e9b-8fb501c90e2a,8,3520114,3520172,3550343,3562242,30171,30229,58,0,0,0
3560117,4a3c2fe2-9d34-7254-5063-317dda738817,8,3559330,3559330,3560117,3559960,787,787,0,0,0,0
3560516,612e5c86-1a5b-558b-0d43-1870ebcfbcfa,8,3559802,3559802,3560516,3560647,714,714,0,0,0,0
3588278,6b0376f0-2306-56d1-c2d5-2a58d791aedd,8,3535027,3535027,3588278,3594793,53251,53251,0,0,0,0
3602475,e7b4638b-e871-690e-5cf9-cefa9dbb2aeb,8,3601147,3601147,3602475,3602821,1328,1328,0,0,0,0
3609753,e6035c26-0793-13db-2feb-0ef22dde29d8,8,3608957,3608957,3609753,3609669,796,796,0,0,0,0
3610280,f17d8b73-e0a1-ff32-f089-d324bfa223da,8,3609555,3609555,3610280,3610425,725,725,0,0,0,0
3610452,f16231e0-6db0-6ad8-9239-b3a065d52310,8,3609670,3609670,3610452,3610650,782,782,0,0,0,0
3614300,8f48de0a-3375-99d9-3879-7294437fdbd9,8,3609773,3609813,3614300,3616145,4487,4527,40,0,0,0
3614301,debfe7d3-7404-efd3-0377-c4283d51c7fc,8,3609769,3609813,3614301,3612352,4488,4532,44,0,0,0
3615047,b084aab8-cf15-2c06-08e4-5be4d0b3575e,8,3609769,3609813,3615047,3616098,5234,5278,44,0,0,0
3615197,65022273-ac5f-a726-2064-b2a131f5ee86,8,3609773,3609813,3615197,3614443,5384,5424,40,0,0,0
3615452,d928c011-91fd-9b9d-319f-da66a986bfc0,8,3609775,3609813,3615452,3615878,5639,5677,38,0,0,0
3615601,96bc3f42-797e-6c89-1bbc-af4503d7f55b,8,3609770,3609813,3615601,3612669,5788,5831,43,0,0,0
3617286,e2aebd53-b89b-4995-e32e-3ac453fe40e3,8,3609772,3609813,3617286,3620443,7473,7514,41,0,0,0
3617355,dfdabe67-801d-04d5-4999-9d27c9f8f4d6,8,3609773,3609813,3617355,3620306,7542,7582,40,0,0,0
3617946,0144fe67-8df5-b9a0-e577-e1b64dd35982,8,3609770,3609813,3617946,3615421,8133,8176,43,0,0,0
3618396,dd20525e-bbdc-dd1f-343b-f9ce1d63734c,8,3610693,3610752,3618396,3617094,7644,7703,59,0,0,0
3618430,98cc3e26-a1a2-0f5e-d75d-cd7e820740e7,8,3610697,3610752,3618430,3618547,7678,7733,55,0,0,0
3618486,8a4f48b2-d251-63ad-c80b-dbd7657050ee,8,3610693,3610752,3618486,3616903,7734,7793,59,0,0,0
3618599,06dba492-b889-5a75-e80f-58fb2d0f0209,8,3610692,3610692,3618599,3621669,7907,7907,0,0,0,0
3618819,5e452956-81e4-ee99-0c28-6323d27f6d1f,8,3610692,3610692,3618819,3617264,8127,8127,0,0,0,0
3618865,c3575ff1-6caa-4c8d-7c3a-aa22d8f148fb,8,3610697,3610752,3618865,3615841,8113,8168,55,0,0,0
3618856,1ad4e764-85fb-94a6-fb67-24376426e700,1,3614041,3614041,3618856,3620269,4815,4815,0,0,0,0
3618890,db36840c-19b7-2aaa-85cc-2c2d89c93243,8,3610694,3610752,3618890,3614863,8138,8196,58,0,0,0
3620389,6f63def8-51a7-6445-0b9d-7654d5c31b18,8,3610696,3610752,3620389,3619886,9637,9693,56,0,0,0
3620508,b8692e43-3fa7-d954-8bfa-fb8c623c2c71,8,3610692,3610692,3620508,3616740,9816,9816,0,0,0,0
3620634,b81c14e5-7fcc-eb99-5dae-f60b01c08038,8,3610693,3610752,3620634,3615796,9882,9941,59,0,0,0
3620879,55b82364-9ca4-d06c-d076-ddad317e43a4,8,3610693,3610752,3620879,3621835,10127,10186,59,0,0,0
3621013,7e29d9a1-05dd-ffbf-bd21-0b7df5b350ab,8,3610692,3610692,3621013,3617607,10321,10321,0,0,0,0
3623063,afd063d6-35dd-e534-1528-68557858406c,16,3614989,3614989,3623063,3619604,8074,8074,0,0,0,0
3623622,1e50661f-2fce-10ae-db06-fec229071205,8,3614787,3614787,3623622,3624235,8835,8835,0,0,0,0
3623948,753840d9-87ea-19f2-1e85-95360c11c74d,8,3614836,3614847,3623948,3621060,9101,9112,11,0,0,0
3627621,dc399fe1-bfd2-85d7-ecaf-9eeb21b5b893,32,3625923,3625923,3627621,3627277,1698,1698,0,0,0,0
3628667,6b766741-cd26-a22b-9631-15d046f860a9,16,3617637,3617637,3628667,3631780,11030,11030,0,0,0,0
3631625,e1b3b9d1-f887-ac21-369d-2be14bf91d08,8,3630847,3630847,3631625,3631957,778,778,0,0,0,0
3632046,cc464bb8-f773-e927-58d6-9943e0e5e2f9,8,3631326,3631326,3632046,3632370,720,720,0,0,0,0
3633476,78e33d35-f4e0-740f-476e-6a0641d0b488,16,3608449,3608449,3633476,3621124,25027,25027,0,0,0,0
3640222,d9f23b37-8475-f248-0ca3-7885d7607ffe,8,3602023,3602023,3640222,3644842,38199,38199,0,0,0,0
3643538,a5c5677f-d8af-a26c-7d1d-53ca4e027022,8,3628045,3628045,3643538,3645714,15493,15493,0,0,0,0
3644852,3d56400b-22ff-5a30-46b3-fcbffb18291f,1,3639985,3639985,3644852,3644648,4867,4867,0,0,0,0
3645993,2bb2c51f-7023-6aca-5ee6-fdea9534ee94,1,3640114,3640114,3645993,3647260,5879,5879,0,0,0,0
3646644,6d33758b-34d4-ab34-aca6-dd4b69dcce11,1,3639870,3639870,3646644,3643287,6774,6774,0,0,0,0
3661878,c3b44bae-101c-1fa0-4df4-8d1fff3c6eb0,16,3638269,3638269,3661878,3666710,23609,23609,2952,1,0,0
3662208,a4ff58a2-8d8f-194c-2a8c-5fdbdcee656d,8,3653816,3653862,3662208,3658119,8346,8392,2783,2,0,0
3662649,aba78b51-eeef-b65f-91cf-b23504540420,8,3653805,3653862,3662649,3663280,8787,8844,1987,2,0,0
3663656,97be4ad9-25eb-fcee-1b7e-b52972a07a9c,8,3653806,3653862,3663656,3665525,9794,9850,1986,2,0,0
3663666,a874d557-cd0e-1708-acbf-81d4b1720b65,8,3653817,3653862,3663666,3659615,9804,9849,2782,2,0,0
3664126,979c2adc-d3fc-8621-8cfe-8711725c5c5f,8,3653810,3653862,3664126,3661589,10264,10316,1982,2,0,0
3664116,623d45f4-c1ef-6252-1b0c-6cadc9f12b09,8,3653813,3653862,3664116,3660338,10254,10303,1979,2,0,0
3664586,36514258-4ca1-5720-22b8-952ee11b1719,8,3653821,3653862,3664586,3659645,10724,10765,2778,2,0,0
3664687,88ab7afd-6635-7eda-d26c-f96cf40e285f,8,3653815,3653862,3664687,3661289,10825,10872,2784,2,0,0
3664733,15152d78-600b-90ee-ba4d-436d656c0188,8,3653820,3653862,3664733,3664183,10871,10913,2779,2,0,0
3665213,fc424352-6d98-7038-b174-429ccffa9e4d,8,3653803,3653862,3665213,3666283,11351,11410,1989,2,0,0
3665522,227c27df-377f-0ac2-7e19-cad732af7b95,8,3653814,3653862,3665522,3659659,11660,11708,2785,2,0,0
3666083,a5868874-4c31-67b6-96f3-05d7cece12fc,8,3653815,3653862,3666083,3664093,12221,12268,2784,2,0,0
3666483,e05f8184-c115-ae8e-5586-768274dfb5ce,8,3653813,3653862,3666483,3660743,12621,12670,1979,2,0,0
3666710,397ab7cc-2567-14d6-2bdc-c3d78fb51ba1,8,3653825,3653862,3666710,3666124,12848,12885,2774,2,0,0
3666736,830bed4f-c566-a2fa-0422-0efc9d435023,8,3653825,3653862,3666736,3662391,12874,12911,2774,2,0,0
3667064,d7718c05-b671-f1b2-c9a0-a9ef513c5c4d,8,3620893,3620939,3667064,3658558,46125,46171,2998,1,0,0
3667816,107187d9-2833-6002-db04-9d89b451c12b,8,3653833,3653862,3667816,3664031,13954,13983,2815,2,0,0
3667974,d61b4a7d-4c41-c603-290a-de9e226c8bcc,8,3653827,3653862,3667974,3665443,14112,14147,2821,2,0,0
3668091,047d4bc7-2753-0c4a-9136-8ea85bd3494b,8,3653804,3653862,3668091,3668963,14229,14287,1988,2,0,0
3668165,f367043b-dadf-5f67-6c6d-eaa2f1b4159f,8,3653809,3653862,3668165,3671285,14303,14356,1983,2,0,0
3668228,433d65c2-c0f5-de46-714f-4be5530619e4,8,3653804,3653862,3668228,3671307,14366,14424,1988,2,0,0
3668264,216bb956-ec46-6708-3982-9dd41828da8f,8,3653802,3653802,3668264,3667368,14462,14462,1930,2,0,0
3668239,8ab55352-49de-f69d-230f-635993f06c26,8,3653822,3653862,3668239,3661544,14377,14417,2777,2,0,0
3668363,571cdfbf-8dd9-bb83-9877-c24c8842955a,8,3653802,3653802,3668363,3665385,14561,14561,1930,2,0,0
3668486,640933ec-c68b-751f-84a2-092d2777fe38,8,3653830,3653862,3668486,3669462,14624,14656,2818,2,0,0
3668494,9d6d37c7-5e45-32ec-7d3f-b84a53e39b1a,8,3653802,3653802,3668494,3671551,14692,14692,1930,2,0,0
3668495,66a4372a-997e-53d1-b87a-d8968278e194,8,3653823,3653862,3668495,3662617,14633,14672,2776,2,0,0
3668605,f5f30d6e-7632-d4d4-1866-177e63abd48f,8,3653803,3653862,3668605,3670852,14743,14802,1989,2,0,0
3668653,e37355f3-0378-25ba-2603-e8cd52eef7f2,8,3653824,3653862,3668653,3662528,14791,14829,2775,2,0,0
3668784,0961b319-3403-3f08-9a60-7945e6bbba9e,8,3653810,3653862,3668784,3669214,14922,14974,1982,2,0,0
3668791,296da4cd-431b-011f-6f90-d9afca07906e,8,3653829,3653862,3668791,3667979,14929,14962,2819,2,0,0
3668806,01c363cd-7add-3695-48ba-47a9ebf1f6a4,8,3653835,3653862,3668806,3665623,14944,14971,2813,2,0,0
3668806,b8ab8e09-c5da-3dcc-4dd7-0974f84716b7,8,3653836,3653862,3668806,3665119,14944,14970,2812,2,0,0
3668837,cab0d331-b13a-8dc7-92db-a951f7b8895a,8,3653838,3653862,3668837,3666181,14975,14999,2810,2,0,0
3668891,377f35c1-076f-632f-3c28-29392bae3b70,8,3653831,3653862,3668891,3668817,15029,15060,2817,2,0,0
3669033,983c9686-1ae3-8baa-339e-f82bb2e8f8bf,8,3653808,3653862,3669033,3672212,15171,15225,1984,2,0,0
3669123,9bd0e94e-601c-af82-faa5-9b3b8c283b62,8,3653825,3653862,3669123,3670546,15261,15298,2774,2,0,0
3669177,b5100bca-0e7d-25c3-0509-c41e10f809ac,8,3653803,3653862,3669177,3666921,15315,15374,1989,2,0,0
3669168,aee5b68c-6093-418a-e472-3a97a7178558,8,3653806,3653862,3669168,3668708,15306,15362,1986,2,0,0
3669210,b1f6d38e-4297-bb04-66f2-1e777ecbca9c,8,3653842,3653862,3669210,3664797,15348,15368,2806,2,0,0
3669365,2e0cf801-f436-6b12-c391-ef93aa012ab9,8,3653837,3653862,3669365,3662582,15503,15528,2811,2,0,0
3669423,da69aa76-be4c-2dc5-bb57-40e9876796d9,8,3653828,3653862,3669423,3671705,15561,15595,2820,2,0,0
3669414,aed65001-b46d-7853-d126-ed1711958966,8,3653842,3653862,3669414,3661656,15552,15572,2806,2,0,0
3669439,46b3138a-660d-2992-7307-039f19b251ca,8,3653841,3653862,3669439,3667583,15577,15598,2807,2,0,0
3669530,bf79dcb6-abc4-4f76-1718-27dfb4c0c39a,8,3653848,3653862,3669530,3668183,15668,15682,2800,2,0,0
3669620,81540e0f-74a2-e707-38dd-71fd4b295ee5,8,3653841,3653862,3669620,3666326,15758,15779,2807,2,0,0
3669723,b05ab6bf-bca9-eeba-35ff-dd0c2eda17d5,8,3653843,3653862,3669723,3670442,15861,15880,2805,2,0,0
3669778,02a49e9a-2a8c-befe-cdef-bf070553c66b,8,3653823,3653862,3669778,3664657,15916,15955,2776,2,0,0
3669763,84dc5e33-7555-7a6c-d6c1-de5749fa485d,8,3653845,3653862,3669763,3665162,15901,15918,2803,2,0,0
3669854,ac58d464-eb16-7eb0-c434-917090f43724,8,3653834,3653862,3669854,3665242,15992,16020,2814,2,0,0
3669900,2262dad8-6c16-a78b-3562-43476b715b34,8,3653832,3653862,3669900,3666528,16038,16068,2816,2,0,0
3670102,e89afbfe-822e-6328-2792-1c1cf14e8d13,8,3653846,3653862,3670102,3663913,16240,16256,2802,2,0,0
3670217,1b19b829-d0fc-b577-cec7-56748b19f320,8,3653847,3653862,3670217,3671911,16355,16370,2801,2,0,0
3671099,9dc4805f-1fe3-c69c-431e-687425076d01,8,3644592,3644592,3671099,3657005,26507,26507,2952,1,0,0
3673503,08fb27dc-e88f-12a4-2a1b-41edfe530a7e,1,3639444,3639444,3673503,3666218,34059,34059,2952,1,0,0
3673806,72007655-02a2-13b0-22d7-e45d402c04cb,8,3653848,3653862,3673806,3661802,19944,19958,7057,2,0,0
3673967,41bc3273-5b5e-ed09-29e3-74bd5b35300d,1,3639747,3639747,3673967,3684848,34220,34220,2952,1,0,0
3673971,5fa8c28a-ca10-c941-d2b7-828638942fe2,8,3653848,3653862,3673971,3669830,20109,20123,7057,2,0,0
3674417,6bb0c8a0-2ec0-f10a-aca5-abd4354f7ca8,8,3653850,3653862,3674417,3665854,20555,20567,7841,3,0,0
3675493,f8644f2f-ddfc-55c2-772c-74985a15fc95,8,3653852,3653862,3675493,3662863,21631,21641,8280,3,0,0
3676046,e810c030-2edf-2b1a-ee35-5704b82f76ef,8,3653854,3653862,3676046,3664918,22184,22192,9288,2,0,0
3676254,6ecf4ff1-6f97-e80c-0bcb-b729b0646038,8,3653853,3653862,3676254,3665453,22392,22401,9289,2,0,0
3676310,49fafbef-c45d-e840-ec25-30fa98b1d51e,8,3653856,3653862,3676310,3667486,22448,22454,9918,2,0,0
3676425,66849b64-34e2-b1b8-7606-9f22b6f23b07,8,3653854,3653862,3676425,3668775,22563,22571,9438,3,0,0
3676495,15c211ca-e4f9-eeff-3b8e-8a91deb1289a,8,3653854,3653862,3676495,3662474,22633,22641,9539,3,0,0
3676540,c6ee1f6a-02d6-fd31-1c28-bbd8d7d6eda6,8,3653857,3653862,3676540,3663317,22678,22683,10353,2,0,0
3676944,634ee115-5c81-2bad-0bb3-4c1425818b22,8,3653860,3653862,3676944,3668412,23082,23084,9961,2,0,0
3677113,1987e27b-2fb1-ce81-cb5f-b5b51388fee7,8,3653862,3654477,3677113,3665156,22636,23251,11049,2,0,0
3677160,fb26699f-1bf5-027f-cea8-be58e2cae78d,8,3653861,3654477,3677160,3664499,22683,23299,10650,2,0,0
3677163,fe9d21c3-c5e9-8866-bbbb-dbd132d48c82,8,3653863,3654477,3677163,3669407,22686,23300,11275,2,0,0
3677225,c4593083-db40-8797-8ecc-4bd986db41b4,8,3653860,3653862,3677225,3667921,23363,23365,9901,2,0,0
3677214,4a086284-b35a-6b1c-5625-583a6b32264f,8,3653861,3654477,3677214,3661569,22737,23353,10089,2,0,0
3677740,3f381a63-a4ac-2176-8882-7b82da6d33da,8,3653863,3654477,3677740,3667380,23263,23877,11335,2,0,0
3678575,0ebd9eef-0836-b2d1-04db-e9aa7999d29e,8,3653986,3654477,3678575,3671378,24098,24589,12258,2,0,0
3678910,ee6fc3f3-ca5e-6705-d1f8-0fcf03acc634,8,3653866,3654477,3678910,3669002,24433,25044,11626,2,0,0
3679132,98343ead-4239-a13e-b33f-f435207479d2,8,3653994,3654477,3679132,3668463,24655,25138,13100,2,0,0
3679447,bfbff315-0507-a453-098f-d17b4097d297,8,3653990,3654477,3679447,3671978,24970,25457,12726,2,0,0
3679499,c50ef346-f34c-8c78-4892-111c1bee4909,8,3653994,3654477,3679499,3669727,25022,25505,13040,2,0,0
3679508,aaee3f08-ff69-0568-0d79-c20f4931bd94,8,3654002,3654477,3679508,3666052,25031,25506,13330,2,0,0
3679513,f721e45e-d796-efbc-3f79-17c5437feb6b,8,3654007,3654477,3679513,3664363,25036,25506,13604,2,0,0
3679641,13d94ad0-d809-5e6d-741a-d2c25ceef79c,8,3653987,3654477,3679641,3671680,25164,25654,12415,2,0,0
3679654,a54720e0-88be-9288-07ad-45b104a05d77,8,3653987,3654477,3679654,3672736,25177,25667,12532,2,0,0
3679644,4635d22a-7be4-0393-64b5-83300b1378a1,8,3653988,3654477,3679644,3666658,25167,25656,12668,2,0,0
3679701,b90db373-5553-9a05-3960-a10e8ee56246,8,3654006,3654477,3679701,3664205,25224,25695,13605,2,0,0
3679689,d0d0d99d-b7a4-9237-277f-172590ea31de,8,3654008,3654477,3679689,3666460,25212,25681,13663,2,0,0
3679770,d04a8ff9-eee1-4ab3-1f5e-c4d26282a4d5,8,3653991,3654477,3679770,3665725,25293,25779,12800,2,0,0
3679854,3f444245-4a33-2325-64a1-0253cee8efcf,8,3653993,3654477,3679854,3670840,25377,25861,12981,2,0,0
3679878,4420ccd0-8206-be0c-bd5a-19be049af501,8,3653987,3654477,3679878,3672629,25401,25891,12606,2,0,0
3679947,d88a2b67-22c2-ca83-7424-0302e48bb336,8,3653991,3654477,3679947,3667584,25470,25956,12923,2,0,0
3679945,d67e0f37-f4e9-b38e-2fa7-6c80f7746c4b,8,3653993,3654477,3679945,3663636,25468,25952,12981,2,0,0
3679962,e0ebb3c7-b8a3-f3fa-7769-44b886b5ca8f,8,3653996,3654477,3679962,3667992,25485,25966,13216,2,0,0
3679922,d8bfc4d5-80d5-4f85-4d3d-22c1d72d6882,8,3654001,3654477,3679922,3669946,25445,25921,13271,2,0,0
3680194,dd16663a-8183-abc0-80e2-cd0484c48ac0,8,3654002,3654477,3680194,3668859,25717,26192,13270,2,0,0
3680359,50a2c011-160f-79f3-a82d-0a46d0f7d4e7,8,3654004,3654477,3680359,3670182,25882,26355,13457,2,0,0
3680562,a8f75fed-0ae7-00f7-9d0a-afe2adc8a219,8,3654019,3654477,3680562,3671306,26085,26543,14323,2,0,0
3680609,76da3747-8fae-e492-f7d9-f6056bbdcd3d,8,3654004,3654477,3680609,3669615,26132,26605,13547,2,0,0
3680567,83674372-d33e-2b2c-3ceb-cc1d6c019c07,8,3654021,3654477,3680567,3665535,26090,26546,14509,2,0,0
3680626,1c30f3f5-598a-2bd1-5e35-b2472de3153d,8,3654010,3654477,3680626,3663126,26149,26616,13843,2,0,0
3680904,363dda7c-d939-90b6-4835-b19428130df9,8,3654013,3654477,3680904,3661466,26427,26891,13900,2,0,0
3680939,671cae75-6dbe-934e-a2fb-8131b81c5f50,8,3653997,3654477,3680939,3669530,26462,26942,13275,2,0,0
3681079,432a23a8-0f05-d46c-7495-d544b1c8bdb9,8,3654017,3654477,3681079,3668205,26602,27062,14194,2,0,0
3681104,bb02e930-e426-0ae1-c59b-7de8d09d1263,8,3654008,3654477,3681104,3664294,26627,27096,13785,2,0,0
3681152,960a3974-1efd-393b-2896-0c250bb1bad8,8,3654019,3654477,3681152,3664590,26675,27133,14263,2,0,0
3681375,e9622f9d-3242-daba-d2c0-75229cb14954,8,3654021,3654477,3681375,3671699,26898,27354,14624,2,0,0
3681431,d4b6f0f2-3bb9-79b9-3f8c-c66b4423fcd5,8,3653990,3654477,3681431,3670624,26954,27441,12726,2,0,0
3681499,8735b2bb-35bd-51ea-0799-6e3ba360c4cb,8,3654013,3654477,3681499,3673612,27022,27486,13840,2,0,0
3681568,fb50d324-129f-f56d-2c99-562cefe3a150,8,3654017,3654477,3681568,3668637,27091,27551,14194,2,0,0
3681687,098bfdfb-202b-50d1-c71a-5cecdbf0d42a,1,3639634,3639634,3681687,3696296,42053,42053,2952,1,0,0
3681721,76d9d64d-7ae6-7ecf-599f-5901e65cad51,8,3654023,3654477,3681721,3669330,27244,27698,15504,2,0,0
3682184,6d0b4f01-cf09-b990-7b5f-b4278fd1bc4e,8,3654000,3654477,3682184,3667065,27707,28184,13272,2,0,0
3682306,82a0f6e9-4b44-aa71-6545-4a72dd372743,8,3654014,3654477,3682306,3667870,27829,28292,13959,2,0,0
3682719,09b3abbf-8078-5391-9bdd-8ac39c4d8e2c,8,3654015,3654477,3682719,3669369,28242,28704,14033,2,0,0
3683116,929b4c7b-f270-3a23-a957-811d2fd02b45,8,3654016,3654477,3683116,3668898,28639,29100,14135,2,0,0
3684278,e8f66646-059d-42e6-b348-f0fed47ebb90,8,3654025,3654477,3684278,3663638,29801,30253,18430,2,0,0
3685171,0476444d-0658-a5a8-3251-561eb43d9643,8,3654024,3654477,3685171,3662228,30694,31147,18210,2,0,0
3685567,fe95c8c9-c16c-d93f-5c40-5fa3de2752ba,8,3654026,3654477,3685567,3663989,31090,31541,18819,2,0,0
3686357,5526db8e-922f-ebcf-0501-e79ef1204008,1,3684812,3684812,3686357,3686305,1545,1545,0,0,0,0
3686404,c3bf7d44-acc9-874d-63af-f1a4a6ebb88c,1,3684813,3684872,3686404,3686058,1532,1591,59,0,0,0
3686533,f882ee16-2740-55a9-219c-5f3ddc26f6c0,1,3684812,3684812,3686533,3687032,1721,1721,0,0,0,0
3686539,33057245-2a9f-b994-ff74-7a8a10e00199,1,3684813,3684872,3686539,3686689,1667,1726,59,0,0,0
3686900,bc6965e7-bdfb-0e2f-cf7a-9bd510e68719,8,3654026,3654477,3686900,3661511,32423,32874,19895,2,0,0
3687251,7f353843-d25b-b219-9912-28bed483764a,8,3654032,3654477,3687251,3667336,32774,33219,20891,2,0,0
3687313,1719944c-9e5d-531a-2477-536f534fa89b,8,3654029,3654477,3687313,3672142,32836,33284,20653,2,0,0
3687542,ee4401c9-71af-c5ff-5bbd-cdb6f117bec0,1,3684812,3684812,3687542,3686388,2730,2730,0,0,0,0
3687655,b53a2800-7d86-1a55-36d8-3fad1ccda878,8,3654029,3654477,3687655,3667799,33178,33626,20713,2,0,0
3687705,40508324-875c-f067-3432-327f0db04a2c,8,3654027,3654477,3687705,3663559,33228,33678,20447,2,0,0
3688127,ae372e39-af39-6095-1461-1ef142bf18d2,1,3684813,3684872,3688127,3687647,3255,3314,59,0,0,0
3688134,e941cff1-046c-f25d-340b-d8b6a521f3ae,8,3654030,3654477,3688134,3666894,33657,34104,20823,2,0,0
3688562,6c2eb0c5-8f9f-f3d6-db40-265ca5dd8a7f,1,3684812,3684812,3688562,3687528,3750,3750,0,0,0,0
3688612,fcc6febe-7b48-afd1-c185-361480f377c2,1,3684812,3684812,3688612,3690028,3800,3800,0,0,0,0
3688691,294a8a71-bf7c-a627-325b-7c88efadd4b5,8,3654036,3654477,3688691,3670975,34214,34655,21565,2,0,0
3688730,d8c024a9-a99e-0f9b-768e-af5851ddaa9d,8,3654040,3654477,3688730,3662193,34253,34690,21621,2,0,0
3688871,9d30b0f7-f6a9-7c38-13f7-4636c7be5406,8,3654041,3654477,3688871,3664839,34394,34830,22962,2,0,0
3688878,ef58b690-632e-67ff-cf2a-5746b41ea125,8,3654036,3654477,3688878,3663733,34401,34842,21565,2,0,0
3688949,1d5f9ff2-a5d3-39af-dae6-c21b111139c1,8,3654037,3654477,3688949,3672186,34472,34912,21624,2,0,0
3689003,f4aa15ac-3971-83ef-5339-e78dc05db901,8,3654047,3655242,3689003,3666273,33761,34956,23948,2,0,0
3689127,8224153c-320b-5ab7-159d-880c76a5025c,1,3684814,3684872,3689127,3689762,4255,4313,58,0,0,0
3689406,5aa249bf-c827-e447-38d8-e484d4e384a3,8,3654040,3654477,3689406,3666665,34929,35366,22128,2,0,0
3689508,994e4303-b0cb-27f3-c3ab-6793e30065bb,8,3654043,3654477,3689508,3663383,35031,35465,23295,2,0,0
3689589,7a3f4573-f16a-1857-9a68-990e2412e47e,8,3654033,3654477,3689589,3673493,35112,35556,20950,2,0,0
3690256,bac043ca-96b7-cf15-b249-848c58810e2d,8,3654049,3655242,3690256,3663033,35014,36207,24080,2,0,0
3690260,dfb2591d-f9b5-a1db-525e-acaf8b67cdcd,8,3654035,3654477,3690260,3662030,35783,36225,21506,2,0,0
3690394,10f3f41f-f202-0876-0c44-3b8c068634e7,8,3654062,3655242,3690394,3660445,35152,36332,24220,2,0,0
3690407,6a21ab97-d04c-5e8e-1eca-88d3af665d67,8,3654045,3654477,3690407,3665715,35930,36362,23515,2,0,0
3690419,0ac33b9c-37e6-daaf-6917-5c82c4c34aeb,8,3654060,3655242,3690419,3664527,35177,36359,24138,2,0,0
3690466,3dddd241-fa98-6619-6ee8-3e03718fda3f,8,3654079,3655242,3690466,3662561,35224,36387,24971,2,0,0
3690731,9c454443-7eb1-a6f4-761e-b3acf92df31d,8,3654066,3655242,3690731,3661015,35489,36665,24336,2,0,0
3690915,a333639f-3873-64c1-5e4c-e90bbadfbb75,8,3654070,3655242,3690915,3663303,35673,36845,24332,2,0,0
3690976,03c50ab3-02a4-8d6e-5a9e-fefcf07c0e77,8,3654047,3655242,3690976,3663493,35734,36929,24022,2,0,0
3691007,7420431e-2bf0-f535-d2f5-c7bc54c4c8ba,8,3654046,3655242,3691007,3661185,35765,36961,23889,2,0,0
3691055,ce68210c-1bdd-cbea-eec2-1c06f99773b2,8,3654073,3655242,3691055,3672107,35813,36982,24549,2,0,0
3691188,f04e11b5-2320-a56a-4cb7-310c6f6e0a4e,8,3654080,3655242,3691188,3661222,35946,37108,25030,2,0,0
3691227,1407a94b-0e59-4ba4-35ea-7f1e5ec51b50,8,3654058,3655242,3691227,3666549,35985,37169,24071,2,0,0
3691293,6fc41bf6-3d6b-ff76-f790-df8a5c493e43,8,3654045,3655242,3691293,3666763,36051,37248,23830,2,0,0
3691322,00501cd8-8bff-35b3-8f6a-5979ab55db54,8,3654047,3655242,3691322,3668693,36080,37275,23948,2,0,0
3691397,3cd68ac3-5665-dd0b-cac2-9f1dc72c3764,8,3654060,3655242,3691397,3660733,36155,37337,24069,2,0,0
3691485,a1f3a5bc-6580-64de-1bc0-04500ddf8da3,8,3654057,3655242,3691485,3671982,36243,37428,24072,2,0,0
3691440,f2128a48-7a6d-9868-24d1-2e3b34f5b8eb,8,3654081,3655242,3691440,3669595,36198,37359,25311,2,0,0
3691535,781aee5a-ad79-b370-c9e2-fc9e277230de,8,3654034,3654477,3691535,3676219,37058,37501,21338,2,0,0
3691542,3772d3a3-1b72-ea6c-33c9-bfa153e87b79,8,3654072,3655242,3691542,3663602,36300,37470,24330,2,0,0
3691650,472678ac-7eae-f452-8eba-2e783b162773,8,3654064,3655242,3691650,3661300,36408,37586,24278,2,0,0
3691854,318c6ee8-f1c8-6a37-23d3-59b81c84f34f,8,3654083,3655242,3691854,3665773,36612,37771,25424,2,0,0
3691857,bfe46ba0-6706-62f2-dc3d-7f9635c65a81,8,3654077,3655242,3691857,3673190,36615,37780,24913,2,0,0
3691891,92c5d3d7-c25c-dea8-243a-c2d48051d262,8,3654092,3655242,3691891,3671180,36649,37799,25771,2,0,0
3691927,9f88be6e-a0cc-faff-4e7e-9ac831b4709c,8,3654077,3655242,3691927,3666752,36685,37850,24710,2,0,0
3692030,10df8c94-7b41-a3ad-0199-673b5f8635af,8,3654086,3655242,3692030,3662935,36788,37944,25541,2,0,0
3692117,7792a78a-792a-83f4-4b1f-a8629fa0aa69,8,3654080,3655242,3692117,3666395,36875,38037,24970,2,0,0
3692360,71a67925-1094-1b53-26d5-1dc14ff90831,8,3654071,3655242,3692360,3669084,37118,38289,24331,2,0,0
3692420,926730dc-1c0a-8411-9086-af36fa0a5de5,8,3654094,3655242,3692420,3668020,37178,38326,26021,2,0,0
3692493,c3b8a22b-5d76-4bc4-03f5-4e71cadafd4a,8,3654085,3655242,3692493,3663022,37251,38408,25482,2,0,0
3692514,f1bef588-9c08-51d4-8f20-2a19d0a836ae,8,3654081,3655242,3692514,3666684,37272,38433,25251,2,0,0
3693004,0c9f82ad-a7f5-7ee0-5f20-90333608428a,8,3654094,3655242,3693004,3664455,37762,38910,25902,2,0,0
3693084,8d1d37a3-0c88-4f7b-e84b-3c5517759710,8,3654094,3655242,3693084,3661898,37842,38990,25833,2,0,0
3693352,93231668-f185-ea7c-6004-0d0d5257c31b,8,3654094,3655242,3693352,3660995,38110,39258,26081,2,0,0
3693495,b9e28abb-640c-70d9-1764-0a6f2ca43d0d,8,3654089,3655242,3693495,3664720,38253,39406,25714,2,0,0
3706007,cb725702-9192-518f-fbe3-f251f6096928,16,3663236,3663236,3706007,3687931,42771,42771,18191,1,0,0
3708162,779f00d5-571d-7650-2a7a-55500ea20640,16,3664496,3664496,3708162,3699045,43666,43666,18232,2,0,0
3710519,59cb1e01-8a40-b5cd-9597-b5085bed5760,1,3705728,3705728,3710519,3709713,4791,4791,0,0,0,0
3710556,19ffa018-c1c1-ba4f-515e-a371f0b10781,1,3705843,3705843,3710556,3710915,4713,4713,0,0,0,0
3711228,c5ba8420-5b4b-9466-36fe-b3a6a37d299e,1,3705603,3705603,3711228,3712727,5625,5625,0,0,0,0
3711581,7731b193-e283-eb28-af9e-a625f091f0f9,8,3647233,3647233,3711581,3737964,64348,64348,2952,1,0,0
3712080,e97f0af3-ec6c-6fcc-f9ab-b350f52b0682,16,3688773,3688811,3712080,3708421,23269,23307,38,0,0,0
3713242,769eb31c-2683-0a4c-8133-25f1e76032c3,1,3708675,3708675,3713242,3713278,4567,4567,0,0,0,0
3713488,a3b44efe-25c3-cc9d-6856-1badee287a92,1,3708910,3708922,3713488,3713957,4566,4578,12,0,0,0
3713910,3e372c8d-8a13-7d8d-d292-4079dfee84b1,1,3708793,3708795,3713910,3714370,5115,5117,2,0,0,0
3714519,8afb9ff3-a7b1-abcd-033a-c676b6d6e920,16,3689636,3689649,3714519,3725944,24870,24883,13,0,0,0
3715169,a05a53c4-7c42-43c7-1bd8-978e92714fea,16,3689914,3689914,3715169,3707106,25255,25255,0,0,0,0
3715331,ffdb88d7-52b1-731b-a4df-08c567adb841,16,3690283,3690316,3715331,3705448,25015,25048,33,0,0,0
3717059,3a08daae-b70e-1920-0e65-9ebac2ad08d9,1,3705469,3705469,3717059,3715879,11590,11590,0,0,0,0
3720542,5caf5c6a-64ca-98e8-cdde-dccc831bef03,1,3705237,3705237,3720542,3714305,15305,15305,0,0,0,0
3720721,d164d651-9d36-dea0-6619-484819bf0f3b,8,3711163,3711222,3720721,3720933,9499,9558,59,0,0,0
3723679,e1e0d3d7-c541-ea01-a47d-d853887e649d,8,3711162,3711162,3723679,3724449,12517,12517,0,0,0,0
3723679,8d129c6c-8a75-9c6e-d096-f682aab09b08,1,3705353,3705353,3723679,3728024,18326,18326,0,0,0,0
3724792,23d34fb6-58a5-802e-d779-87b7ae6791cd,8,3711162,3711162,3724792,3719600,13630,13630,0,0,0,0
3724899,30b69f93-c438-c125-254d-befee1dd8d91,8,3711163,3711222,3724899,3730651,13677,13736,59,0,0,0
3725498,e4a6da33-bda5-3100-fbaf-f9ca565854d5,8,3711191,3711222,3725498,3725442,14276,14307,31,0,0,0
3734852,4fca946a-6c6a-58e9-c564-956a97f5f3e4,8,3734058,3734067,3734852,3734595,785,794,9,0,0,0
3735263,8623a5ca-efc3-5842-65b4-11ed05d1f737,8,3734549,3734549,3735263,3735018,714,714,0,0,0,0
3738790,06c0965d-d68b-717e-57cb-97197a3367d0,1,3719974,3719974,3738790,3737495,18816,18816,0,0,0,0
3738990,8b418bdf-e52b-9187-3c3b-5ed72dd5b752,1,3708229,3708229,3738990,3724497,30761,30761,0,0,0,0
3739301,07a1012a-e8f8-6e43-0b99-69081d575d69,1,3708372,3708372,3739301,3734053,30929,30929,0,0,0,0
3739390,87647505-ee88-19c9-0571-cc8df7102c89,1,3708483,3708483,3739390,3724470,30907,30907,0,0,0,0
3741420,9adc8fe3-cad6-7b77-0287-413950e7ceb8,8,3740640,3740640,3741420,3741709,780,780,0,0,0,0
3742193,417e5edc-13e6-9df3-2fc0-fe9c854a05f9,8,3741428,3741465,3742193,3742407,728,765,37,0,0,0
3746692,a09d63de-44a3-521a-71ee-ea5105c0e8c6,2,3723924,3723924,3746692,3735792,22768,22768,0,0,0,0
3746698,e4af65aa-08f3-43a9-1398-592b698681df,1,3726742,3726742,3746698,3739964,19956,19956,0,0,0,0
3753264,273fd952-fe77-d9f9-8533-4baf222b8537,8,3404911,3404911,3753264,3906342,348353,348353,2952,1,0,0
3754027,fab8cd39-d6b3-e81a-ed37-0c84a011d446,8,3752564,3752564,3754027,3754204,1463,1463,0,0,0,0
3779211,b67819ff-9bca-0ac2-1786-e4b747c3c3cc,8,3778021,3778021,3779211,3779522,1190,1190,0,0,0,0
3805539,545b25b3-7e20-3afb-e858-f4f172f44add,16,3761466,3761466,3805539,3796892,44073,44073,0,0,0,0
3809234,d516f81c-43d8-015f-0394-c4d84a240d4b,16,3763494,3763494,3809234,3826335,45740,45740,0,0,0,0
3809696,78fd3b16-8262-8a03-be45-43f40a8fc854,8,3808947,3808947,3809696,3809999,749,749,0,0,0,0
3810390,fdff67de-6a63-bd5b-9398-ba020141f1ae,16,3763524,3763554,3810390,3823170,46836,46866,30,0,0,0
3822957,3d948afd-864d-3a8d-1067-308a95cc34cd,8,3804060,3804060,3822957,3818377,18897,18897,0,0,0,0
3823835,7393c675-a3cc-77c1-c4b6-ae47ea0970c6,8,3804062,3804120,3823835,3828736,19715,19773,58,0,0,0
3824765,264e448e-1a87-77b0-855f-c748c6d273f9,8,3804063,3804120,3824765,3825932,20645,20702,57,0,0,0
3826482,62e38426-06fb-22ac-c342-adc9df09451f,8,3804062,3804120,3826482,3819416,22362,22420,58,0,0,0
3829539,0570ea72-a167-00f7-5de8-f62bd45f8e7f,8,3804062,3804120,3829539,3829859,25419,25477,58,0,0,0
3829753,ff8abfc0-2d58-293a-aebe-15241549d4d7,8,3804064,3804120,3829753,3817201,25633,25689,56,0,0,0
3830142,dce202f5-36ef-f201-5656-b5f91c6a16e0,16,3782246,3782246,3830142,3823582,47896,47896,0,0,0,0
3831953,3ad96cc4-c0ac-ea64-a426-d1c1feb24920,8,3805689,3805689,3831953,3826989,26264,26264,0,0,0,0
3831976,5f5310d7-6d7f-80cd-343c-4990c007e123,8,3805690,3805749,3831976,3826655,26227,26286,59,0,0,0
3835311,f929eda0-bf30-070d-42a5-af9b522326bb,8,3805690,3805749,3835311,3832638,29562,29621,59,0,0,0
3845811,1ac0dff3-6717-1ab7-61f0-e5c51cda8918,8,3805689,3805689,3845811,3858499,40122,40122,0,0,0,0
3845911,7f0544ca-40f6-754a-989d-f5ed6df2b925,8,3805690,3805749,3845911,3843955,40162,40221,59,0,0,0
3846365,8c28d4a4-d301-e76f-e8a9-4b68e9fc5fb3,16,3789551,3789551,3846365,3828519,56814,56814,0,0,0,0
3846495,8b0ed975-e20e-f794-9de5-d2eb28596e80,8,3805690,3805749,3846495,3828354,40746,40805,59,0,0,0
3863713,eeb450c8-50bf-c860-230d-a62a7a49ae9c,1,3855489,3855522,3863713,3860272,8191,8224,33,0,0,0
3863853,21737acd-3e37-07dc-84d9-92ecea3c2de7,1,3855496,3855522,3863853,3865774,8331,8357,26,0,0,0
3865442,16107d90-28c2-7491-ac83-995b53f0a378,1,3862445,3862445,3865442,3866622,2997,2997,0,0,0,0
3865455,f8eb7113-6aee-a07a-c387-d8eb7509d8ba,1,3855463,3855522,3865455,3869061,9933,9992,59,0,0,0
3865487,64dd4384-b34f-21ca-3bde-c3f462171534,1,3855480,3855522,3865487,3866115,9965,10007,42,0,0,0
3866367,d8058bb7-bdec-9144-0629-7a2a66599dde,1,3855494,3855522,3866367,3869498,10845,10873,28,0,0,0
3866582,4797fe1e-eab4-bce8-40f9-60502efc7709,1,3855469,3855522,3866582,3861618,11060,11113,53,0,0,0
3867334,fa33dec0-6d99-35f0-1623-6b475e4815f7,1,3855484,3855522,3867334,3871126,11812,11850,38,0,0,0
3867374,d0af7986-2937-27e9-1752-db082e86d47e,1,3855465,3855522,3867374,3862343,11852,11909,57,0,0,0
3867471,427288fd-5513-a16e-2c39-e3ba90080708,1,3855481,3855522,3867471,3865735,11949,11990,41,0,0,0
3869037,404eb634-f4e0-270e-d0b6-8d0280dc3ba1,1,3855487,3855522,3869037,3869822,13515,13550,35,0,0,0
3869067,244a603e-156e-57f8-8af0-cf0c596b0c6f,1,3855465,3855522,3869067,3869981,13545,13602,57,0,0,0
3869979,67b80731-fe39-fe8d-05f0-604a896e5e77,1,3855468,3855522,3869979,3865309,14457,14511,54,0,0,0
3871334,e1316354-e574-cdde-ad19-378ef64ff128,1,3856354,3856354,3871334,3864150,14980,14980,0,0,0,0
3871614,07789dae-e478-7edc-899a-c6ce5704c899,1,3855485,3855522,3871614,3875293,16092,16129,37,0,0,0
3871709,48b1e8cc-679a-9d56-36e6-222e3be9cfb0,1,3855470,3855522,3871709,3877154,16187,16239,52,0,0,0
3871805,ab6b897b-0ccc-941d-9d3b-9ac6be24af96,1,3855479,3855522,3871805,3871594,16283,16326,43,0,0,0
3874869,e3931b79-2fc8-e230-f53f-38c0f95f299a,1,3855468,3855522,3874869,3883047,19347,19401,54,0,0,0
3875054,965a18c5-67bc-d5a7-2bef-0136432d9930,1,3856363,3856414,3875054,3867366,18640,18691,51,0,0,0
3875069,b069acba-8d9b-4935-5af3-80a4ef70f8b6,1,3855479,3855522,3875069,3869800,19547,19590,43,0,0,0
3875635,2899e850-dd32-b854-f3f2-33b742d4f31c,1,3856359,3856414,3875635,3868959,19221,19276,55,0,0,0
3876280,ddc16c3a-4f9d-2780-e1cf-33a4f6214132,1,3855483,3855522,3876280,3866452,20758,20797,39,0,0,0
3878744,82fecfdc-73fb-b982-4401-4a72068f19b5,1,3856354,3856354,3878744,3877418,22390,22390,0,0,0,0
3879100,2bb47785-5385-9e02-6fe4-0ae899ccdde6,1,3856371,3856414,3879100,3882582,22686,22729,43,0,0,0
3879303,f1cf851b-ad02-94a0-080c-28ad0c11f642,1,3856390,3856414,3879303,3888512,22889,22913,24,0,0,0
3880112,f2203acf-8eed-8d34-f384-3346945f4281,1,3855491,3855522,3880112,3881004,24590,24621,31,0,0,0
3880906,a227ac14-343f-5341-8593-d3a208a66a64,1,3856418,3856474,3880906,3868922,24432,24488,56,0,0,0
3881147,dfe38af0-e85d-4aae-5024-7f99648ff83f,1,3856355,3856414,3881147,3879668,24733,24792,59,0,0,0
3881276,a528698b-d756-b927-e0f0-200824a994d7,1,3856357,3856414,3881276,3874327,24862,24919,57,0,0,0
3881703,e771c17c-fbcd-cfde-3354-38032cfffc6b,1,3855472,3855522,3881703,3882429,26181,26231,50,0,0,0
3881761,7146a1c1-cd04-4f6c-6391-26040519ae36,1,3856389,3856414,3881761,3890564,25347,25372,25,0,0,0
3882992,44ed3d94-4ea8-599e-7440-6c5f72bfa693,1,3855462,3855462,3882992,3888010,27530,27530,0,0,0,0
3883513,5c699e1f-458c-f41d-01b8-d47e7a5f1d32,1,3856357,3856414,3883513,3870063,27099,27156,57,0,0,0
3883588,9f9dda0d-425b-8476-a9ca-723755d145d2,1,3856358,3856414,3883588,3876560,27174,27230,56,0,0,0
3883726,8bb61e76-efbf-4c75-e6e5-4d66ee4ebb16,1,3856374,3856414,3883726,3872772,27312,27352,40,0,0,0
3884107,04fb7e52-5834-75e1-231f-167698a7e77b,1,3856387,3856414,3884107,3875443,27693,27720,27,0,0,0
3885363,29c649ec-2b48-a034-88e5-e76e68eac538,1,3856391,3856414,3885363,3876050,28949,28972,23,0,0,0
3885974,937838f9-bd46-bb37-885f-3b06aefb886b,1,3856354,3856354,3885974,3882610,29620,29620,0,0,0,0
3886454,640324f0-99b3-51a6-6f2a-e2fd838edbe4,1,3856387,3856414,3886454,3882900,30040,30067,27,0,0,0
3886652,323415b1-64e1-9340-97f5-d62875ef8169,1,3856367,3856414,3886652,3898280,30238,30285,47,0,0,0
3889345,21e219ce-5158-7417-ab6d-0f79fac368c1,1,3856392,3856414,3889345,3886416,32931,32953,22,0,0,0
3889580,e32a2082-3d4a-c183-ce14-586856bdebf5,1,3856369,3856414,3889580,3890142,33166,33211,45,0,0,0
3889584,d4073daa-68db-3370-4cb3-7187eb469b21,1,3855486,3855522,3889584,3889017,34062,34098,36,0,0,0
3889600,92a6584c-85b2-6fa7-1fde-c4f3c92215cd,1,3856364,3856414,3889600,3900028,33186,33236,50,0,0,0
3889884,b800f540-7f69-53af-e921-3dfa86e979fe,1,3855482,3855522,3889884,3906394,34362,34402,40,0,0,0
3889938,b798e034-04cd-a7c6-0a12-1024a5a2d5ac,1,3855476,3855522,3889938,3902064,34416,34462,46,0,0,0
3893743,7bd0a126-d086-d4d6-36e8-d3bd342f4b08,1,3855464,3855522,3893743,3910890,38221,38279,58,0,0,0
3893876,124abc16-de4c-4944-0678-4f498bdeb84a,1,3855475,3855522,3893876,3901147,38354,38401,47,0,0,0
3893896,feb2ac4b-85e8-10a2-28ed-a191dfb48b5f,1,3855471,3855522,3893896,3886098,38374,38425,51,0,0,0
3895225,10e7ee6f-1c15-b55f-bf6e-074d865fe33c,16,3838609,3838609,3895225,3900597,56616,56616,0,0,0,0
3896376,e88668a4-e0f9-9296-ca89-b4606d8ec757,1,3856363,3856414,3896376,3876590,39962,40013,51,0,0,0
3896684,e5b23a6d-00c9-578e-d3f8-b32d48e23143,1,3856388,3856414,3896684,3910497,40270,40296,26,0,0,0
3896818,d78c2051-7efa-70ae-fdea-42aa14003cbc,1,3856388,3856414,3896818,3907574,40404,40430,26,0,0,0
3903353,85a0429c-a18d-218d-f6a0-e01fd969c458,1,3855490,3855522,3903353,3903167,47831,47863,1231,1,0,0
3903666,ee926321-245f-ed94-2ac1-4fd1eb74e721,1,3855469,3855522,3903666,3905166,48144,48197,1252,1,0,0
3903757,2d3b840d-a0db-01ff-11c7-0935f03256d8,1,3855475,3855522,3903757,3891879,48235,48282,1246,1,0,0
3906969,8e47fb7d-8a7f-e26e-f585-f440c3a98532,1,3856366,3856414,3906969,3906582,50555,50603,1247,1,0,0
3907279,fd236d28-4f2e-8a08-63b3-dfd00ef90bcc,1,3856371,3856414,3907279,3917664,50865,50908,1242,1,0,0
3908193,7a44167a-63f7-8edf-7294-8c6466d2c0a7,1,3856361,3856414,3908193,3898994,51779,51832,1252,1,0,0
3908569,ada3b63d-ad08-58c6-bad1-6e1dbefb1a15,1,3856381,3856414,3908569,3907700,52155,52188,1232,1,0,0
3908909,d6e11e55-e6a4-443c-f06c-fdb6c046f297,1,3856364,3856414,3908909,3896555,52495,52545,1249,1,0,0
3911829,c0ff979e-bd29-e827-e0f2-d1dc6b55ae42,1,3855463,3855522,3911829,3892939,56307,56366,1258,1,0,0
3911837,c351c359-6739-6010-b9dc-86a923c560d2,1,3855466,3855522,3911837,3894757,56315,56371,1255,1,0,0
3912016,b5e5f62a-9a39-bc36-93c8-40115c2281fe,1,3855494,3855522,3912016,3911883,56494,56522,1227,1,0,0
3912274,8a25cd95-539e-9c1f-8cb8-cf5d5be87a2a,8,3900637,3900679,3912274,3914897,11595,11637,42,0,0,0
3912784,03908f5a-7312-e621-7992-ce54c2cfa589,8,3900625,3900679,3912784,3908031,12105,12159,54,0,0,0
3913154,b5e18851-619f-6688-f6a8-6371bf693365,1,3856383,3856414,3913154,3912036,56740,56771,1230,1,0,0
3913311,a71f4b37-4e35-7338-4124-98f96de27e22,1,3856378,3856414,3913311,3906064,56897,56933,1235,1,0,0
3913504,652b1328-422f-203e-fc29-c667233089c9,8,3900650,3900679,3913504,3909668,12825,12854,1187,1,0,0
3913729,c337ed45-4e93-f53a-632a-992b5ddf6f80,8,3900637,3900679,3913729,3919604,13050,13092,42,0,0,0
3913754,581d0820-e900-52ed-52d7-ed321de883ef,8,3900621,3900679,3913754,3909217,13075,13133,58,0,0,0
3913776,2ccd00e7-92ca-30b9-91d9-ee264997dd20,8,3900631,3900679,3913776,3917740,13097,13145,48,0,0,0
3913766,b4d713fb-d5b7-bc6e-dc13-1f79114e16d5,8,3900633,3900679,3913766,3907386,13087,13133,46,0,0,0
3913844,5fd24b9a-a527-9af5-3bd6-df9b36430f4d,8,3900641,3900679,3913844,3913133,13165,13203,38,0,0,0
3913857,310e8aed-07dc-4a0c-2b72-d6947d41cba8,8,3900623,3900679,3913857,3913460,13178,13234,56,0,0,0
3913892,b4cb8396-2b08-0b7e-bec0-94b8b02d25b4,8,3900626,3900679,3913892,3911144,13213,13266,53,0,0,0
3913902,73cd3e91-2f5b-46f7-449c-230d3bb11ffe,8,3900628,3900679,3913902,3917755,13223,13274,51,0,0,0
3913878,9170d854-c734-817f-c4a3-60a6925d5ff4,8,3900628,3900679,3913878,3919622,13199,13250,51,0,0,0
3913855,439cf4f8-e93b-f044-d292-5f7cb624013a,8,3900630,3900679,3913855,3908004,13176,13225,49,0,0,0
3913917,7ec4eb39-b0e4-50ce-a2d4-faa0a466c489,8,3900619,3900619,3913917,3918552,13298,13298,0,0,0,0
3913949,eabb42d6-a81c-e995-9e00-801dcb8052e1,8,3900628,3900679,3913949,3909317,13270,13321,51,0,0,0
3914007,1ab84c1b-8524-3095-5bcb-31f340ae802f,8,3900621,3900679,3914007,3908915,13328,13386,58,0,0,0
3914013,38ac7355-f495-dd71-1802-f730e8ec6834,8,3900622,3900679,3914013,3919585,13334,13391,57,0,0,0
3914023,7c923cab-2488-a330-4399-5af3021e2689,8,3900624,3900679,3914023,3915038,13344,13399,55,0,0,0
3914087,45876487-9555-d6a4-045b-44d9bafd2834,8,3900621,3900679,3914087,3909180,13408,13466,58,0,0,0
3914087,2755d942-89cf-c27c-5f5b-787eb6131739,8,3900648,3900679,3914087,3916273,13408,13439,389,1,0,0
3914138,83a64431-d83e-6704-3c29-9c682138fe3c,8,3900621,3900679,3914138,3918682,13459,13517,58,0,0,0
3914117,4ff02a31-c903-5d4c-92f1-d3d08111f0f3,8,3900633,3900679,3914117,3913271,13438,13484,46,0,0,0
3914205,621285e3-407a-d92f-660d-63f3eaf590ed,8,3900642,3900679,3914205,3910545,13526,13563,395,1,0,0
3914195,020978dc-b811-6c26-7748-9b6b97f3d71d,8,3900646,3900679,3914195,3910652,13516,13549,391,1,0,0
3914187,3ea34052-2af3-2711-f518-75ec01adf395,8,3900648,3900679,3914187,3912419,13508,13539,389,1,0,0
3914216,dca261ea-d432-c16a-b396-9a862a8daa45,8,3900641,3900679,3914216,3913017,13537,13575,38,0,0,0
3914256,6755b2d4-2bfe-d52a-9350-46f4f7f80118,8,3900642,3900679,3914256,3911453,13577,13614,395,1,0,0
3914271,d048c8af-ff5f-274a-ca53-76abc027c505,8,3900636,3900679,3914271,3918180,13592,13635,43,0,0,0
3914306,2280229d-9d1b-40f5-1fc6-1eb31c534b87,8,3900645,3900679,3914306,3916861,13627,13661,392,1,0,0
3914352,01f239e4-3965-9c7a-42ff-3b13d32a27d1,8,3900630,3900679,3914352,3908537,13673,13722,49,0,0,0
3914344,217c82b1-c884-fac6-619a-4805e03a0ab6,8,3900647,3900679,3914344,3907368,13665,13697,390,1,0,0
3914434,4059d846-ff17-bb76-b7be-51dffd5eb636,8,3900642,3900679,3914434,3917837,13755,13792,395,1,0,0
3914906,7397b987-5edd-3492-aac2-33021a3bc8d8,8,3900655,3900679,3914906,3909786,14227,14251,1182,1,0,0
3914942,16440645-f17a-0355-05b3-f11620629446,8,3900656,3900679,3914942,3913235,14263,14286,1181,1,0,0
3914911,cdf392f9-aa6c-fab9-dffb-ad3730a0d16d,8,3900657,3900679,3914911,3917734,14232,14254,1180,1,0,0
3914990,93ad6724-2abc-64d6-b21e-810becac3756,8,3900653,3900679,3914990,3919280,14311,14337,1184,1,0,0
3915019,381487da-2c42-b7f3-9a03-718276f3304d,8,3900658,3900679,3915019,3907912,14340,14361,1179,1,0,0
3915077,a0d72005-411e-8bac-d192-4b21b54c54f9,8,3900654,3900679,3915077,3919174,14398,14423,1183,1,0,0
3915164,6d3026db-20f8-260c-bf10-545a1dd3c5d2,8,3900660,3900679,3915164,3909608,14485,14504,1494,1,0,0
3915225,6c456d93-1b4a-a8ae-7de7-e713f7fd8283,8,3900654,3900679,3915225,3916695,14546,14571,1183,1,0,0
3915381,2e8139fe-e75d-b776-b3b5-ab5c9fb8d4b8,8,3901418,3901477,3915381,3905149,13904,13963,11112,1,0,0
3915561,8852c78e-0633-a286-5852-62b176935d1f,8,3900647,3900679,3915561,3913492,14882,14914,390,1,0,0
3915607,c88736e9-6d82-bf0b-e6a1-9ff8ab9a9585,8,3900634,3900679,3915607,3918452,14928,14973,45,0,0,0
3916583,89d8953b-812c-fa6f-be98-703f50261309,8,3900637,3900679,3916583,3911546,15904,15946,42,0,0,0
3916616,f5d92b55-74dc-bf13-8960-a41b25a744a7,8,3900619,3900619,3916616,3921245,15997,15997,0,0,0,0
3916671,9909131b-ad1e-e6f0-5459-7b42c28a9be4,8,3900650,3900679,3916671,3915094,15992,16021,1187,1,0,0
3916666,d7b798ec-fd2e-93ed-8b17-74d44cda028a,8,3901424,3901477,3916666,3904621,15189,15242,11226,1,0,0
3919087,1eac66fe-fc30-c77c-8f58-ed08f5b917b1,1,3855487,3855522,3919087,3917515,63565,63600,1234,1,0,0
3919528,a28322e8-d171-504f-df48-00048910d70e,8,3901423,3901477,3919528,3907523,18051,18105,11167,1,0,0
3919591,07e79181-3039-6a9f-4f0b-5593542d4393,1,3855476,3855522,3919591,3903939,64069,64115,1245,1,0,0
3919646,0bce8eeb-684f-1e52-22f1-5aad8752d9fb,16,3861356,3861356,3919646,3890169,58290,58290,1199,1,0,0
3919609,a5588005-6527-6d38-73db-22db6b76c990,1,3855474,3855522,3919609,3929129,64087,64135,1247,1,0,0
3920000,5339eb18-2aa3-ed5e-e58e-8fb63c884bee,16,3861421,3861421,3920000,3898071,58579,58579,1199,1,0,0
3920201,4af83592-2e85-8bc6-65ed-b1d9a4242b77,8,3901426,3901477,3920201,3906845,18724,18775,11224,1,0,0
3922269,1a037833-d4fd-fad6-4008-40cbae9abf14,1,3856389,3856414,3922269,3903988,65855,65880,1224,1,0,0
3922512,a44c26d4-03fc-5e6c-1b6e-63538d6ebe62,8,3901417,3901417,3922512,3915634,21095,21095,11053,1,0,0
3922631,b91340e3-9afe-08a7-20d8-82e46b8d8642,8,3901426,3901477,3922631,3906601,21154,21205,11224,1,0,0
3923340,2815eb62-670f-7921-9b61-e82e334b2922,1,3856358,3856414,3923340,3908805,66926,66982,1255,1,0,0
3924017,e37b9630-9798-b4e0-1a11-0a4f673e79fe,8,3900661,3900679,3924017,3917791,23338,23356,10414,1,0,0
3924019,6624f8ed-ed96-5f31-8bef-2ae1f87339cc,8,3900665,3900679,3924019,3910921,23340,23354,11640,1,0,0
3924166,24843f73-1e2e-fb93-0e72-f8dff38d906a,8,3900660,3900679,3924166,3908750,23487,23506,9970,1,0,0
3924331,e7a9f866-38f9-faed-25c8-5224d202d65b,1,3856383,3856414,3924331,3955507,67917,67948,1230,1,0,0
3924934,3c02c906-aa34-d26d-f424-6a54afdcd2a7,8,3901422,3901477,3924934,3913985,23457,23512,11168,1,0,0
3925148,5ad2c420-f09d-ba8a-fcd9-915dc2b408fc,8,3901427,3901477,3925148,3910119,23671,23721,11283,1,0,0
3925545,4f39a47f-b328-8760-a102-7a457e4e7273,8,3900669,3900679,3925545,3919066,24866,24876,11981,1,0,0
3925746,34634757-3d23-1e3b-4a97-a245da5bf081,8,3900666,3900679,3925746,3911756,25067,25080,11864,1,0,0
3925772,7533c4df-b964-fbed-9d75-5e6cab84978c,8,3900670,3900679,3925772,3913365,25093,25102,12040,1,0,0
3925859,00fc21fd-8ffb-cc0f-0587-29f37c03af35,8,3900675,3900679,3925859,3914881,25180,25184,12078,2,0,0
3925908,d2e9c930-eeec-175d-8772-36d0c39b7cb2,8,3900668,3900679,3925908,3911787,25229,25240,11922,1,0,0
3925903,6a5b54e4-f0e2-aa55-284c-3ab4e5b2df55,8,3900676,3900679,3925903,3914053,25224,25227,12137,2,0,0
3925977,cbfd0aa6-fc69-6d17-9f44-2e7b57869db0,8,3900673,3900679,3925977,3916630,25298,25304,12080,2,0,0
3926015,f62e329e-32c2-1a25-9317-bf7bd45b1527,8,3900672,3900679,3926015,3910706,25336,25343,12081,2,0,0
3925988,54be6170-4ec6-6d97-38a8-9514ca0e0bc2,8,3900677,3900679,3925988,3918905,25309,25311,12136,2,0,0
3926066,1d3208db-a28f-57d0-5612-ad538172d09d,8,3900674,3900679,3926066,3911970,25387,25392,12079,2,0,0
3926121,5a332b7d-1c54-cdb8-b1dd-fdbb80cf9dc7,8,3900677,3900679,3926121,3910792,25442,25444,12196,2,0,0
3926195,6d566dcc-bb99-1df7-19ce-afeef4914ab0,8,3900685,3900739,3926195,3918002,25456,25510,12308,2,0,0
3926312,90c031a8-a28e-aff6-e1fa-b7e41c230f19,8,3900678,3900679,3926312,3910280,25633,25634,12195,2,0,0
3927247,a9fc73da-5926-c059-bfd0-b387963dbc5e,8,3900664,3900679,3927247,3912277,26568,26583,10921,1,0,0
3927753,e3a14f5d-6ed5-855d-2d1c-a2b3e5715f31,8,3900668,3900679,3927753,3921409,27074,27085,11922,1,0,0
3927928,561657a8-163d-cf6f-269b-ded71c474b1c,8,3901429,3901477,3927928,3909747,26451,26499,11281,1,0,0
3927934,b79fa51d-3045-c38c-c52c-7f939acaf159,8,3900666,3900679,3927934,3919990,27255,27268,11924,1,0,0
3928641,19df5a16-cc2f-95ed-88f6-8352d38bca4e,1,3856359,3856414,3928641,3937626,72227,72282,1254,1,0,0
3928868,d1c76cf1-35d3-fe5b-881f-ea11d36b06cd,8,3920716,3920769,3928868,3926366,8099,8152,53,0,0,0
3929463,9295e162-6383-3b28-d2ec-137980406ea6,1,3856389,3856414,3929463,3906161,73049,73074,1224,1,0,0
3929657,8fb8a4a3-3b64-5e6d-4584-9668ffd4b196,8,3920302,3920302,3929657,3927726,9355,9355,0,0,0,0
3937542,41a50d68-4140-4d41-cea7-252160b1aac5,1,3856384,3856414,3937542,3935823,81128,81158,1229,1,0,0
3938236,b31e120d-9f49-ab89-6866-d52e0e05926a,1,3856391,3856414,3938236,3963095,81822,81845,1222,1,0,0
3942702,4d2a5ec7-029d-b4a0-0609-ac3b386b8594,1,3856394,3856414,3942702,3932537,86288,86308,1219,1,0,0
3944569,2c01b5a6-c9dd-80a8-678f-5465228dc422,1,3856371,3856414,3944569,3970475,88155,88198,1242,1,0,0
3946766,6f1e2050-3f71-edab-1ad1-36d67472bd84,1,3856367,3856414,3946766,3949123,90352,90399,1246,1,0,0
3952176,c37180d4-91e6-10dd-d72a-bf118f415cf0,1,3856392,3856414,3952176,3913693,95762,95784,1221,1,0,0
3955808,4927db4a-4a12-d0d4-cda4-2f8510995969,8,3763178,3763178,3955808,4047653,192630,192630,1199,1,0,0
3960597,5ef28433-109c-21df-9f76-cb6f4eea155b,1,3856418,3856474,3960597,4004197,104123,104179,1255,1,0,0
3964933,00b30bda-6f26-bd7c-7634-fa4840480f7b,1,3856417,3856474,3964933,3986878,108459,108516,1256,1,0,0
3969603,478cd79d-0856-cc4b-9ea4-6e7d3cfa73f8,8,3516808,3516808,3969603,4011835,452795,452795,4091,2,0,0
3972446,a19f304a-af71-a929-fda5-e1d1aa3db493,1,3856390,3856414,3972446,4025668,116032,116056,1223,1,0,0
3972764,e604d38c-0a9b-1471-31a7-9435b7c52ba7,1,3968626,3968626,3972764,3973351,4138,4138,0,0,0,0
3973239,db1a8e44-f477-4614-9463-9e5705ecad50,1,3968514,3968514,3973239,3975554,4725,4725,0,0,0,0
3973738,4a2e25a0-f6ee-dbdc-9670-0f55a03ef56a,1,3968846,3968846,3973738,3972127,4892,4892,0,0,0,0
3975663,a8f4c2dc-2bc1-2824-9dae-8912cf70ea88,1,3856368,3856414,3975663,3970550,119249,119295,1245,1,0,0
3984997,9ae5fbbc-0f65-7cc9-8fbd-853a790f2b45,8,3984213,3984213,3984997,3985129,784,784,0,0,0,0
3985388,a3b0e3da-845e-aab9-cc00-7490888d7c51,8,3984657,3984680,3985388,3985316,708,731,23,0,0,0
3987131,599a20f1-81dc-d57c-164c-af2f6d442c3f,1,3982864,3982864,3987131,3987958,4267,4267,0,0,0,0
3987848,f11b9c1b-bad1-ffe7-ed46-d087c77afed5,1,3983009,3983009,3987848,3986541,4839,4839,0,0,0,0
3988295,5b1bab8d-98b0-4e7a-c74f-555dde9389de,1,3982753,3982753,3988295,3989485,5542,5542,0,0,0,0
3990995,232e84ea-dfe3-28d5-50be-629444c1a38c,8,3990204,3990204,3990995,3991013,791,791,0,0,0,0
3991464,76b1cd87-3bbe-d1b4-cde5-7aa6c5ca18e9,8,3990747,3990747,3991464,3991216,717,717,0,0,0,0
3991884,bbfe7e0e-3a22-1851-2928-a048763c714b,1,3856399,3856414,3991884,4039577,135470,135485,1214,1,0,0
3992974,2a17879a-67a7-9886-5716-6f351a64eed2,1,3856394,3856414,3992974,4010165,136560,136580,1219,1,0,0
3994394,fe3d81d8-0eb9-daed-a39a-d4dfafd3ec8b,1,3968123,3968123,3994394,3983059,26271,26271,0,0,0,0
3994581,082bbc6f-b8bf-6903-9e15-00621ef70629,1,3968384,3968384,3994581,3992421,26197,26197,0,0,0,0
3999254,fb6e5531-3779-0ead-f6d4-017df8490b53,8,3998474,3998474,3999254,3999448,780,780,0,0,0,0
3999266,0d41de26-91c9-9644-72e6-3a676e971b5a,1,3968271,3968271,3999266,4010190,30995,30995,0,0,0,0
4000168,8a9da702-660f-44e6-445d-3231c6f7cc83,8,3999031,3999031,4000168,4000004,1137,1137,0,0,0,0
4002042,b31985d0-a84a-3aee-d636-a89dad0fc0f7,8,3981981,3981981,4002042,4006394,20061,20061,0,0,0,0
4005991,aad29f81-7fe9-9b4f-ca7a-d5f3bdacb371,8,4005278,4005278,4005991,4006170,713,713,0,0,0,0
4006236,8b81ea62-2fb0-aeaa-05ef-ea2af825a8bd,8,4005456,4005456,4006236,4005868,780,780,0,0,0,0
4008304,d4ec675d-53a3-939e-6899-98d64e444af9,1,3982503,3982503,4008304,4017722,25801,25801,0,0,0,0
4014598,d5e652b7-1a83-4240-f0a3-a4122cfc142d,1,3982388,3982388,4014598,4013468,32210,32210,0,0,0,0
4014622,ec32006d-da7b-9adb-1ce3-31182e857464,1,3982638,3982638,4014622,4009288,31984,31984,0,0,0,0
4014747,21483249-414e-7cc1-5027-8ec26125cb48,1,4011610,4011610,4014747,4014940,3137,3137,0,0,0,0
4046727,9089bcfd-9145-9617-b9c1-f1b288c79c98,16,3962116,3962116,4046727,4031811,84611,84611,0,0,0,0
4058140,da51db69-394f-fcb9-93db-c3a56071b669,8,4055357,4055357,4058140,4058664,2783,2783,0,0,0,0
4067069,df40ae0a-e1cb-ad85-34f1-7153e3b89773,8,4066285,4066285,4067069,4067398,784,784,0,0,0,0
4067142,aec13f6e-6a6c-0216-16f3-e1c899249d85,8,4066449,4066449,4067142,4067169,693,693,0,0,0,0
4070439,41c7a406-9359-fb5d-9ac7-25209670efb3,8,4069453,4069478,4070439,4070510,961,986,25,0,0,0
4070552,e3d2549d-769f-3d26-fbb9-c4ee7641f1fb,8,4069455,4069478,4070552,4070744,1074,1097,23,0,0,0
4070604,9fd90541-f597-0e00-168d-1defbb926370,8,4069440,4069478,4070604,4070811,1126,1164,38,0,0,0
4070593,e9f8e115-2d8a-c2cc-7bb9-bc20eea21c48,8,4069442,4069478,4070593,4070424,1115,1151,36,0,0,0
4070634,aee0ba17-9d25-4068-5fca-fb85dc34d926,8,4069448,4069478,4070634,4070019,1156,1186,30,0,0,0
4070643,4e1c6d6a-7b82-ff4c-5473-04460a88bdd7,8,4069465,4069478,4070643,4070651,1165,1178,13,0,0,0
4070702,bc9b944f-c6a3-e5d4-53c9-6c608551e6e8,8,4069448,4069478,4070702,4070083,1224,1254,30,0,0,0
4070726,b8b75626-b805-f666-716f-f4f50fbfae31,8,4069473,4069478,4070726,4070581,1248,1253,5,0,0,0
4070752,1e2f9c71-b6a0-33e6-3ab5-d8d05ac9c4d4,8,4069481,4069538,4070752,4070898,1214,1271,57,0,0,0
4070831,ae269692-d819-a8d1-445d-ff54427fbc4b,8,4069479,4069538,4070831,4070765,1293,1352,59,0,0,0
4071697,ef145b36-06b6-3727-2fcf-9246a81f3e5b,8,3763286,3763286,4071697,4189910,308411,308411,1199,1,0,0
4072670,a6cbb287-1432-f972-68b2-9ad37867340f,8,4068544,4068544,4072670,4074052,4126,4126,0,0,0,0
4076208,b97938ac-ead2-2702-0fcc-588e49ec6e32,8,4068606,4068606,4076208,4073406,7602,7602,0,0,0,0
4090569,52a6d515-b3d2-510c-6b2e-95702767333c,32,3972433,3972433,4090569,4031744,118136,118136,0,0,0,0
4101709,bab5c54b-5a48-7fd6-2ef0-17e7888546da,8,4093481,4093481,4101709,4100167,8228,8228,0,0,0,0
4107634,baad0da4-65aa-6c06-5d43-3dc2cb115be6,8,4105815,4105815,4107634,4107868,1819,1819,0,0,0,0
4110312,d5828d59-e1ce-f59e-6f10-2145227b0512,8,4101495,4101495,4110312,4112309,8817,8817,0,0,0,0
4111733,21ce7ad0-73f5-9a4e-767a-004b71d87c8f,8,4098412,4098412,4111733,4116332,13321,13321,0,0,0,0
4120181,1db60efe-740a-a8ad-4545-448dad2aa94b,8,4112065,4112065,4120181,4117676,8116,8116,0,0,0,0
4127329,ff33c8fc-187c-de97-038f-e1188cb2214e,8,4119175,4119175,4127329,4124616,8154,8154,0,0,0,0
4131529,c9886df0-95d0-2dac-cef2-4e8ad1fcbfa4,8,4122312,4122312,4131529,4133907,9217,9217,0,0,0,0
4133555,7a134ada-2e51-46bd-d857-0bc325ac7254,16,4122499,4122499,4133555,4129409,11056,11056,0,0,0,0
4143988,1f8452fb-6c26-5326-0dc6-d899ee209e85,16,4126071,4126071,4143988,4147935,17917,17917,0,0,0,0
4144879,8e1483d2-2f99-88ae-736c-1a10e4bc9bef,16,4127063,4127063,4144879,4150676,17816,17816,0,0,0,0
4144905,81ec334f-c766-978e-7673-7d1619a1459d,8,4144090,4144112,4144905,4145247,793,815,22,0,0,0
4144968,19504cc0-cf96-2bfa-5427-becdece9abc0,8,4144118,4144172,4144968,4144827,796,850,54,0,0,0
4145332,8151ef6c-7963-3f34-70c7-556a6576796d,8,4144609,4144626,4145332,4145116,706,723,17,0,0,0
4145368,3539bd22-6815-7607-43df-1c142ee066ca,8,4144616,4144626,4145368,4145389,742,752,10,0,0,0
4145907,fdcdd45c-53d3-2d79-f632-090ac22664f4,8,4144970,4144999,4145907,4145502,908,937,29,0,0,0
4145963,e093e2cf-162c-f897-a755-54fefcebe192,8,4144938,4144939,4145963,4146224,1024,1025,1,0,0,0
4146002,c6fc40c3-03cc-0a33-5db4-d496a8d89b3d,8,4144925,4144939,4146002,4146143,1063,1077,14,0,0,0
4146083,8ccf8851-fc94-7bc1-d14f-c8aa9cdd1043,8,4144924,4144939,4146083,4146380,1144,1159,15,0,0,0
4146040,b4fc8fdd-875d-24cb-5b32-7b4edd44051b,8,4144945,4144999,4146040,4145853,1041,1095,54,0,0,0
4146067,abf5c5d8-7582-40a7-b4a7-4d4353067ada,8,4144954,4144999,4146067,4145586,1068,1113,45,0,0,0
4146031,79a59fec-d5fd-40e9-8102-d8ebb8d7529c,8,4144970,4144999,4146031,4145502,1032,1061,29,0,0,0
4146105,24b0e62f-85ba-2504-3e07-90f18fc23d26,8,4144926,4144939,4146105,4146164,1166,1179,13,0,0,0
4146116,5a6d86ba-1434-faeb-261f-32ead2bcc804,8,4144935,4144939,4146116,4145521,1177,1181,4,0,0,0
4146305,5a878212-7988-16f2-e5d2-3d4112a1720b,8,4144967,4144999,4146305,4146535,1306,1338,32,0,0,0
4148537,3f843c8f-a46f-87b5-8d45-e921e64b5523,8,4147543,4147543,4148537,4148500,994,994,0,0,0,0
4148585,fff44899-89d2-5791-bd8c-182fbf228ef3,8,4147420,4147479,4148585,4148330,1106,1165,59,0,0,0
4148637,24f3984a-264f-b171-4a0d-08aedb6e82cc,8,4147419,4147419,4148637,4148665,1218,1218,0,0,0,0
4148636,6f3f753b-3fc1-2984-3818-1f7aaf2e1558,8,4147579,4147603,4148636,4148418,1033,1057,24,0,0,0
4148688,c84042f9-db66-cc53-3e15-91ee217fc48c,8,4147556,4147603,4148688,4148680,1085,1132,47,0,0,0
4148669,ccda08bf-5163-2bff-2d47-cb5af7b96b0d,8,4147575,4147603,4148669,4149130,1066,1094,28,0,0,0
4148764,3f4435c3-2fbd-af4f-b9e8-ba00cd59855d,8,4147424,4147479,4148764,4148661,1285,1340,55,0,0,0
4148814,6a036e2f-5108-4482-bdb7-7a79990501f8,8,4147566,4147603,4148814,4148967,1211,1248,37,0,0,0
4148974,fa98f0cf-42df-3d68-969e-3fde571ceacb,8,4147593,4147603,4148974,4148598,1371,1381,130,1,0,0
4149008,ebbc9e9a-f786-7063-8c69-d4b8ba045dfb,8,4147592,4147603,4149008,4149135,1405,1416,71,1,0,0
4149573,f039d524-0897-42f0-923d-a9569be2c179,8,4143092,4143138,4149573,4148377,6435,6481,46,0,0,0
4149984,2abb8747-d88e-6b86-a159-b48192a6dd56,8,4144052,4144052,4149984,4148761,5932,5932,1842,2,0,0
4150646,649ad218-a5b5-c511-e7ad-3be20356b6fe,8,4142580,4142580,4150646,4147409,8066,8066,0,0,0,0
4151167,f0c46591-b2d9-95fa-449e-e02aeea28810,8,4143095,4143138,4151167,4150962,8029,8072,43,0,0,0
4151184,2d6446d8-94d3-a310-9489-133ccf40ee1a,8,4143081,4143138,4151184,4154853,8046,8103,57,0,0,0
4151258,426cd241-261e-5c4d-d868-7bc07de7ca5a,8,4150215,4150248,4151258,4150914,1010,1043,33,0,0,0
4151295,f505b662-5937-0710-2829-1eebe614a0d9,8,4150188,4150188,4151295,4150783,1107,1107,0,0,0,0
4151548,018af2d2-427c-3d5f-3c3d-bcd8c7050c5b,8,4150351,4150351,4151548,4151723,1197,1197,0,0,0,0
4151618,2f2a2499-2da2-79cb-c4a3-68646ceb9d92,8,4150190,4150248,4151618,4151371,1370,1428,58,0,0,0
4151670,70e39ecb-77ec-1430-6885-ca4740ee7a6e,8,4150416,4150471,4151670,4151979,1199,1254,55,0,0,0
4151705,625ac0d9-fce3-5a66-a23c-ff90968c5275,8,4150354,4150411,4151705,4151493,1294,1351,57,0,0,0
4151714,f20d3aea-a998-a3ee-22a1-12b53a880cec,8,4150362,4150411,4151714,4151868,1303,1352,49,0,0,0
4151680,aac782ac-dce2-ab06-7a15-422e3cc7edc8,8,4150431,4150471,4151680,4151755,1209,1249,40,0,0,0
4153198,fc16f82a-b682-4487-ef45-88c3277747dc,8,4143097,4143138,4153198,4149257,10060,10101,41,0,0,0
4153248,2aed0848-639a-851f-57e5-d468f1ed1e4a,8,4143080,4143138,4153248,4153056,10110,10168,58,0,0,0
4153253,312dd27a-87c8-9c01-86fc-96c7bc38bf24,8,4143101,4143138,4153253,4152120,10115,10152,37,0,0,0
4155408,b4d70339-1424-bcfc-13da-35053daaae57,8,4146768,4146768,4155408,4155415,8640,8640,548,1,0,0
4156077,46997fc2-7de5-0d45-cb00-ebbfaf0545d3,8,4143087,4143138,4156077,4158626,12939,12990,51,0,0,0
4156081,18f1101e-8450-6864-035c-6c488b5c0140,8,4143098,4143138,4156081,4153181,12943,12983,40,0,0,0
4156294,929d778e-9fde-2d5f-c441-c3db6bb57af7,8,4143107,4143138,4156294,4156573,13156,13187,31,0,0,0
4156401,7d82e0de-e3cc-1771-c66e-f0cdd2ea243c,8,4148324,4148324,4156401,4159711,8077,8077,0,0,0,0
4156445,c8880b2c-651e-bbd2-e99e-9370ede40cf0,8,4143088,4143138,4156445,4156893,13307,13357,50,0,0,0
4156622,c2045288-3bde-8b66-701c-3f0c9b43324c,8,4143080,4143138,4156622,4161801,13484,13542,58,0,0,0
4156720,dfb44eef-7038-6338-4c2d-189b2422262e,8,4143106,4143138,4156720,4160993,13582,13614,32,0,0,0
4157021,7f258778-8140-3ce5-c2e8-118f9ca3d9d1,8,4143078,4143078,4157021,4150336,13943,13943,0,0,0,0
4157057,46a1c19b-d238-b804-8a8c-e2d7bdeb7527,8,4143096,4143138,4157057,4161052,13919,13961,42,0,0,0
4157260,6b35a9b9-0bfc-8c45-8a43-aa23426ea2f9,8,4143089,4143138,4157260,4163756,14122,14171,49,0,0,0
4158840,e39f95a1-61a9-529d-edc2-735db26dfebe,8,4143101,4143138,4158840,4156101,15702,15739,37,0,0,0
4159277,03d2a7ca-3775-33ab-d447-6a01ec67f7b7,8,4158659,4158659,4159277,4159455,618,618,0,0,0,0
4159365,0d97bade-647a-96e9-1a2d-0d7abac432f8,8,4143103,4143138,4159365,4151450,16227,16262,35,0,0,0
4159504,e62c54bb-ff01-1f14-d97b-d00e34757171,8,4143109,4143138,4159504,4162865,16366,16395,362,1,0,0
4159898,c91463ac-af4a-bf31-49df-f7488a8b0677,8,4143088,4143138,4159898,4156252,16760,16810,50,0,0,0
4159898,11f0a923-22b2-e0bd-b8b0-67436a02c1e2,8,4143096,4143138,4159898,4165462,16760,16802,42,0,0,0
4159962,9077f90f-58c9-2bb8-06d2-af43899348fc,8,4143082,4143138,4159962,4164712,16824,16880,56,0,0,0
4165964,80dac46f-2171-ce00-c261-c03dc6df62a7,8,4143080,4143138,4165964,4172703,22826,22884,58,0,0,0
4165996,61650f34-465f-d96b-73b6-b1439d96d6dd,8,4143096,4143138,4165996,4154534,22858,22900,42,0,0,0
4166084,131ad6fa-c8b8-0c6c-2f54-2dc69a24beb8,8,4143083,4143138,4166084,4156247,22946,23001,55,0,0,0
4166114,b4c754f0-0f44-5302-2e25-acf434cc4768,8,4143093,4143138,4166114,4157346,22976,23021,45,0,0,0
4166359,13abd39b-b92e-2cab-08e5-dd93dad50f42,8,4143086,4143138,4166359,4167439,23221,23273,52,0,0,0
4167235,1006e0eb-63a8-4422-e29e-ae63e8475ebd,8,4143111,4143138,4167235,4165545,24097,24124,1019,3,0,0
4169694,03e6551e-11da-be5e-1862-3b8cdb23915e,8,4143079,4143138,4169694,4165483,26556,26615,59,0,0,0
4169708,041aabfd-b894-9e59-a4da-b893e19896da,8,4143108,4143138,4169708,4159230,26570,26600,30,0,0,0
4169785,d142a871-05b2-622f-3603-768daa7694d9,8,4143105,4143138,4169785,4172958,26647,26680,33,0,0,0
4170026,f70f8b81-4f83-90da-19a4-8e556cf1bb98,8,4143105,4143138,4170026,4179197,26888,26921,33,0,0,0
4170028,8ad634a7-f6a6-4d7f-a190-28e4e21e2ae4,8,4143098,4143138,4170028,4162824,26890,26930,40,0,0,0
4170212,03711d3f-c9be-5dce-02ee-09bf9811cd8b,8,4143083,4143138,4170212,4178371,27074,27129,55,0,0,0
4171375,48ae4aba-19b1-cec8-ae97-38692ea151aa,8,4170656,4170656,4171375,4171258,719,719,0,0,0,0
4185617,408b1ac0-1f0e-b3aa-1709-0396ffd04fa6,8,4177410,4177410,4185617,4181558,8207,8207,0,0,0,0
4188031,c5c19ddb-917f-8389-e146-02b4eac2e8ad,8,4143088,4143138,4188031,4196144,44893,44943,50,0,0,0
4188068,d771b446-7ac5-3288-4053-f74e3f003f8a,8,4143102,4143138,4188068,4167630,44930,44966,36,0,0,0
4188631,284baa23-350e-0c9a-1d95-505626db89dc,8,4068648,4068666,4188631,4238236,119965,119983,18,0,0,0
4189838,e31896d5-7216-006c-31ab-2c49ec817e3e,8,4188623,4188623,4189838,4189272,1215,1215,0,0,0,0
4189983,84203c0c-51f3-23e6-2126-180ad586cc32,8,4143091,4143138,4189983,4211036,46845,46892,47,0,0,0
4194066,8716f0b3-9619-7356-fcf8-d6f86cf322ab,32,3628167,3628167,4194066,4012678,565899,565899,4151,2,0,0
4194738,77b299e6-22cd-2c19-e7a3-3be5532394aa,8,4188454,4188454,4194738,4196021,6284,6284,0,0,0,0
4198242,d3dd8cf8-53a7-0e7d-1b86-9a7274242892,8,4190333,4190333,4198242,4200602,7909,7909,0,0,0,0
4201011,7dd7e170-e0d0-807c-179e-e93ba3999919,16,4199760,4199772,4201011,4200506,1239,1251,12,0,0,0
4202538,33eadf2f-e4cd-46e1-2139-298b2795bf89,16,4201323,4201323,4202538,4202194,1215,1215,0,0,0,0
4211348,e37fb2dd-2f8a-d8e5-c6bc-b0d00415052c,8,4209937,4209937,4211348,4211622,1411,1411,0,0,0,0
4211354,b3cbc1c4-4cdf-2ab5-94a0-f4355b3d7f2a,8,4209938,4209997,4211354,4211634,1357,1416,59,0,0,0
4211457,c51e21bd-b4d2-b229-23a7-cc57cf63961d,8,4209938,4209997,4211457,4211992,1460,1519,59,0,0,0
4211634,80ff8beb-631e-b726-c364-9c91faca60d4,16,4199712,4199712,4211634,4210410,11922,11922,0,0,0,0
4211654,20bf262b-4f4c-9fe8-2cc1-8e4d83992e41,8,4209939,4209997,4211654,4211702,1657,1715,58,0,0,0
4215736,46230245-dd7c-b15a-aeb2-51526002ed7b,64,4054261,4054261,4215736,4201651,161475,161475,0,0,0,0
4216072,0f6924f3-2f53-2a9f-ce0a-e1dd5b95ae5e,8,4212197,4212256,4216072,4215961,3816,3875,59,0,0,0
4216078,ff36fe7f-c1ab-5f4c-23a8-bfbe96289af2,8,4212196,4212196,4216078,4217229,3882,3882,0,0,0,0
4216711,ab16b1fd-14ca-728c-1336-eb2833ba1e1b,8,4212197,4212256,4216711,4215459,4455,4514,59,0,0,0
4217346,2e8498c6-7c74-eb6a-78b6-a2933d6f9aaf,8,4212199,4212256,4217346,4217621,5090,5147,57,0,0,0
4217558,094d4b8a-67ee-87f2-7433-005aa5b33e2e,16,4199749,4199772,4217558,4213432,17786,17809,23,0,0,0
4220949,b31083a0-5215-65ee-c65b-c093f90047bb,8,4191975,4191975,4220949,4207336,28974,28974,0,0,0,0
4223010,b0385cd1-fb86-71c1-58be-6c14b2675285,16,4209789,4209789,4223010,4228455,13221,13221,0,0,0,0
4223262,73b171e5-cc56-4dff-c314-d41cf699734e,8,4217801,4217801,4223262,4221059,5461,5461,0,0,0,0
4223730,12e63e97-178f-1dd7-44c7-b9766c0d8d97,8,4217803,4217861,4223730,4225441,5869,5927,58,0,0,0
4224268,72b91684-e6d4-f65e-3401-9a9a90fcc940,8,4217801,4217801,4224268,4225595,6467,6467,0,0,0,0
4224997,57a9b67f-e35f-41db-0a12-0876c74de5e3,8,4217801,4217801,4224997,4223330,7196,7196,0,0,0,0
4226777,3db8014a-8dc5-d246-a85d-938be64f8ec0,8,4210929,4210929,4226777,4225043,15848,15848,0,0,0,0
4231796,632cd092-5b80-f397-f347-e18df7dea35a,8,4218868,4218899,4231796,4228823,12897,12928,31,0,0,0
4231983,3878a369-b2f3-bc00-5092-74705a5e6d18,8,4218851,4218899,4231983,4229901,13084,13132,48,0,0,0
4232154,2c5e405e-34cf-6b7f-3f4c-d64f3142feb2,8,4218866,4218899,4232154,4227570,13255,13288,33,0,0,0
4232208,c881464b-c358-5cfb-c75f-a0cf4974e1b7,8,4218867,4218899,4232208,4227497,13309,13341,32,0,0,0
4232274,ddef6430-845f-6d5d-2c22-919cfbc07564,8,4218847,4218899,4232274,4233481,13375,13427,52,0,0,0
4232482,019db91e-3c7f-1fd1-d3e2-63471ac33967,8,4218856,4218899,4232482,4234081,13583,13626,43,0,0,0
4232564,352d855e-95cf-bd81-6c47-016cecb359bf,8,4218843,4218899,4232564,4225769,13665,13721,56,0,0,0
4232589,6839ff36-079d-02d4-715a-27c5b9296f54,8,4218846,4218899,4232589,4233819,13690,13743,53,0,0,0
4232637,085e9e90-f12f-f03e-923b-6567dcdc614f,8,4218853,4218899,4232637,4228043,13738,13784,46,0,0,0
4232742,ee550e96-037c-9932-e5b3-2f0bc91ca763,8,4218844,4218899,4232742,4231824,13843,13898,55,0,0,0
4232733,84e69ef9-a629-ebb2-5352-e5785e13ab9c,8,4218846,4218899,4232733,4233491,13834,13887,53,0,0,0
4232689,0cc664cb-132a-c1fa-9d51-65083b4a17cd,8,4218849,4218899,4232689,4233595,13790,13840,50,0,0,0
4232724,7f527025-b3ed-3b04-a307-840278e6e25e,8,4218850,4218899,4232724,4227293,13825,13874,49,0,0,0
4233016,f53d488d-e994-4cd2-9ab9-5b799f76385e,8,4218840,4218899,4233016,4227822,14117,14176,59,0,0,0
4233058,d75ca92d-a65a-158b-7455-008bb28fa46c,8,4218840,4218899,4233058,4239932,14159,14218,59,0,0,0
4233051,63754082-420d-2799-fffe-5b8b7ae32c9a,8,4218854,4218899,4233051,4236314,14152,14197,45,0,0,0
4233108,37309e25-f10c-b4f0-285d-9795b9138441,8,4218843,4218899,4233108,4235499,14209,14265,56,0,0,0
4233160,52105009-b207-75f2-8e07-b7b4a7905401,8,4218840,4218899,4233160,4227296,14261,14320,59,0,0,0
4233157,6d2616e2-2a3b-b73f-12fe-55f53732d5fe,8,4219618,4219618,4233157,4237369,13539,13539,0,0,0,0
4233210,2bd346cb-e1ad-d4fa-6974-eaeebdb1d20f,8,4218840,4218899,4233210,4226577,14311,14370,59,0,0,0
4233439,3495aef4-fa2b-c70f-5b1c-1cd74dc0c04c,8,4219618,4219618,4233439,4235048,13821,13821,0,0,0,0
4233554,824fdf53-d98a-1a6f-4f8c-d57dc5ecd23e,8,4218852,4218899,4233554,4238201,14655,14702,47,0,0,0
4233808,626cd59a-ec3e-83c3-7961-3250d3752185,8,4219619,4219678,4233808,4234399,14130,14189,59,0,0,0
4234086,7bdeb381-f4fc-b6bc-012d-b1c403c3c30d,8,4219618,4219618,4234086,4226956,14468,14468,0,0,0,0
4234180,ce908ee8-f657-a9b2-61de-ebef80b6d44f,8,4218855,4218899,4234180,4229953,15281,15325,44,0,0,0
4234587,378a91e6-882a-6ff5-40c0-63fc9c9a9d7d,8,4229398,4229456,4234587,4232642,5131,5189,58,0,0,0
4234968,3a96c7f5-18e0-0183-c6bf-b986045fea04,8,4229397,4229456,4234968,4237273,5512,5571,59,0,0,0
4235873,cc02ae53-5cad-f1a9-40d2-e1bee0ef3416,8,4218862,4218899,4235873,4232748,16974,17011,37,0,0,0
4235853,86403806-a366-6154-7136-e9e57f71a837,8,4229396,4229396,4235853,4235105,6457,6457,0,0,0,0
4236114,d5b4c4a4-f9d7-b9ad-7850-b7b19d95f5c5,8,4229397,4229456,4236114,4238970,6658,6717,59,0,0,0
4236423,fd481505-b8f0-9270-567f-d2e9c2f18bfc,8,4218839,4218839,4236423,4232192,17584,17584,0,0,0,0
4236902,d91e7e1a-6e48-0e95-e228-23f82a46cb32,8,4229397,4229456,4236902,4233289,7446,7505,59,0,0,0
4237245,fd780916-aa84-6060-070d-eea0bb09e763,8,4218852,4218899,4237245,4233089,18346,18393,47,0,0,0
4237987,33c25e62-7960-e810-fa37-298924290112,8,4236341,4236341,4237987,4237302,1646,1646,0,0,0,0
4238005,b5836d91-4eb1-3673-38ae-1b31becde24c,8,4229397,4229456,4238005,4234164,8549,8608,59,0,0,0
4238081,0f90bfaa-b44d-4088-57bc-6e8af9653f72,8,4229397,4229456,4238081,4240835,8625,8684,59,0,0,0
4238345,e2f7da51-4c40-a716-bcf8-fa8f71c01cb1,8,4236341,4236341,4238345,4237821,2004,2004,0,0,0,0
4238361,b92d933d-a10f-f3db-c169-9add6c286e65,8,4236342,4236401,4238361,4237604,1960,2019,59,0,0,0
4238978,c1fcdfc3-21b2-caa6-d5bc-cd83bb853c91,8,4229396,4229396,4238978,4234604,9582,9582,0,0,0,0
4239070,0f34bd08-8e10-a3c7-0b4b-af231c4dacfd,8,4231106,4231106,4239070,4235651,7964,7964,0,0,0,0
4239125,22f50db1-6563-c7d9-d04a-3a7335bc040f,8,4236341,4236341,4239125,4239304,2784,2784,0,0,0,0
4239134,f605070b-ea73-2391-5840-f42533decf96,8,4236341,4236341,4239134,4238356,2793,2793,0,0,0,0
4239711,1192a38f-6d5e-020f-a08c-afbfecdbe3c7,8,4236343,4236401,4239711,4238103,3310,3368,58,0,0,0
4239758,5a8d9931-5ebb-3417-7523-8331243711ee,8,4236343,4236401,4239758,4239319,3357,3415,58,0,0,0
4239745,22897671-7234-9df0-45f0-3f1ccd4a3c8e,8,4236344,4236401,4239745,4238396,3344,3401,57,0,0,0
4239775,66383fa3-dec6-7e8f-f21b-76e3482202f9,8,4236341,4236341,4239775,4240068,3434,3434,0,0,0,0
4240085,706370c4-971f-0676-7697-67b732dba13d,8,4232003,4232043,4240085,4238267,8042,8082,40,0,0,0
4242371,e282338d-27ae-500a-c6c2-e2be83b5c73d,8,4241664,4241664,4242371,4242654,707,707,0,0,0,0
4247722,c0c86a82-b2b1-1b81-a438-0f8a8ffd43cf,8,4234281,4234340,4247722,4241370,13382,13441,59,0,0,0
4247902,8e5e71c5-94eb-ae5d-bc16-5b0e3b17b288,8,4234280,4234280,4247902,4252878,13622,13622,0,0,0,0
4247949,0caaf782-dae5-108b-7454-83ed12ed553c,8,4234280,4234280,4247949,4242389,13669,13669,0,0,0,0
4248063,c6d93097-4d0e-2acd-1dc8-b74ad10b41c1,8,4234280,4234280,4248063,4253346,13783,13783,0,0,0,0
4254372,966925ed-9c0e-2e5e-0d7b-03695769993c,8,4241148,4241199,4254372,4250973,13173,13224,51,0,0,0
4254573,52335cad-3905-7fc0-6151-f6edb2297aff,8,4241143,4241199,4254573,4259322,13374,13430,56,0,0,0
4254807,a9c55ff9-9dd0-db9c-6c14-52b48bc1163c,8,4241142,4241199,4254807,4260028,13608,13665,57,0,0,0
4255296,f7b8a5e4-80a5-fe0d-0016-7fac2003c81e,8,4241146,4241199,4255296,4256520,14097,14150,53,0,0,0
4255316,f1db228c-b4a7-ea99-d572-d4083e11bb31,8,4241139,4241139,4255316,4250995,14177,14177,0,0,0,0
4256369,2b72895b-03c5-607e-080e-ee5e8020da65,8,4241148,4241199,4256369,4260161,15170,15221,51,0,0,0
4277397,44de3376-8a53-3a16-4752-7e223aff81d1,8,4276354,4276354,4277397,4277647,1043,1043,0,0,0,0
4278769,d550f98f-1cb4-e0cf-4bb9-536fbb74a62b,8,4277361,4277361,4278769,4279145,1408,1408,0,0,0,0
4278847,fc3b8f4d-fe42-db8f-4e5a-ef220f988297,8,4277362,4277421,4278847,4279273,1426,1485,59,0,0,0
4278856,895c186b-3a77-2b80-27b8-f1780ef6465e,8,4277362,4277421,4278856,4278973,1435,1494,59,0,0,0
4281580,b1d8ea69-8eb7-cd02-abf7-c0281f978761,16,4274615,4274615,4281580,4281666,6965,6965,0,0,0,0
4285152,53ae0bce-0ccc-f432-6913-ed3b7f5c62cc,8,4279142,4279200,4285152,4284772,5952,6010,58,0,0,0
4286926,02f38593-5fcf-960e-b71f-e000884831ce,8,4274850,4274870,4286926,4289486,12056,12076,20,0,0,0
4287044,5da55873-5e85-f364-6426-f2e5b5eae220,8,4279142,4279200,4287044,4283656,7844,7902,58,0,0,0
4287609,6c74eed4-4578-f4e6-332b-ad052c682589,8,4279149,4279200,4287609,4289035,8409,8460,51,0,0,0
4288805,e2888ddb-892e-2973-cd65-be9a9b4d6f3e,8,4279144,4279200,4288805,4284958,9605,9661,56,0,0,0
4289115,6d473b55-db1c-71cb-7002-983102bda3a7,8,4273117,4273117,4289115,4288475,15998,15998,0,0,0,0
4289292,818b0652-7974-8626-8352-a5d609954fc3,8,4279140,4279140,4289292,4284988,10152,10152,0,0,0,0
4290091,0d86ff36-f35d-164d-466d-8ac168f65558,16,4289466,4289466,4290091,4290082,625,625,0,0,0,0
4290178,8776b75f-ecef-93a2-be19-b37aa966544f,8,4274816,4274870,4290178,4287865,15308,15362,54,0,0,0
4290414,4b2ca54d-5343-5238-1694-c02c4ebd9823,8,4274811,4274870,4290414,4287776,15544,15603,59,0,0,0
4292619,6fd2b471-64c4-8c04-e3bf-37c26ffe5a67,8,4274854,4274870,4292619,4293317,17749,17765,16,0,0,0
4295673,0784781d-2006-1fdb-16ee-251359d12415,8,4274853,4274870,4295673,4299113,20803,20820,17,0,0,0
4297357,62e5b19a-0ccf-d7fb-4382-79e7ecf8022f,8,4274835,4274870,4297357,4297220,22487,22522,35,0,0,0
4297574,c6e9c9c4-df46-6896-cdbc-3b08abc9fbb3,16,4292015,4292015,4297574,4295013,5559,5559,0,0,0,0
4297781,23451386-ebaf-c098-26f7-12cc81ca7732,8,4274811,4274870,4297781,4295583,22911,22970,59,0,0,0
4298264,4d40e14f-0afc-32bc-0299-e3553e933783,8,4274814,4274870,4298264,4289633,23394,23450,56,0,0,0
4298686,ee125271-ef2b-03e0-0e5b-f3282b7a523e,8,4274815,4274870,4298686,4291190,23816,23871,55,0,0,0
4300807,6b2fa6bc-00b6-cb48-d0e9-9af04d257207,8,4272470,4272470,4300807,4314063,28337,28337,0,0,0,0
4301893,2b2fedc6-e1d8-2cb7-0a8a-88d92ec8d7c7,8,4256245,4256245,4301893,4298940,45648,45648,0,0,0,0
4307513,32803153-382e-80e8-059f-99d73acf0cbf,16,4306257,4306280,4307513,4307944,1233,1256,23,0,0,0
4307614,285e9704-3fca-1417-1989-cdb9450513d0,16,4306220,4306220,4307614,4307071,1394,1394,0,0,0,0
4309066,ed6b9872-dc2b-1537-8082-efd478b2a65d,8,4258659,4258659,4309066,4295931,50407,50407,0,0,0,0
4309301,394b5576-f887-6d7d-bb28-b3b18212f5df,16,4308056,4308056,4309301,4309168,1245,1245,0,0,0,0
4309338,06cd3e3b-d202-6202-356d-98962f50f0fb,16,4308083,4308116,4309338,4309137,1222,1255,33,0,0,0
4311014,2bfad69a-8a9e-d16f-bd23-21add45ce2cf,8,4258669,4258719,4311014,4327379,52295,52345,50,0,0,0
4311453,18161864-515b-045a-028a-f9a75ac8c08c,8,4258665,4258719,4311453,4286369,52734,52788,54,0,0,0
4311499,c0b15ca3-89ae-67cb-9893-e27dd5204b48,8,4274833,4274870,4311499,4295475,36629,36666,37,0,0,0
4312016,f365185d-eafb-7b2c-b77c-32c24556a328,8,4274859,4274870,4312016,4330310,37146,37157,11,0,0,0
4312420,bef0e0f1-1791-de3c-cc75-70cc8e32ebbf,8,4274825,4274870,4312420,4313679,37550,37595,45,0,0,0
4314211,00bd2562-205c-ffb1-817b-f3cec78d7642,8,4274813,4274870,4314211,4310383,39341,39398,57,0,0,0
4314458,695db06d-3151-bb94-f88f-7584a31dcd15,8,4274827,4274870,4314458,4303831,39588,39631,43,0,0,0
4314960,a8eb963a-2888-ead9-97d4-d81b92326c46,8,4258672,4258719,4314960,4289864,56241,56288,47,0,0,0
4315751,e9052c4b-2c4c-7385-e74c-87ebf10a373d,8,4274845,4274870,4315751,4302361,40881,40906,25,0,0,0
4316079,61b862b2-181d-40f9-b0d3-ce6fb437e204,16,4314764,4314764,4316079,4315859,1315,1315,0,0,0,0
4318868,bca88911-97ea-502c-2bc6-206b16754427,16,4317647,4317647,4318868,4319118,1221,1221,0,0,0,0
4319143,0a6368f2-e413-a4d3-e083-ebb5c0cdf96d,8,4316981,4317031,4319143,4318938,2112,2162,50,0,0,0
4319169,cfab07f4-0022-994c-cdad-77367a272eb3,8,4274810,4274810,4319169,4337500,44359,44359,0,0,0,0
4319409,87a6c63c-65a1-ee9c-3b39-b8aa39d0eb01,8,4274822,4274870,4319409,4298327,44539,44587,48,0,0,0
4319695,ff62499a-f2ae-7fce-877a-71fc9d9fbeb3,8,4316985,4317031,4319695,4318917,2664,2710,46,0,0,0
4320122,1d522106-71e6-1fd1-e846-d6880047eacb,8,4316971,4316971,4320122,4318832,3151,3151,0,0,0,0
4320886,db0f1685-93dd-ee65-ca12-f3d93e98f09d,8,4320095,4320095,4320886,4320628,791,791,0,0,0,0
4321163,773fbb30-107d-4224-493a-55d2e3a71aee,16,4314793,4314824,4321163,4322937,6339,6370,31,0,0,0
4321650,33e1f2af-32cc-ea25-31fd-1e5ef86561ef,8,4320910,4320946,4321650,4321506,704,740,36,0,0,0
4324011,2a67f030-87b5-3b85-5673-51cb39347843,8,4316982,4317031,4324011,4324623,6980,7029,49,0,0,0
4324351,5492112f-259d-537f-3f8a-16b8919a5591,8,4323511,4323511,4324351,4324220,840,840,0,0,0,0
4324794,9012d2f8-c3dc-13a9-5f42-feab979f5b27,8,4324061,4324076,4324794,4324632,718,733,15,0,0,0
4324864,4258828b-a23e-189b-4367-70b21a3a1233,16,4323530,4323571,4324864,4325034,1293,1334,41,0,0,0
4333511,964d9921-41f9-bf45-86b5-dd45d41a4093,8,4274848,4274870,4333511,4361638,58641,58663,22,0,0,0
4335082,ac5a61d3-94fc-2275-d4e8-45bcbdfe7f18,8,4248075,4248123,4335082,4314045,86959,87007,48,0,0,0
4337575,95a5de44-e731-207b-65db-b4045b199207,8,4274847,4274870,4337575,4361413,62705,62728,23,0,0,0
4337725,c65f72e4-7d8b-8291-7b2a-cbee405620d4,8,4336908,4336958,4337725,4337410,767,817,50,0,0,0
4337769,2f63a62d-03d0-ac19-1df1-f0f5d0f36c28,8,4336898,4336898,4337769,4337458,871,871,0,0,0,0
4337728,5dbe0139-c895-78d9-8907-19db252a95db,8,4336900,4336958,4337728,4337552,770,828,58,0,0,0
4337759,128e92ad-6b70-7ef6-fe62-314e22e142fc,8,4336900,4336958,4337759,4338043,801,859,58,0,0,0
4337726,31bf8a3c-5ae5-7068-d2ed-9291c3da1521,8,4336938,4336958,4337726,4337752,768,788,20,0,0,0
4337727,611e5684-76af-13c0-36c1-c052207ca173,8,4336943,4336958,4337727,4337685,769,784,15,0,0,0
4337828,6acac286-8b1e-e01c-6f79-029edea6a37e,8,4336967,4337018,4337828,4338122,810,861,51,0,0,0
4337823,d46a1235-80c7-50d4-8b9a-0113b81c9d0b,8,4336979,4337018,4337823,4338090,805,844,39,0,0,0
4337890,c016215d-3807-ef3a-1cd4-aa85613c826a,8,4336900,4336958,4337890,4337834,932,990,58,0,0,0
4337897,1f4db543-f58b-42eb-db03-89976cab2214,8,4336943,4336958,4337897,4337939,939,954,15,0,0,0
4338221,f1587598-9e15-3705-df63-2d7a5ba3d1da,8,4336495,4336541,4338221,4338463,1680,1726,46,0,0,0
4338335,dff4cc91-3164-6c14-f1a0-051f0acae683,8,4336439,4336481,4338335,4337680,1854,1896,205,1,0,0
4338571,afef2e1c-f34b-83b9-9818-2703fc800953,8,4336485,4336541,4338571,4337817,2030,2086,56,0,0,0
4338624,a564ee98-fc3e-9ed1-1cdb-d909f9cd1b18,8,4336421,4336421,4338624,4338516,2203,2203,0,0,0,0
4338712,93188472-9fa6-f3ea-db65-e8d62660f73f,8,4336490,4336541,4338712,4339153,2171,2222,51,0,0,0
4338766,f8642165-298a-7a60-2fac-4e8cf6c94743,8,4336461,4336481,4338766,4337985,2285,2305,183,1,0,0
4338821,ef3dc5a8-9295-8d18-ec7c-44a8e6c9e05e,8,4336443,4336481,4338821,4338199,2340,2378,201,1,0,0
4338853,a484be3e-2191-990c-3c86-1a6af55db8b9,8,4336426,4336481,4338853,4338573,2372,2427,55,0,0,0
4338888,9c4cc0fd-fee4-4434-1d2b-11d0e976d79f,8,4336445,4336481,4338888,4339520,2407,2443,199,1,0,0
4338891,cc6c7745-06a7-bafd-0327-aec2f737e8bc,8,4336509,4336541,4338891,4338274,2350,2382,242,1,0,0
4338941,6932317a-876e-f409-b106-3540067b0c70,8,4336498,4336541,4338941,4338481,2400,2443,193,1,0,0
4339002,55ba1dfe-a30e-1e97-9406-1f23c91f8d86,8,4336465,4336481,4339002,4337753,2521,2537,179,1,0,0
4338973,8e687e83-0023-b3a5-38b0-42dac52a0570,8,4336524,4336541,4338973,4338036,2432,2449,227,1,0,0
4339094,23065b37-1c75-725e-dd3e-0153ea15bb14,8,4336452,4336481,4339094,4338908,2613,2642,192,1,0,0
4339102,240ed1db-0c3b-add8-52b1-9d01942caa0c,8,4336502,4336541,4339102,4338970,2561,2600,249,1,0,0
4339170,ef6739d2-6c82-3a41-30d5-69ed4684ac73,8,4336446,4336481,4339170,4338937,2689,2724,198,1,0,0
4339286,2ed1027f-dcbd-6ef5-ef8b-07d099c8cca7,8,4336508,4336541,4339286,4339454,2745,2778,243,1,0,0
4339340,87eb0127-c979-ff8f-cb8a-051ab27913d5,8,4336530,4336541,4339340,4339250,2799,2810,281,1,0,0
4339403,47eebcf2-6664-b678-5203-d212098aa62c,8,4336453,4336481,4339403,4340391,2922,2950,191,1,0,0
4339645,374e3e12-ebed-65d4-04f2-99efc26cd636,8,4336524,4336541,4339645,4338796,3104,3121,227,1,0,0
4340216,c252714e-869c-6fdd-0465-a8d7438806fe,8,4274848,4274870,4340216,4341249,65346,65368,22,0,0,0
4340732,089f4c42-2407-6ed2-641d-f3f9e403cbbb,8,4274844,4274870,4340732,4364688,65862,65888,26,0,0,0
4340984,6e96f611-e00c-04a3-3826-ad580e98686d,8,4274819,4274870,4340984,4317819,66114,66165,51,0,0,0
4342326,9d09cf19-a079-f65a-4cc5-b7058af263bd,8,4274831,4274870,4342326,4364997,67456,67495,39,0,0,0
4343121,986abdfa-800c-8efb-7943-bf07bc9b5872,8,4340956,4340993,4343121,4343395,2128,2165,37,0,0,0
4343177,88143a11-7b0e-2102-a6ff-ab6dc133ef02,8,4341032,4341053,4343177,4343680,2124,2145,21,0,0,0
4343344,d6dcb81a-824b-debb-d644-2ee9c448ebc5,8,4340827,4340873,4343344,4343453,2471,2517,46,0,0,0
4343514,2a314f1d-7bf7-bf91-9958-21e07b310f54,8,4274858,4274870,4343514,4375287,68644,68656,12,0,0,0
4343557,662b7ae4-c2aa-be0c-2f74-10dd57790735,8,4340813,4340813,4343557,4344630,2744,2744,0,0,0,0
4343547,3adbd2b2-943a-1af1-c146-3a0a8763edcb,8,4340941,4340993,4343547,4342341,2554,2606,52,0,0,0
4343679,65cc59d6-2d52-0b16-6709-9d55c49943ce,8,4274833,4274870,4343679,4359660,68809,68846,37,0,0,0
4343839,731baedd-6b25-e1e9-fa78-14729c4973a4,8,4340834,4340873,4343839,4344268,2966,3005,39,0,0,0
4343861,d7aae31f-6afd-7346-ecc6-9033296e44d5,8,4274834,4274870,4343861,4319050,68991,69027,36,0,0,0
4343840,20b2a35f-64f6-82b5-3fc7-6ec5bdb3a39d,8,4340941,4340993,4343840,4342520,2847,2899,52,0,0,0
4343978,5c05dcee-f49c-66f4-ab86-d1c5eab2bbe3,8,4322636,4322636,4343978,4343118,21342,21342,0,0,0,0
4344102,252b473a-d2cd-b683-4c56-4c15e507b981,8,4322636,4322636,4344102,4339489,21466,21466,0,0,0,0
4344105,d0f95340-720d-576f-0d96-30be5580885a,8,4341025,4341053,4344105,4343565,3052,3080,28,0,0,0
4344247,350c559f-09ea-3c35-1f65-206e83a17fac,8,4340829,4340873,4344247,4344637,3374,3418,44,0,0,0
4344434,32fc5015-b2c4-606b-8381-023f292faba1,8,4340896,4340933,4344434,4343359,3501,3538,37,0,0,0
4344469,ff3d782f-4cdd-aaf2-d57a-d46184255121,8,4343567,4343574,4344469,4344228,895,902,7,0,0,0
4344502,7ea19c4a-769b-c641-f84c-0ee5a2206dd1,8,4343583,4343634,4344502,4344657,868,919,51,0,0,0
4344496,b4666d99-46d5-d341-ed50-a84e71bfd71b,8,4343585,4343634,4344496,4344248,862,911,49,0,0,0
4344496,0c5f606f-8b5c-59ef-1faf-f7a0c991484d,8,4343608,4343634,4344496,4344188,862,888,26,0,0,0
4344517,8c38c18b-02de-4556-1f27-e8b562e03868,8,4343608,4343634,4344517,4344277,883,909,26,0,0,0
4344552,90ccd1e5-8027-39e5-4da5-98e482a06460,8,4343643,4343694,4344552,4344100,858,909,51,0,0,0
4344606,00adad8f-cc5e-c79b-67fc-50e01e7e0e2d,8,4343566,4343574,4344606,4344775,1032,1040,8,0,0,0
4344644,6dbd4921-653f-4313-ef82-fab37e0c5286,8,4343653,4343694,4344644,4344132,950,991,41,0,0,0
4344752,b443cda3-4b80-a8c6-ce31-66c3541acd27,8,4343567,4343574,4344752,4344279,1178,1185,7,0,0,0
4344810,ab86fc70-a89c-0d28-ce08-215adbe6fc7f,8,4343621,4343634,4344810,4344257,1176,1189,13,0,0,0
4346045,54f51900-dc2c-e1c4-3af3-1608b0ead4df,8,4344040,4344079,4346045,4345224,1966,2005,39,0,0,0
4346313,803e82de-7a9e-9031-ff01-73e93ddbd9d1,8,4344017,4344019,4346313,4347390,2294,2296,2,0,0,0
4346316,8ab171e0-e657-1d38-4793-acb12afcc87e,8,4343889,4343899,4346316,4345191,2417,2427,10,0,0,0
4346316,224717f9-9d62-c05d-99e4-8a169c9a3db3,8,4343995,4344019,4346316,4346577,2297,2321,24,0,0,0
4346343,fcb4ee27-c167-dc84-a943-2abd5b95509f,8,4344049,4344079,4346343,4346765,2264,2294,30,0,0,0
4346569,698f3072-05ba-b8a1-973f-7fd5dca9b10a,8,4343886,4343899,4346569,4346048,2670,2683,13,0,0,0
4346634,eb10052a-cead-fe1b-6a7a-4ce68d843ad9,8,4343876,4343899,4346634,4345702,2735,2758,23,0,0,0
4346740,d15a1b21-d2f7-873b-d91d-49fa18acf173,8,4343936,4343959,4346740,4347515,2781,2804,23,0,0,0
4347193,086c030f-f0fd-1ea9-02c2-7f97af6c9a31,8,4343880,4343899,4347193,4347034,3294,3313,19,0,0,0
4347199,0a6246b9-e624-76fe-a044-3dc9459b556f,8,4343891,4343899,4347199,4348585,3300,3308,8,0,0,0
4347563,6c04399d-f466-b44b-57cb-2f2eaa4ed133,8,4346896,4346920,4347563,4347498,643,667,24,0,0,0
4347614,731bd233-c011-c674-928a-77e53a99bbcb,8,4346802,4346860,4347614,4347490,754,812,58,0,0,0
4347660,34cd510f-57e6-9df9-a142-070ef197e38d,8,4346893,4346920,4347660,4347647,740,767,27,0,0,0
4347698,940cbc1d-469a-09ee-422b-a8e9db93db00,8,4346744,4346800,4347698,4347256,898,954,56,0,0,0
4347721,f8bc60bb-9677-3d4c-1a83-7f9e5a3ede12,8,4346954,4346980,4347721,4347326,741,767,26,0,0,0
4347776,3f55f644-f278-b488-25be-290abd4fb6fc,8,4346984,4347040,4347776,4347763,736,792,56,0,0,0
4347823,5bc76084-e9a9-8188-ca27-b91a3a36fc4e,8,4346991,4347040,4347823,4347698,783,832,49,0,0,0
4347921,746a18dc-9990-1c0d-b618-1e8e18360f46,8,4346986,4347040,4347921,4348138,881,935,54,0,0,0
4347966,29c09a85-48c9-5572-0ba4-0fdb105fef51,8,4346810,4346860,4347966,4347382,1106,1156,50,0,0,0
4347933,5728e2b6-912c-4ca9-af9f-504b5fb15849,8,4346966,4346980,4347933,4347729,953,967,14,0,0,0
4348423,d12f4227-e661-b181-46a9-5d1a5955d6c3,8,4346162,4346175,4348423,4348574,2248,2261,73,1,0,0
4348485,c391a132-8626-09ab-418b-6aa27016f6ad,8,4346141,4346175,4348485,4348973,2310,2344,34,0,0,0
4348530,7ed62e8c-44c5-6f6a-65c3-ea24adb94578,8,4346142,4346175,4348530,4347876,2355,2388,33,0,0,0
4348500,75ffb57f-f27d-f93c-481f-af4bfd4454db,8,4346149,4346175,4348500,4349310,2325,2351,26,0,0,0
4348513,cfe4ce7b-2cd2-3623-e3be-6d6c88f25856,8,4346153,4346175,4348513,4348595,2338,2360,22,0,0,0
4348556,b8280725-70e9-8f08-c9f0-9bd6a32785f7,8,4346109,4346115,4348556,4348051,2441,2447,159,1,0,0
4348606,a44d3bc0-0572-257e-3250-d693e3656653,8,4345995,4345995,4348606,4347224,2611,2611,153,1,0,0
4348688,7f12e3cd-b09a-96e3-c00d-ec5e1b6046ee,8,4346051,4346055,4348688,4347765,2633,2637,217,1,0,0
4348678,4d315b7c-c273-973b-39bf-cccad336a508,8,4346064,4346115,4348678,4348005,2563,2614,204,1,0,0
4348999,60ca13d1-32b7-b456-1f22-b19432ce3db1,8,4346168,4346175,4348999,4348356,2824,2831,377,1,0,0
4350073,504d39e0-d4f7-f15f-3e9a-f4fb7afe3780,8,4274844,4274870,4350073,4341939,75203,75229,26,0,0,0
4350240,2f637877-31b7-7072-6e28-b3e95c7e954d,8,4274825,4274870,4350240,4372470,75370,75415,45,0,0,0
4352395,27d49ec5-ed64-6014-e254-c6d16350eff7,8,4351610,4351630,4352395,4352616,765,785,20,0,0,0
4352403,44963381-f190-3205-bdee-5f357b51446a,8,4351570,4351570,4352403,4352417,833,833,0,0,0,0
4352492,18927ebd-b195-6d60-84f3-6ac60bde24e2,8,4349910,4349910,4352492,4352822,2582,2582,389,1,0,0
4352495,6b1b8c03-0b7e-cd79-cc1b-0d55933be58a,8,4351618,4351630,4352495,4352816,865,877,12,0,0,0
4352538,15c18944-b44b-2731-185f-014a29e9efa2,8,4351616,4351630,4352538,4352535,908,922,14,0,0,0
4352571,4580ee86-18ce-5087-253c-e1148d185c2a,8,4351767,4351826,4352571,4352687,745,804,59,0,0,0
4352566,53cbad6c-171d-a14d-dde2-2a23e47c666a,8,4351856,4351886,4352566,4352196,680,710,30,0,0,0
4352600,3f0cd8c9-d98c-9dc3-4b67-2fac298604bc,8,4351804,4351826,4352600,4352463,774,796,22,0,0,0
4352704,4e6120f3-af52-d77c-3243-cee9facd64f1,8,4351846,4351886,4352704,4352275,818,858,40,0,0,0
4352717,836392b7-d9a3-742a-83c2-8870adde98b6,8,4351930,4351946,4352717,4352985,771,787,16,0,0,0
4352889,c1192634-cad3-e250-6a5f-09cb81a603db,8,4349942,4349970,4352889,4352954,2919,2947,477,1,0,0
4352891,aaa54056-7928-913d-51f8-8167796c39ad,8,4351766,4351766,4352891,4352230,1125,1125,185,1,0,0
4353071,0097d5f0-f6be-5f8c-78aa-9c52d6eee772,8,4349965,4349970,4353071,4353073,3101,3106,514,1,0,0
4353138,59f5870d-db2b-ee8a-f688-677da6de041f,8,4349991,4350030,4353138,4353182,3108,3147,668,1,0,0
4353207,859b6ee4-9146-d391-cc25-9a1b240eb222,8,4350034,4350090,4353207,4351839,3117,3173,874,1,0,0
4353211,f0dac80a-57f1-19fb-bd24-e118d428df1c,8,4349998,4350030,4353211,4352684,3181,3213,790,1,0,0
4353458,3a25be44-db98-6cde-3e7b-15a3eefdf1cf,8,4350051,4350090,4353458,4353014,3368,3407,917,1,0,0
4353552,d4d1bf15-ea92-19d4-69e0-d8c3b8e2e864,8,4350070,4350090,4353552,4352182,3462,3482,1023,1,0,0
4353564,e702c0d8-8875-b591-e11d-b469bde85aab,8,4350114,4350150,4353564,4351607,3414,3450,1039,1,0,0
4353720,0a0ef615-f478-3e8d-e2e3-87c2a2e01d59,8,4349979,4350030,4353720,4353712,3690,3741,680,1,0,0
4353985,ec2597eb-9482-20ec-9966-80b38231f16b,8,4351935,4351946,4353985,4353526,2039,2050,71,1,0,0
4354096,7f849eea-c661-e011-f3fc-e192cf8e31a3,8,4351881,4351886,4354096,4353450,2210,2215,5,0,0,0
4354202,3aa74acf-50b4-927c-ab43-bd837c4e1b98,8,4351845,4351886,4354202,4353373,2316,2357,41,0,0,0
4354233,f1fc8f26-466d-19a5-146c-e13089ecde94,8,4351907,4351946,4354233,4355170,2287,2326,39,0,0,0
4354284,bd00ff19-608d-5135-0f19-9b9217b4e6d0,8,4351858,4351886,4354284,4354144,2398,2426,28,0,0,0
4354351,5763c5c0-1934-d49c-81b6-69c67f6c945f,8,4351938,4351946,4354351,4353457,2405,2413,68,1,0,0
4354441,71926dfe-d64d-8f6a-de02-ad35ad0e0e1b,8,4352044,4352066,4354441,4355286,2375,2397,22,0,0,0
4354558,b098a176-ea87-fe7d-63f1-8953ba4ec145,8,4351964,4352006,4354558,4354241,2552,2594,164,1,0,0
4354739,e498446d-38e6-1f15-8dba-2c36fb0100d9,8,4352024,4352066,4354739,4354938,2673,2715,42,0,0,0
4354774,e66aeaff-337c-eef0-2827-67c0ca85a82c,8,4352094,4352126,4354774,4355210,2648,2680,32,0,0,0
4356844,4c6cfc1c-783c-b761-12f3-77fdbe072245,8,4356158,4356199,4356844,4357032,645,686,41,0,0,0
4356915,00d9dc89-0e6d-62f9-988f-00a8e643b83e,8,4356139,4356139,4356915,4356598,776,776,0,0,0,0
4356966,ecfa60c9-83c1-7063-b890-33f0cb041d56,8,4356155,4356199,4356966,4356924,767,811,44,0,0,0
4357020,6c1c0ab6-0f80-34cc-13d2-9821d42de47a,8,4356161,4356199,4357020,4357044,821,859,38,0,0,0
4357050,dc1c4e12-e4ac-1e29-d3c6-756c5a2cfba8,8,4354881,4354881,4357050,4356896,2169,2169,0,0,0,0
4357105,89efa861-bb2b-35a2-7677-7d6d95745ff7,8,4356310,4356331,4357105,4356706,774,795,21,0,0,0
4357150,9b48c6fb-333f-117b-2054-e592101b3c72,8,4356359,4356391,4357150,4357024,759,791,32,0,0,0
4357186,1ca691e1-dda7-c33a-b334-5e5bdca3aa0a,8,4356271,4356271,4357186,4356766,915,915,0,0,0,0
4357206,66c09e7b-741a-a26d-cbca-fbdb54b0f552,8,4356292,4356331,4357206,4356957,875,914,39,0,0,0
4357210,2344f207-f0a1-9255-671e-bf8e979bc54c,8,4356417,4356451,4357210,4357365,759,793,34,0,0,0
4357290,c87533e5-6bcf-d76f-46bf-c38b7b8ae091,8,4356498,4356511,4357290,4357010,779,792,13,0,0,0
4357468,8a81b778-8bf4-d171-0ab5-6e07a167974e,8,4355105,4355162,4357468,4357855,2306,2363,57,0,0,0
4357543,47691dcb-d0c9-dfc1-d13f-24955ebc23bf,8,4355102,4355102,4357543,4357334,2441,2441,0,0,0,0
4357736,d52939e5-3be4-5056-e7ea-6db48802bbd2,8,4355018,4355018,4357736,4358582,2718,2718,0,0,0,0
4357759,a4ba1e5c-f195-dc4c-2ce9-b6cb2d12831f,8,4354890,4354941,4357759,4358803,2818,2869,51,0,0,0
4357884,dea43dfd-29e1-bb4c-f701-f1f4a48f93b4,8,4355118,4355162,4357884,4357451,2722,2766,377,1,0,0
4358039,d14c6d19-ab44-1946-935b-cc84fd030266,8,4355119,4355162,4358039,4357024,2877,2920,507,1,0,0
4358352,31a9b14c-7f49-d0d9-1cc8-1f380c71aae2,8,4355130,4355162,4358352,4356899,3190,3222,736,1,0,0
4358397,96c78cad-304e-d61b-6943-b1548d6eb73f,8,4355123,4355162,4358397,4356933,3235,3274,623,1,0,0
4358719,c2c76cf4-91fd-62b9-72d9-c2b7416a4f9f,8,4355183,4355222,4358719,4357529,3497,3536,803,1,0,0
4359081,d69cd777-4114-a2dc-ec06-2d4a708183ae,16,4353369,4353369,4359081,4359627,5712,5712,0,0,0,0
4359699,809a794c-fa3d-5527-1d9b-a45067f4df95,8,4341058,4341113,4359699,4353394,18586,18641,55,0,0,0
4360373,5953b5d4-2e85-9607-6f62-752490ac7063,8,4358081,4358099,4360373,4360859,2274,2292,18,0,0,0
4360418,2b998363-4e26-6d3f-ab28-efa9959ee77e,8,4358170,4358170,4360418,4361428,2248,2248,0,0,0,0
4360482,4e02ffb3-04bd-d646-d561-2a4ae7a3d3fe,8,4358083,4358099,4360482,4359921,2383,2399,16,0,0,0
4360544,33342b79-7969-748f-2510-f963c5a1faa6,8,4358264,4358290,4360544,4359452,2254,2280,26,0,0,0
4360599,8772a3ba-0d5e-a574-ea8e-81315603534d,8,4358171,4358230,4360599,4360932,2369,2428,59,0,0,0
4360570,16520d40-4605-dd14-ec0c-00473ee5236e,8,4358185,4358230,4360570,4359863,2340,2385,45,0,0,0
4360564,c925f7fa-1484-e9d6-5f8c-2498bcb37ddd,8,4358230,4358230,4360564,4360665,2334,2334,0,0,0,0
4360615,8da72e1a-1b21-eb27-feae-0fb8be56db4c,8,4358176,4358230,4360615,4360782,2385,2439,54,0,0,0
4360667,3a21356c-0fd6-8618-ba6b-295caec9c199,8,4358200,4358230,4360667,4361528,2437,2467,30,0,0,0
4360649,bf2c857e-9f7b-3992-ecec-73f232acf022,8,4358290,4358290,4360649,4360282,2359,2359,0,0,0,0
4362885,d2d07acf-7f1e-6dcc-955d-8f95b1ceb8e6,8,4360580,4360613,4362885,4363584,2272,2305,33,0,0,0
4363046,1f0e523d-9cab-2954-4e2b-952ee58d55cb,8,4360783,4360811,4363046,4363790,2235,2263,28,0,0,0
4363079,796c6ae6-fc19-285d-92d1-3d77da532699,8,4360751,4360751,4363079,4364213,2328,2328,0,0,0,0
4363110,dfe88339-bcbf-7a3d-e5b1-7208243517e0,8,4360759,4360811,4363110,4362707,2299,2351,52,0,0,0
4363132,f3234331-1828-0e61-26de-fcafd9ba9cdb,8,4360816,4360871,4363132,4363045,2261,2316,55,0,0,0
4363172,3a363b3a-8aa7-deb9-a3cb-29bd5c1947e1,8,4360783,4360811,4363172,4363236,2361,2389,28,0,0,0
4363205,64ea7b95-62a1-89fb-57de-b702b026d60a,8,4360864,4360871,4363205,4364132,2334,2341,7,0,0,0
4363227,f2af577d-43c5-27a4-fbc0-2c385e55bd48,8,4360781,4360811,4363227,4362339,2416,2446,30,0,0,0
4363234,cb0a7314-7088-1b5b-4b7e-40bda8efa221,8,4360825,4360871,4363234,4363767,2363,2409,46,0,0,0
4363267,8cf431de-8cdc-6715-5512-a5075f15ee3f,8,4360868,4360871,4363267,4363765,2396,2399,3,0,0,0
4365002,73eb0a4e-0e4b-4dbf-cf41-80b1b7e8b0a4,8,4274854,4274870,4365002,4330905,90132,90148,16,0,0,0
4372787,8f6a201a-589a-691e-276a-7d9aff447459,8,4343891,4343899,4372787,4364610,28888,28896,8,0,0,0
4373894,bc033a02-2d9e-3145-7f5a-c17aa926550e,8,4344413,4344413,4373894,4378666,29481,29481,0,0,0,0
4374597,3c91accc-5538-b109-168e-8bf69f3df699,8,4344956,4344963,4374597,4377873,29634,29641,7,0,0,0
4375199,5739d3a3-7003-3ea7-f54c-e27a34be949b,16,4365799,4365799,4375199,4374738,9400,9400,0,0,0,0
4376422,49a85d9e-dec7-56ca-d020-94d60c3c83d3,8,4346246,4346246,4376422,4361793,30176,30176,430,1,0,0
4377824,e3f9899a-62ba-6966-3388-cf1bd0f383cd,8,4374616,4374657,4377824,4378142,3167,3208,41,0,0,0
4380385,ec202e90-b701-9da2-aa44-7966029e6783,8,4370777,4370777,4380385,4383890,9608,9608,0,0,0,0
4381167,05722bc5-4b5e-4a40-1a5a-897790ba1d38,8,4349769,4349769,4381167,4381012,31398,31398,269,1,0,0
4381574,e7ebff3f-3568-3bea-6e4f-fcf31046eb49,8,4370777,4370777,4381574,4386033,10797,10797,0,0,0,0
4382624,4f418193-e328-9c3a-801c-bac1c5b56b89,8,4349980,4350030,4382624,4377205,32594,32644,679,1,0,0
4382827,e11b2f5a-9f14-256f-ed35-839bf4d62658,8,4370778,4370837,4382827,4388255,11990,12049,59,0,0,0
4382994,b7f156e8-6e31-c7bd-d498-0e1d201cbf3b,8,4352596,4352635,4382994,4373065,30359,30398,39,0,0,0
4383311,6f242a0f-2588-61bb-ad32-a7c68b64612c,8,4370777,4370777,4383311,4382435,12534,12534,0,0,0,0
4383512,6a5e52e1-f20b-db32-1ca8-d3ea77cb751d,8,4370777,4370777,4383512,4381358,12735,12735,0,0,0,0
4383665,5d5b0bd9-0ebf-1523-aaad-89265d9a24cd,8,4370778,4370837,4383665,4384551,12828,12887,59,0,0,0
4384016,258e0162-b287-2686-0de6-d57ecfcd1535,8,4370777,4370777,4384016,4384443,13239,13239,0,0,0,0
4385347,a910c002-ae9f-f41d-feb8-bf0b8775a0f0,16,4281021,4281021,4385347,4343117,104326,104326,0,0,0,0
4385925,54ad2b86-30b8-74e1-6440-4fef984bbbba,8,4382721,4382721,4385925,4384710,3204,3204,0,0,0,0
4386128,cbd93d47-966d-b02f-3d98-03952621b899,8,4274835,4274870,4386128,4420464,111258,111293,35,0,0,0
4386587,efb3eb37-6d57-ffd7-2ea5-f54bfafbb18e,8,4344998,4345023,4386587,4376776,41564,41589,92,1,0,0
4386662,e50c27d4-a9df-bb1d-07a7-611de20da100,8,4344993,4345023,4386662,4401650,41639,41669,30,0,0,0
4386703,d173bd6d-16a0-0e13-9b80-5cc7e2712ff8,8,4344903,4344903,4386703,4389373,41800,41800,0,0,0,0
4386809,ce8437fc-38cd-0ced-ba7b-c404650c5ea2,8,4344960,4344963,4386809,4389158,41846,41849,3,0,0,0
4387016,455f8af7-d21d-637a-d504-882cd6d21f63,8,4344932,4344963,4387016,4398308,42053,42084,31,0,0,0
4387057,da970edb-a841-588d-53b3-4dafcca5ac2e,8,4344950,4344963,4387057,4387671,42094,42107,13,0,0,0
4387365,166e6aeb-7f1e-d1ea-61ab-0704de8e2646,8,4344962,4344963,4387365,4381786,42402,42403,1,0,0,0
4387451,4344c269-7a3d-7b8e-7071-878cb795c127,8,4344947,4344963,4387451,4366467,42488,42504,16,0,0,0
4387542,6b2e258e-afc6-3d34-1dbe-fabd8c881f36,8,4344917,4344963,4387542,4396578,42579,42625,46,0,0,0
4396961,132fdba1-f106-f955-4265-3ccf06ec3c00,16,4323363,4323363,4396961,4374973,73598,73598,0,0,0,0
4398913,51a3dfe4-7962-e5a8-7f7d-7604ebd92165,8,4324340,4324340,4398913,4402340,74573,74573,0,0,0,0
4410366,21366a4d-01a1-296e-bf34-d88926530bd4,16,4404443,4404443,4410366,4411964,5923,5923,0,0,0,0
4411082,1a04409f-37d9-6c58-5902-bf0bba891427,8,4274827,4274870,4411082,4432531,136212,136255,43,0,0,0
4411820,e53b7727-b209-21cd-c73e-45170b4967db,8,4274815,4274870,4411820,4345411,136950,137005,55,0,0,0
4412757,893ba2ae-c5d0-612d-4b1d-b296dfc81033,8,4274811,4274870,4412757,4390634,137887,137946,59,0,0,0
4414218,79edf2d0-ead7-131d-d4ea-18f51a01d224,8,4274850,4274870,4414218,4429147,139348,139368,20,0,0,0
4414752,a864a116-3852-9f46-69a3-618b910ad032,16,4408773,4408773,4414752,4417298,5979,5979,0,0,0,0
4415299,f5b16d2f-e1fc-d171-ca23-792cac553173,8,4274833,4274870,4415299,4419890,140429,140466,37,0,0,0
4434168,bb859153-4918-df40-b3ff-962ec1e81da9,8,4391453,4391475,4434168,4436066,42693,42715,22,0,0,0
4443572,797d3028-85f1-bc46-f473-bdb490ff3e09,8,4391423,4391475,4443572,4435659,52097,52149,52,0,0,0
4446834,6cd27618-bd14-3f78-1b6d-5342e9b2286b,8,4391448,4391475,4446834,4468745,55359,55386,27,0,0,0
4447184,35c87983-910b-77f9-e1ae-25a6f1966b21,8,4444839,4444839,4447184,4446202,2345,2345,0,0,0,0
4447286,aff32a65-0680-9246-c9c7-eb4c58cb5de8,8,4391422,4391475,4447286,4450826,55811,55864,53,0,0,0
4448074,f21dfe36-2c27-d031-d7ef-f6da6cd7f2a3,8,4391415,4391415,4448074,4448088,56659,56659,0,0,0,0
4448101,29ca6e42-d09a-e2dc-a3dd-65b3998549bc,8,4391493,4391535,4448101,4466012,56566,56608,42,0,0,0
4448370,65b63378-a5df-c68a-17c4-8e8e24ebe8de,8,4391448,4391475,4448370,4449844,56895,56922,27,0,0,0
4449247,b19158b4-d4db-9051-2b94-e8fa64f8a4b1,8,4391465,4391475,4449247,4456701,57772,57782,10,0,0,0
4450424,7bdd42e3-26e8-5cb6-ebb7-e6cc067b30d1,8,4447904,4447904,4450424,4450901,2520,2520,0,0,0,0
4450933,12a94f75-d243-3439-4be7-df76713a9af7,8,4391461,4391475,4450933,4432857,59458,59472,14,0,0,0
4451125,584c3ee3-adfe-0110-0bc1-b150367d9aad,8,4391428,4391475,4451125,4463404,59650,59697,47,0,0,0
4458454,829d03f5-567f-fe50-b4c3-13eb7e225d5c,8,4455631,4455677,4458454,4457637,2777,2823,46,0,0,0
4465457,950097ce-28bc-2d51-f1e4-53e6dc50522d,8,4455630,4455677,4465457,4467171,9780,9827,47,0,0,0
4466620,624f88a5-16a0-7b2c-1ddc-a90ae7215e6c,8,4455630,4455677,4466620,4467740,10943,10990,47,0,0,0
4467615,db9b318b-12ba-cc10-9b45-caa9a13ea32a,8,4455622,4455677,4467615,4461800,11938,11993,55,0,0,0
4468135,891887a7-3620-ab79-6fc0-760380cd513e,8,4455618,4455677,4468135,4473924,12458,12517,59,0,0,0
4468137,3f13d74a-5c7f-35ce-fea3-9cb17a4e438d,8,4455613,4455617,4468137,4463339,12520,12524,4,0,0,0
4468278,6086ce8d-123e-a2fb-e95e-17415e48f8b3,8,4455614,4455617,4468278,4464064,12661,12664,3,0,0,0
4468430,9933a462-c058-ec0f-5555-c133c7b30b41,8,4455617,4455617,4468430,4468121,12813,12813,0,0,0,0
4468441,1ab01dc1-39db-7ebb-7538-c985c533af2d,8,4455614,4455617,4468441,4467597,12824,12827,3,0,0,0
4468483,2fad3d7e-a4bf-a846-660a-3bdb002ae6c6,8,4455619,4455677,4468483,4471658,12806,12864,58,0,0,0
4468598,7cd5babe-d0e9-9e5d-4220-f0b6c5035b6c,8,4455613,4455617,4468598,4474997,12981,12985,4,0,0,0
4468616,53d2f38a-ed34-7d55-3673-f569a9305695,8,4455614,4455617,4468616,4472195,12999,13002,3,0,0,0
4468706,f2fb122f-7e34-be79-bc25-d3bd88a72da1,8,4455624,4455677,4468706,4472618,13029,13082,53,0,0,0
4468767,35a02595-cfcb-3ed7-4599-9d7edd354aa4,8,4455639,4455677,4468767,4472633,13090,13128,1256,1,0,0
4468799,b1c72493-4077-3847-9e04-215a9e92b9d9,8,4455627,4455677,4468799,4470719,13122,13172,50,0,0,0
4468878,1f0b2be6-6040-4c51-584f-a41ff9f7852c,8,4455617,4455617,4468878,4472021,13261,13261,0,0,0,0
4468854,81572c3c-df4e-ba91-a450-f04fbae0054d,8,4455618,4455677,4468854,4470377,13177,13236,59,0,0,0
4468932,9e0a294e-c3cc-0aac-2489-41f479a55d6f,8,4455636,4455677,4468932,4472876,13255,13296,41,0,0,0
4469009,492eb70c-2f03-5a0c-6423-421be61aa316,8,4455631,4455677,4469009,4463585,13332,13378,46,0,0,0
4469057,ea176ff6-bccf-45c8-7521-6a991726e178,8,4455626,4455677,4469057,4465384,13380,13431,51,0,0,0
4469039,53332e5d-3ac3-6c05-fa96-a00dcaf6a7d4,8,4455632,4455677,4469039,4470953,13362,13407,45,0,0,0
4469076,a5637759-e10a-bc64-9752-800f42bb7890,8,4455635,4455677,4469076,4470739,13399,13441,42,0,0,0
4469187,c58b8f79-4d71-5e47-01e6-8457f818b7eb,8,4455622,4455677,4469187,4463665,13510,13565,55,0,0,0
4469442,fdce4f12-dc46-76c7-393a-cfff1a2b2339,8,4455621,4455677,4469442,4471252,13765,13821,56,0,0,0
4469602,7f7eedaa-ae01-d882-af9d-cdf04e9720a0,8,4455634,4455677,4469602,4471309,13925,13968,43,0,0,0
4469679,e3164f25-e22f-8d1a-76ec-f3f9735902cf,8,4455627,4455677,4469679,4472498,14002,14052,50,0,0,0
4469789,652fd941-e057-c014-3699-febb228c4f0c,8,4455632,4455677,4469789,4469178,14112,14157,45,0,0,0
4471061,94743809-8717-9af0-a52b-d100e20e22b8,8,4455634,4455677,4471061,4463403,15384,15427,43,0,0,0
4471797,dcbd4d9b-377a-132c-ec89-cea74e1de367,8,4455627,4455677,4471797,4471807,16120,16170,50,0,0,0
4475305,974a2447-ab73-860c-83f0-79b3f78ffd83,8,4455640,4455677,4475305,4471379,19628,19665,8258,1,0,0
4475914,9523175b-c0d5-dc17-61a5-564247d41385,8,4455641,4455677,4475914,4470174,20237,20273,9420,1,0,0
4477489,3e16918f-7648-78d7-6934-3f601ccfb86d,8,4455642,4455677,4477489,4472421,21812,21847,10414,1,0,0
4483005,54b279cd-0c24-8f00-8a4a-07e1234d65cf,8,4401482,4401482,4483005,4510257,81523,81523,0,0,0,0
4485223,0262bf90-3bd8-8e22-cb0f-ab8e9fa4ce21,8,4439401,4439457,4485223,4475631,45766,45822,457,1,0,0
4487577,bfa55677-89a2-9dad-5422-7d6dc454d1a5,8,4454902,4454902,4487577,4483165,32675,32675,0,0,0,0
4491310,1cb04376-c5d6-6362-1b3e-144b6f093f45,8,4439406,4439457,4491310,4471076,51853,51904,452,1,0,0
4493395,d4961e60-2daf-33de-84cc-98eb803f8f00,8,4439398,4439457,4493395,4489837,53938,53997,59,0,0,0
4496487,eb108621-75ec-c919-1de5-388868e57a79,8,4455022,4455081,4496487,4484791,41406,41465,417,1,0,0
4497393,26fb0b0c-a0b5-e6c3-bdcb-3eb2c0c28c41,8,4455069,4455081,4497393,4489761,42312,42324,1170,1,0,0
4497722,4e0d4d6f-f324-a4fd-8f13-72bbdb55667b,8,4455108,4455141,4497722,4489899,42581,42614,1191,1,0,0
4497840,345ec501-df85-a192-d21c-922affa2df47,8,4454740,4454780,4497840,4498822,43060,43100,40,0,0,0
4497954,71fef0ab-381d-02e5-8f73-e0f5497adf42,8,4455021,4455021,4497954,4491323,42933,42933,358,1,0,0
4502810,c01ba459-ec7f-dc2e-fb00-59ff563bf6e0,8,4455196,4455201,4502810,4502156,47609,47614,805,1,0,0
4502881,72f0b90d-5c2f-e996-64ba-aea10cd4ba10,8,4455188,4455201,4502881,4520483,47680,47693,813,1,0,0
4507189,5bd537b1-c35a-dde3-972b-cd8d67fec003,8,4439405,4439457,4507189,4527323,67732,67784,453,1,0,0
4509154,a5571020-cf8b-e199-3a1c-e4164b046117,8,4324482,4324538,4509154,4487843,184616,184672,510,1,0,0
4509476,c9581c41-32bf-07ae-e2d4-c43cde0a6e83,8,4324487,4324538,4509476,4485724,184938,184989,505,1,0,0
4511900,143e77c2-70fe-3e06-76e3-1e8ef67fb352,8,4324478,4324478,4511900,4586383,187422,187422,394,1,0,0
4512484,6295b041-4bfa-f1db-7cff-c54b2351fc3a,8,4454811,4454840,4512484,4495631,57644,57673,29,0,0,0
4513519,da2a4996-aaef-7529-01aa-db8000401b20,8,4454720,4454720,4513519,4538910,58799,58799,401,1,0,0
4516419,ae957e1c-667a-6370-6e12-d25593ca3df0,8,4439397,4439397,4516419,4547045,77022,77022,0,0,0,0
4520301,915fbbf9-53cf-ff73-2384-bb95921409e1,8,4439398,4439457,4520301,4546512,80844,80903,59,0,0,0
4528653,c92c2f78-3768-c08e-4177-497a25987d51,8,4495712,4495763,4528653,4536171,32890,32941,51,0,0,0
4528894,bdcfc42b-8122-a1db-6a6a-58b294568b74,8,4495715,4495763,4528894,4522692,33131,33179,48,0,0,0
4529948,3ecfc25e-c94e-36bf-a89f-d6ce4726d174,8,4495716,4495763,4529948,4524900,34185,34232,47,0,0,0
4530605,46ff19b3-83da-50ff-96e8-9593f8f1e1f4,8,4304630,4304679,4530605,4560686,225926,225975,49,0,0,0
4530726,1b993f82-fdd3-5eea-92d8-8eb166b9ce27,8,4304620,4304679,4530726,4465615,226047,226106,59,0,0,0
4530753,40f62c58-4ac2-ee89-9b80-6a19c11f2240,8,4495703,4495703,4530753,4513463,35050,35050,0,0,0,0
4531167,a2f445e8-5563-1bf4-850f-5739e227d70e,8,4304619,4304619,4531167,4527782,226548,226548,0,0,0,0
4534503,91b6aa01-74e6-0f83-af84-4b8f54f5e2f0,8,4532551,4532551,4534503,4535317,1952,1952,0,0,0,0
4534699,f05ad4ec-33f9-6264-de5e-d279cd2c614b,8,4532703,4532750,4534699,4534245,1949,1996,47,0,0,0
4534724,6db96fa2-6aa7-92a8-72dd-aaea0bb28d6b,8,4532702,4532750,4534724,4534020,1974,2022,48,0,0,0
4535511,de4b2801-38be-318f-96d0-d89df2314c7d,8,4532690,4532690,4535511,4536134,2821,2821,0,0,0,0
4544530,68ec88eb-60d2-642e-a670-af0fc40586bc,8,4304628,4304679,4544530,4442455,239851,239902,51,0,0,0
4544880,e6fe01cc-5553-931a-efd9-d09a8a74a19a,8,4324481,4324538,4544880,4439662,220342,220399,511,1,0,0
4548252,520c31d3-ab65-89eb-b9dc-e742ccea7dd0,8,4324497,4324538,4548252,4498002,223714,223755,495,1,0,0
4548564,bb20fea4-bc89-e2fe-c3ed-fa0e9d620006,8,4324481,4324538,4548564,4549597,224026,224083,451,1,0,0
4548930,0e0f2704-5265-072a-16e5-b746245c92cb,8,4324493,4324538,4548930,4459117,224392,224437,499,1,0,0
4549332,efa5fccb-eb24-4b05-845a-ede243641b12,8,4546168,4546168,4549332,4549119,3164,3164,0,0,0,0
4550065,58c68877-4897-c6e2-1581-f33ea5b38959,8,4324478,4324478,4550065,4648691,225587,225587,0,0,0,0
4550412,7e8f7fe9-163b-7284-b1b2-5b70a0a6e38e,8,4549532,4549574,4550412,4550613,838,880,42,0,0,0
4551214,fb3cd9c8-ebcf-a81a-61f3-b7803a5479ea,8,4324481,4324538,4551214,4456538,226676,226733,511,1,0,0
4552557,dd0cd405-9084-b6de-830a-d57d19fdaf3b,8,4517129,4517129,4552557,4551579,35428,35428,0,0,0,0
4552639,c81e4c13-e4f7-86ab-d40b-d487b188bd6a,8,4379225,4379225,4552639,4537779,173414,173414,0,0,0,0
4559329,aa68a301-734a-f94f-4ab9-e0dff4a3ee30,8,4517180,4517189,4559329,4572598,42140,42149,9,0,0,0
4559736,6855a90d-0f2f-ea57-0883-93111216e243,8,4516912,4516912,4559736,4566316,42824,42824,0,0,0,0
4559874,0ee503e3-298d-4c45-6407-675048107252,8,4517266,4517309,4559874,4573726,42565,42608,43,0,0,0
4560089,c1ef09ec-3c06-c2b3-e170-cfb3357f080b,8,4517230,4517249,4560089,4542520,42840,42859,19,0,0,0
4560430,59b0d399-8dd9-ff68-7611-7bbd0c4fde2e,8,4517360,4517369,4560430,4575468,43061,43070,9,0,0,0
4560778,534b3dbb-7a14-330b-8742-45861034794e,8,4516913,4516972,4560778,4570915,43806,43865,59,0,0,0
4562490,84add36e-67b3-a154-e67a-e19a3c6736b0,8,4517370,4517429,4562490,4545727,45061,45120,59,0,0,0
4565830,3f8f9da4-b98a-953f-fe85-44e1c1b65800,8,4549535,4549574,4565830,4565389,16256,16295,39,0,0,0
4565897,2c9c763b-e454-0286-9dd9-76469d892032,8,4549514,4549514,4565897,4558878,16383,16383,0,0,0,0
4565929,57cad887-b916-7c61-22d0-0779724d3c00,8,4549536,4549574,4565929,4561778,16355,16393,38,0,0,0
4566953,a119ca40-c360-8f0d-eccc-d30e0bf0afdb,8,4549514,4549514,4566953,4558471,17439,17439,0,0,0,0
4567901,20141450-ae22-c5bb-b1c3-6cb3445dc624,8,4530603,4530603,4567901,4557505,37298,37298,0,0,0,0
4574177,a93dbf91-66bb-1d3c-2cad-002a62a765d3,8,4573382,4573382,4574177,4574104,795,795,0,0,0,0
4575696,caad515c-12af-baeb-c91a-c2f241e4d392,8,4516929,4516972,4575696,4581820,58724,58767,43,0,0,0
4578258,b2846e07-4cbe-5d5d-2c24-bc1b30544160,8,4516917,4516972,4578258,4598470,61286,61341,55,0,0,0
4593747,b5bef85b-ec0b-6ca6-dec1-6a3450f35bb4,8,4592962,4592962,4593747,4594098,785,785,0,0,0,0
4594133,e5d0111f-8521-46cd-8e30-0e9c8edb0ef1,8,4593386,4593429,4594133,4594329,704,747,43,0,0,0
4597438,66747987-658e-a17a-0a01-7177756c1d0f,8,4596651,4596651,4597438,4597133,787,787,0,0,0,0
4597829,9d88e7a4-f763-61e6-5f9f-9701b819544a,16,4526746,4526746,4597829,4581092,71083,71083,0,0,0,0
4598447,792f873e-11c8-398a-cf10-ecb56db68f14,8,4597276,4597276,4598447,4598599,1171,1171,0,0,0,0
4610669,fcc6713a-7cbe-08bc-475b-ce8c47054796,8,4581708,4581708,4610669,4611646,28961,28961,0,0,0,0
4610889,4bf1d7a8-b904-2b4e-9f57-1ce3d3a085ec,8,4580828,4580828,4610889,4596539,30061,30061,0,0,0,0
4611343,498ccdd7-ae1b-3c1a-c5e3-8a4e7cde6371,8,4581994,4582046,4611343,4604442,29297,29349,52,0,0,0
4611555,0942f1cd-a7f1-6425-4ced-c55b41365c29,8,4581370,4581370,4611555,4621039,30185,30185,0,0,0,0
4617492,b106c45a-71f6-aee9-1f4a-47062e795ba5,8,4581944,4581986,4617492,4609442,35506,35548,42,0,0,0
4619178,0466b04d-2c0c-9e4b-c920-aae993283178,16,4618171,4618171,4619178,4619629,1007,1007,0,0,0,0
4624220,19664504-6e7e-b978-869d-7b0161f03b99,8,4582260,4582298,4624220,4630565,41922,41960,38,0,0,0
4624617,863e3610-ae7a-e52a-5179-15b7883a5ef5,8,4582230,4582238,4624617,4623487,42379,42387,8,0,0,0
4624753,1138b544-d8c7-8cbe-cd1b-30400f8f2932,8,4582222,4582238,4624753,4643636,42515,42531,16,0,0,0
4625312,af88239f-d4a3-218d-ac08-f40119271805,8,4582398,4582398,4625312,4619429,42914,42914,0,0,0,0
4626071,ad20c3fa-d501-b8d7-50ff-14bf96b525c7,8,4582220,4582238,4626071,4615199,43833,43851,18,0,0,0
4626721,ddbb5298-a575-1dda-2268-1c704eb00c3d,8,4582295,4582298,4626721,4623288,44423,44426,3,0,0,0
4628447,b903b981-ebc7-2f45-94b7-177bc5bbed6c,8,4581926,4581926,4628447,4635523,46521,46521,0,0,0,0
4628780,3b289bee-3ebc-c752-cb4f-e656b6819b33,8,4582178,4582178,4628780,4610194,46602,46602,0,0,0,0
4629045,589a8b9d-5bf2-d6af-8ba2-2d11f5b85c17,8,4582227,4582238,4629045,4646957,46807,46818,11,0,0,0
4633442,78f45889-1e49-c76a-90d5-2b99a2a1a620,8,4625622,4625622,4633442,4631986,7820,7820,0,0,0,0
4645496,299b4130-cafc-bc0e-2b66-201cf21d96e7,16,4644554,4644554,4645496,4645103,942,942,0,0,0,0
4646779,2c20fb0e-e632-ef0a-7ac6-885994f6614e,16,4645633,4645633,4646779,4646298,1146,1146,0,0,0,0
4647239,3473b11a-73a5-24c1-3c8b-c1890d8adcc6,1,4643829,4643871,4647239,4645998,3368,3410,42,0,0,0
4648334,2c1fd0db-689a-5f90-a550-0af12777a40b,16,4646992,4646992,4648334,4648368,1342,1342,0,0,0,0
4649930,3d5e1fbf-f22a-f6f6-d2e4-455c0112ae15,1,4643822,4643871,4649930,4650967,6059,6108,49,0,0,0
4650887,250d235f-1feb-a1e7-3bb1-591b2e832bbe,1,4643813,4643871,4650887,4652667,7016,7074,58,0,0,0
4651162,a2a8d37d-aa22-23a9-7a25-90fcd91218a9,1,4643812,4643871,4651162,4652878,7291,7350,59,0,0,0
4652038,c89a0cbd-cc19-2b50-1e56-a4fbc4e7770d,1,4643823,4643871,4652038,4653447,8167,8215,48,0,0,0
4652193,c22515fe-6f64-ca2b-4aef-9e25c9699ed6,1,4643824,4643871,4652193,4650919,8322,8369,47,0,0,0
4652384,c7569b9b-ca12-7556-f5cc-a86b92e92aa7,1,4643811,4643811,4652384,4650852,8573,8573,0,0,0,0
4652465,9b08725e-e1ea-f0f2-4c52-b95c2146e7b4,1,4643818,4643871,4652465,4648357,8594,8647,53,0,0,0
4652552,f001e73c-f5eb-b7f9-8f52-3f8a905cbe00,1,4643842,4643871,4652552,4649107,8681,8710,29,0,0,0
4652557,d37805ee-204f-cbe4-adec-6f15bfdc2b0d,1,4643840,4643871,4652557,4648255,8686,8717,31,0,0,0
4652645,b0af70d2-4e3e-4f5f-0461-2c712eda833f,1,4643830,4643871,4652645,4655563,8774,8815,41,0,0,0
4653601,02d4729d-d414-cafe-5912-853ea204a093,1,4643811,4643811,4653601,4653770,9790,9790,0,0,0,0
4653801,4087550b-f80b-ba34-f31f-24084d927676,1,4643836,4643871,4653801,4652260,9930,9965,35,0,0,0
4653987,989f5496-53ce-a4c4-e7a1-550cf4fd7fd5,1,4643831,4643871,4653987,4658063,10116,10156,40,0,0,0
4654258,5bf2e8db-7f7e-b2ed-705c-3053b789593e,1,4643837,4643871,4654258,4655925,10387,10421,34,0,0,0
4654747,7fd7559e-44c0-8b4e-acd5-f173904fa87a,8,4650473,4650473,4654747,4653036,4274,4274,0,0,0,0
4654995,6e6c4c64-6f56-21b1-9d07-285b8e8752c2,1,4643841,4643871,4654995,4650591,11124,11154,30,0,0,0
4655087,45358d5a-2249-aa0f-ad58-35f3f87e213c,1,4643845,4643871,4655087,4660498,11216,11242,26,0,0,0
4655218,1eb51009-2f85-f6a6-247d-2d527ee0938e,1,4643838,4643871,4655218,4657187,11347,11380,33,0,0,0
4655333,48c31385-922b-a6f1-d9c1-75fd9e28984f,8,4650500,4650533,4655333,4655028,4800,4833,33,0,0,0
4655548,fb87ebc5-d986-3b5f-93fc-03bc3ef3d085,1,4643837,4643871,4655548,4657669,11677,11711,34,0,0,0
4655592,79150e99-8ed3-1834-fd72-1fc205e0c019,8,4626613,4626613,4655592,4645002,28979,28979,0,0,0,0
4655823,da8f55c4-b310-f0ed-2362-84b8d4a84c96,1,4643840,4643871,4655823,4660738,11952,11983,31,0,0,0
4656129,e322544a-8034-3d4d-58be-184d87e7a66e,1,4643847,4643871,4656129,4659908,12258,12282,24,0,0,0
4657599,199f4960-5716-1810-dbbc-b1d653ea4b54,8,4618775,4618775,4657599,4653253,38824,38824,0,0,0,0
4660495,06ecbbf3-3616-0e06-3ee2-bae3825aac2e,8,4622085,4622085,4660495,4648955,38410,38410,0,0,0,0
4661270,ffdf6588-0ffe-d184-29c4-91dd33dfeff6,8,4660143,4660143,4661270,4660829,1127,1127,0,0,0,0
4661888,1ee5abec-9b53-ca4f-6d09-82b77d76ea43,1,4643827,4643871,4661888,4659175,18017,18061,44,0,0,0
4662697,3c6bad34-94fc-712b-5567-cd27b4664f33,1,4643812,4643871,4662697,4662506,18826,18885,59,0,0,0
4663069,aad74fe0-5f48-087e-e0e6-60c2b477caf7,8,4659909,4659952,4663069,4663379,3117,3160,43,0,0,0
4664012,0043384a-f987-8ca6-5f2e-621e930951a6,8,4659894,4659952,4664012,4664425,4060,4118,58,0,0,0
4664077,116f176a-755d-2764-4bc6-fdb98a497bbd,1,4643825,4643871,4664077,4660607,20206,20252,46,0,0,0
4664303,a4960505-032e-aa56-1d5a-c38c690dc911,1,4643827,4643871,4664303,4657698,20432,20476,44,0,0,0
4665001,0409b7c8-ef59-a4b5-2e89-015e92f765e7,8,4659908,4659952,4665001,4666579,5049,5093,44,0,0,0
4665385,6f6afbe1-6dec-0f06-bc45-0b7c7f6d19a8,1,4643829,4643871,4665385,4664632,21514,21556,42,0,0,0
4665565,9a77c01f-85af-b75b-e4c4-607130aaa9ae,1,4643815,4643871,4665565,4670405,21694,21750,56,0,0,0
4665686,8f6a9f1b-ad82-64e3-8eeb-2a03f676831f,1,4643812,4643871,4665686,4663403,21815,21874,59,0,0,0
4665879,f99003d8-cad4-13f4-9e68-9a6c91c98ab6,1,4643818,4643871,4665879,4661498,22008,22061,53,0,0,0
4665944,e3e7589e-4bef-82f1-3467-73fbe2908a40,1,4643822,4643871,4665944,4664840,22073,22122,49,0,0,0
4666156,9cb84018-1c79-8fe1-97ff-96423d40f9b0,1,4643844,4643871,4666156,4661051,22285,22312,27,0,0,0
4666481,9bc27450-a3a9-0472-3002-0f5e8a5acb4d,1,4643833,4643871,4666481,4665114,22610,22648,38,0,0,0
4666524,dcaeedcd-67d7-7873-0f7b-524587aa2080,1,4664042,4664072,4666524,4667211,2452,2482,30,0,0,0
4666538,aaef0591-3fd1-80e5-50a6-eb2200c65ec8,1,4664057,4664072,4666538,4665684,2466,2481,15,0,0,0
4666566,0eba92ac-2d26-4022-3bd7-6e1fadeeb23b,1,4664041,4664072,4666566,4665819,2494,2525,31,0,0,0
4666712,52949fbd-1243-1159-1df5-6402492ca612,1,4643820,4643871,4666712,4665314,22841,22892,51,0,0,0
4666789,f0c935a9-91c3-d637-7ca5-013cf6b896c2,1,4664054,4664072,4666789,4667279,2717,2735,18,0,0,0
4666870,b4c21dd6-2ed1-8d37-f63f-a63fa1d29dff,1,4664041,4664072,4666870,4666346,2798,2829,31,0,0,0
4666878,d3d17709-a54c-f489-0fdb-a768e9390c7f,1,4664047,4664072,4666878,4666372,2806,2831,25,0,0,0
4666887,9fc2e952-4e0b-ec8f-a07d-4d6c01d0468c,1,4664060,4664072,4666887,4666884,2815,2827,12,0,0,0
4666986,39385322-537e-95ed-57ea-efa6299a19fb,1,4643814,4643871,4666986,4658141,23115,23172,57,0,0,0
4666952,8b41bcd9-3182-1fde-562f-62e88a0bb8e4,1,4664043,4664072,4666952,4665947,2880,2909,29,0,0,0
4666938,0ce06819-24c6-1f93-a081-9bf56940240c,1,4664059,4664072,4666938,4667009,2866,2879,13,0,0,0
4667001,5cc7127a-2b14-8354-c767-364495a1dc98,1,4664052,4664072,4667001,4667205,2929,2949,20,0,0,0
4667008,8f0f7109-fddb-eb80-7e99-cb58b601efce,1,4664054,4664072,4667008,4666809,2936,2954,18,0,0,0
4667026,82ee6e08-0ba9-ee1e-7588-8aa1f9e33543,1,4664061,4664072,4667026,4666023,2954,2965,11,0,0,0
4667382,2ddecd40-e1de-c31a-cdd9-f251abc90bba,1,4643835,4643871,4667382,4676914,23511,23547,36,0,0,0
4667463,38059440-2642-765f-c772-fdb6b3d42f8a,1,4643846,4643871,4667463,4672499,23592,23617,25,0,0,0
4668275,d3c8acca-3615-ede4-2bf3-074375987f10,1,4664053,4664072,4668275,4667219,4203,4222,19,0,0,0
4668315,29568d7d-d57e-4322-0396-63d0133ee71e,1,4664043,4664072,4668315,4668664,4243,4272,29,0,0,0
4668422,5a6d4596-3580-17d6-3ece-ff5e917f61b3,1,4664049,4664072,4668422,4666580,4350,4373,23,0,0,0
4668522,38dd9a5e-dd9e-ae73-89c7-0e189eb88096,8,4652306,4652306,4668522,4676416,16216,16216,0,0,0,0
4669304,7a761f37-e1a0-6de2-f6de-974a6d9d5598,1,4664041,4664072,4669304,4668885,5232,5263,31,0,0,0
4669311,bce4d414-a7ff-3051-ae8b-3239311d3751,1,4664045,4664072,4669311,4671386,5239,5266,27,0,0,0
4669325,7d2e11bd-1708-f96e-f176-2fbdc37114e3,1,4664059,4664072,4669325,4668273,5253,5266,13,0,0,0
4669412,702adf3b-7cbf-66b4-f8e7-4535a9a45be4,1,4664045,4664072,4669412,4667558,5340,5367,27,0,0,0
4669397,57ff5548-1d28-67a0-ad84-5afe38c77dca,1,4664048,4664072,4669397,4670475,5325,5349,24,0,0,0
4669469,df30f2f5-3226-786f-8595-30c1a1295a39,1,4643834,4643871,4669469,4677704,25598,25635,37,0,0,0
4669430,cf460215-1225-33fd-765e-3ce808676b2a,1,4664052,4664072,4669430,4671587,5358,5378,20,0,0,0
4669508,babfbd99-2d9d-4bd8-aeb2-f98cdb38c2f2,1,4664041,4664072,4669508,4671577,5436,5467,31,0,0,0
4669572,4138aeea-8988-7d52-7599-d4751b139a48,1,4664049,4664072,4669572,4669869,5500,5523,23,0,0,0
4670018,1192e4dc-c99a-9a60-dfb4-6e9e15490c7e,1,4664059,4664072,4670018,4672862,5946,5959,13,0,0,0
4672766,a6e62c01-8529-e74f-7c48-13d916c60b3d,8,4671982,4671982,4672766,4672498,784,784,0,0,0,0
4673252,40328c40-b100-0314-b77c-ff4c99252280,8,4672466,4672466,4673252,4673148,786,786,0,0,0,0
4678254,7455c604-fee9-31f4-582d-45dc38e6a21b,8,4651064,4651080,4678254,4690734,27174,27190,16,0,0,0
4680441,0c975601-97b1-afbd-43bc-bd124e9dfdb6,8,4651064,4651080,4680441,4674023,29361,29377,16,0,0,0
4681559,72e27aa8-f081-eaef-3320-66bf006083dd,8,4634403,4634403,4681559,4670842,47156,47156,0,0,0,0
4682386,5dc228d3-ab91-dd71-ba0d-24f5cff54357,8,4659898,4659952,4682386,4687455,22434,22488,54,0,0,0
4682449,bc221d90-2edb-7916-22b9-4234eeda2259,8,4659892,4659892,4682449,4687155,22557,22557,0,0,0,0
4682536,6b775489-16ca-7742-f0e5-2458e2832379,8,4659899,4659952,4682536,4676090,22584,22637,53,0,0,0
4682662,d1c1f266-ce9c-a015-c7c4-0854d6d4eb06,8,4681885,4681885,4682662,4682526,777,777,0,0,0,0
4683573,c148e224-6340-4548-e078-8722adef8e74,8,4651064,4651080,4683573,4696284,32493,32509,16,0,0,0
4683575,1a950f3e-bd84-b6da-a266-04f3c9afd545,8,4682404,4682446,4683575,4684018,1129,1171,42,0,0,0
4683794,c5ee154f-6c3f-fefb-47ba-1cc7c58e411e,8,4682848,4682848,4683794,4683598,946,946,0,0,0,0
4684105,8e2a4c5a-97d5-4683-69c7-c2dd77e42950,8,4682887,4682908,4684105,4684563,1197,1218,21,0,0,0
4684133,41431647-0aad-04b7-d3a2-b6cb3f3753af,8,4682893,4682908,4684133,4684408,1225,1240,15,0,0,0
4684136,f275de56-4e18-dcc7-33fe-09e708fd4865,8,4682893,4682908,4684136,4684289,1228,1243,15,0,0,0
4684192,15604ec8-1ca9-31d9-e5bf-13792587f6a0,8,4682888,4682908,4684192,4683999,1284,1304,20,0,0,0
4684232,99786dc1-5f54-d82d-53e1-1f554289281d,8,4682863,4682908,4684232,4684536,1324,1369,45,0,0,0
4684345,44fbb5b9-c9e5-a194-f746-682ad4e73adb,8,4682885,4682908,4684345,4683988,1437,1460,23,0,0,0
4684313,572d3274-e5c2-2467-4107-e87337f66fc4,8,4682891,4682908,4684313,4684317,1405,1422,17,0,0,0
4684459,4bf66063-8b91-7e2d-aaf9-ee3ee432d37d,8,4682867,4682908,4684459,4683698,1551,1592,41,0,0,0
4684715,c23e471a-6081-8fb2-755e-b3647da38784,8,4682884,4682908,4684715,4685455,1807,1831,24,0,0,0
4685630,e877a70d-692f-e76c-1a20-4dcc4ae8e236,8,4651064,4651080,4685630,4688758,34550,34566,16,0,0,0
4685688,eb7fb03e-d14c-70b7-50ac-2a6d3bdad4ac,8,4684701,4684733,4685688,4686098,955,987,32,0,0,0
4685912,ae57927f-730c-ce0e-d6f9-92984634a5f6,8,4684687,4684733,4685912,4685596,1179,1225,46,0,0,0
4685979,e2abe6e3-72f3-4ed1-f163-ebe1b6dd5f35,8,4684749,4684793,4685979,4685396,1186,1230,44,0,0,0
4686014,caea5bfb-3f70-a1b2-3206-9ba39561a574,8,4684673,4684673,4686014,4686112,1341,1341,0,0,0,0
4686105,cf03c9ad-72d5-68d4-1ed6-d4366cfc3638,8,4684749,4684793,4686105,4685561,1312,1356,44,0,0,0
4686250,d5d19277-0418-cd27-9a78-ceed9708094c,8,4684769,4684793,4686250,4686729,1457,1481,24,0,0,0
4686291,0d0d13d3-779e-e83d-36df-223906bc0d71,8,4684701,4684733,4686291,4686613,1558,1590,32,0,0,0
4686333,fe13d91c-183e-5726-9ea8-428428d30ca3,8,4684728,4684733,4686333,4686159,1600,1605,5,0,0,0
4686368,5ef993c3-07d7-afec-5d34-a21912990cb3,8,4684734,4684793,4686368,4686441,1575,1634,59,0,0,0
4686391,79e49119-ca6e-dd5a-46df-90fbbb01e392,8,4684750,4684793,4686391,4685830,1598,1641,43,0,0,0
4687324,5dcf19aa-bb3d-c51c-b893-dae943ab6168,8,4686039,4686069,4687324,4687295,1255,1285,30,0,0,0
4687339,69f6a8cb-42ac-dbbb-d328-bb735234967d,8,4685929,4685949,4687339,4687391,1390,1410,20,0,0,0
4687343,24ea2f78-24fa-350e-ec70-d93aa260f227,8,4686034,4686069,4687343,4687207,1274,1309,35,0,0,0
4687356,6a0e99b2-1c94-d5c6-89ed-4d64b984933d,8,4686065,4686069,4687356,4686983,1287,1291,4,0,0,0
4687551,03cfaa49-e80a-c6e7-10c8-f7c928f93da0,8,4685889,4685889,4687551,4686785,1662,1662,0,0,0,0
4687581,dfd87a1b-8038-593f-3a25-9e6556c26218,8,4685890,4685949,4687581,4686883,1632,1691,59,0,0,0
4687550,b6315c55-0ca3-e980-ec95-575283c2539c,8,4686068,4686069,4687550,4687118,1481,1482,1,0,0,0
4687632,a37ae656-2a03-1bf9-da4d-4948435bfa43,8,4685910,4685949,4687632,4688316,1683,1722,39,0,0,0
4687703,01183a0a-b908-b9f4-7d24-28d4e8eca39b,8,4686059,4686069,4687703,4687471,1634,1644,10,0,0,0
4688112,aadbb2fc-9331-653d-1b36-84b41b13a85f,8,4686089,4686129,4688112,4687500,1983,2023,40,0,0,0
4688919,7e34edc3-dbe9-664c-f6b2-41f316f2af16,8,4687677,4687703,4688919,4689276,1216,1242,26,0,0,0
4688943,d8060ff5-059b-b77b-d921-0c645299607c,8,4687670,4687703,4688943,4689392,1240,1273,33,0,0,0
4688982,0823e20b-08ff-7421-c76e-e7c026c53162,8,4687560,4687583,4688982,4689228,1399,1422,23,0,0,0
4689021,ef3cfc8f-5e58-e27a-9256-fa39e5b6ead0,8,4687703,4687703,4689021,4689536,1318,1318,0,0,0,0
4689154,40d6c0ac-82ab-fb8d-69fc-339fe9dcbdd1,8,4687562,4687583,4689154,4688840,1571,1592,21,0,0,0
4689267,b3fce44c-942a-9c09-7b32-99df50833557,8,4687675,4687703,4689267,4689907,1564,1592,28,0,0,0
4689314,361f448c-cb53-c44a-5126-28f2978bd951,8,4687675,4687703,4689314,4689616,1611,1639,28,0,0,0
4689331,d08ef8b5-c556-f034-b177-3184a3d2e30b,8,4687523,4687523,4689331,4689573,1808,1808,0,0,0,0
4689423,313e59a2-f546-f5ee-d999-6d9d61eb8774,8,4687660,4687703,4689423,4689511,1720,1763,43,0,0,0
4689479,6789278d-cc86-ac85-4212-173f5e997f0d,8,4687707,4687763,4689479,4689279,1716,1772,56,0,0,0
4689856,3918d757-1b62-5489-b94e-52be346b544c,8,4594450,4594450,4689856,4701672,95406,95406,0,0,0,0
4690239,b1b8106d-e27e-9a13-022b-2e42cc1e713d,8,4594473,4594510,4690239,4698916,95729,95766,37,0,0,0
4690415,56885791-8f92-c2c3-2727-aea402f93785,8,4594456,4594510,4690415,4663823,95905,95959,54,0,0,0
4692216,72f4c4b3-453a-2e55-6fe2-43b3828648b4,8,4690890,4690938,4692216,4691653,1278,1326,48,0,0,0
4692217,05a562a9-6cc7-3151-1172-44f793645e43,8,4690878,4690878,4692217,4691722,1339,1339,0,0,0,0
4692331,4ba9008d-85af-b680-e39f-6cc716f39bed,8,4691054,4691058,4692331,4691799,1273,1277,4,0,0,0
4692454,28018e89-0f94-e2f9-4296-8a4a53398474,8,4691034,4691058,4692454,4692322,1396,1420,24,0,0,0
4692471,3094f256-7420-2299-2ad2-85f1607e683f,8,4691159,4691178,4692471,4693006,1293,1312,19,0,0,0
4692591,16f89d97-0795-7c4a-162f-bcea7551eb4f,8,4691144,4691178,4692591,4693200,1413,1447,34,0,0,0
4692619,9814697c-9c02-5145-968f-86586800155d,8,4690915,4690938,4692619,4692915,1681,1704,23,0,0,0
4692655,bbf7f858-2dbb-3bdf-2f23-4d87dc383057,8,4691209,4691238,4692655,4693113,1417,1446,29,0,0,0
4692887,129f9fa5-3b6a-38cf-e0df-542da5b813c2,8,4690949,4690998,4692887,4692201,1889,1938,49,0,0,0
4693047,4056c9bd-bdc2-7e8f-b142-b54e5fd62bb0,8,4691117,4691118,4693047,4693026,1929,1930,1,0,0,0
4693246,ae1c64c6-9efd-a9e9-e1dd-2f7f00c976e5,8,4691836,4691836,4693246,4693553,1410,1410,0,0,0,0
4693291,2eeaf8b3-f3e5-118a-ab0d-bf1175770452,8,4691726,4691774,4693291,4692534,1517,1565,48,0,0,0
4693290,ee38a9e9-f377-071a-28e6-a63b4fc34028,8,4691928,4691965,4693290,4693424,1325,1362,37,0,0,0
4693352,63cd0cb1-a7b3-b6f9-1358-96aae2751ce6,8,4691717,4691774,4693352,4692896,1578,1635,57,0,0,0
4693333,6e659294-876d-732a-e4a3-482f37c783d1,8,4691719,4691774,4693333,4692978,1559,1614,55,0,0,0
4693426,1feb1cf5-7dcb-e113-039f-f46b194274cf,8,4691714,4691714,4693426,4693221,1712,1712,0,0,0,0
4693418,a6f7b85d-591a-91ea-38e2-aae3633ad91a,8,4692009,4692025,4693418,4693428,1393,1409,16,0,0,0
4693432,af003b94-596c-9252-7039-035691a4d3a5,8,4691929,4691965,4693432,4693847,1467,1503,36,0,0,0
4693636,2bf23fc0-7393-9a80-a783-621808dc05ef,8,4691905,4691905,4693636,4692893,1731,1731,0,0,0,0
4693662,ad2654a4-8733-0652-dc01-ef9d881cf24c,8,4691716,4691774,4693662,4693087,1888,1946,58,0,0,0
4697546,97967ef5-6cc0-1241-ea33-6701445ab4a6,8,4594503,4594510,4697546,4659637,103036,103043,7,0,0,0
4699253,b4c70241-990c-b8bf-c197-8cb867218261,8,4651064,4651080,4699253,4675604,48173,48189,16,0,0,0
4702123,e9faa206-7ad7-9ad5-c2dc-09c180ade83c,8,4699662,4699662,4702123,4701924,2461,2461,0,0,0,0
4702209,3b8ee0e0-1ba3-4c18-684a-05d0b6f8dba9,8,4698045,4698045,4702209,4701934,4164,4164,0,0,0,0
4702237,066208b6-96dd-4b80-a078-6e8f54909f0a,8,4698096,4698105,4702237,4702389,4132,4141,9,0,0,0
4702641,9ea56510-4aa4-b837-7d9e-3bb20853d212,8,4699664,4699722,4702641,4703033,2919,2977,58,0,0,0
4702737,8a38ef1d-015d-441f-8e22-0c2dea771919,8,4699666,4699722,4702737,4702724,3015,3071,56,0,0,0
4703389,5636d3b7-c069-47d3-72cd-fdd02e616bd7,8,4699670,4699722,4703389,4703374,3667,3719,52,0,0,0
4704449,dc247a02-286c-b3e0-02b5-166d0f3cc54f,8,4659905,4659952,4704449,4725652,44497,44544,47,0,0,0
4704510,c1ed3940-610d-a84a-34a4-ed3c7f0643ea,8,4659906,4659952,4704510,4689732,44558,44604,46,0,0,0
4705588,94f319ac-1938-bfc7-4224-91e981e02a64,8,4659895,4659952,4705588,4692381,45636,45693,57,0,0,0
4706022,c5404be9-e6d5-9568-3695-6a3815280e7c,8,4651064,4651080,4706022,4697545,54942,54958,16,0,0,0
4711068,b41287fb-6d08-5507-7262-c8cb5af7233a,8,4651064,4651080,4711068,4728743,59988,60004,16,0,0,0
4713211,ddc55228-38e1-e998-ddca-9cc3d48f16c5,8,4697638,4697638,4713211,4708393,15573,15573,0,0,0,0
4713525,57988711-e602-8d06-b441-a695ece321fd,8,4697687,4697698,4713525,4707750,15827,15838,11,0,0,0
4716948,d3c0331b-c002-c999-cfb3-0320e9bdb511,8,4700684,4700684,4716948,4714409,16264,16264,0,0,0,0
4720259,922e3abc-7ada-31a6-7c2a-5ca20c921749,8,4660541,4660555,4720259,4749462,59704,59718,14,0,0,0
4720500,75d0a2af-1c06-efa6-521b-a1e492e7fc57,8,4660532,4660555,4720500,4694463,59945,59968,23,0,0,0
4720569,5c253a40-ba76-96f5-ca69-35bdc89eb2f2,8,4660537,4660555,4720569,4725858,60014,60032,18,0,0,0
4723062,20b6a33c-15d3-24dc-0dc4-aa1006062b52,8,4660530,4660555,4723062,4748584,62507,62532,25,0,0,0
4723169,590bbfbc-0160-c1c4-0ff8-a84c008ba779,8,4660541,4660555,4723169,4733920,62614,62628,14,0,0,0
4723388,44f2a0db-b20c-651e-0d47-7c015e61df62,8,4660530,4660555,4723388,4695212,62833,62858,25,0,0,0
4723677,7a52cd11-cb32-32ab-b5e9-fa216fef2a24,8,4715045,4715045,4723677,4722149,8632,8632,0,0,0,0
4724581,20793a98-f94c-9458-9aff-badc7754cdfc,8,4660533,4660555,4724581,4723443,64026,64048,22,0,0,0
4727850,f0582911-0499-9aeb-d8b6-a5b0c7c22f1b,8,4703395,4703449,4727850,4733852,24401,24455,54,0,0,0
4730197,3fa1292a-507b-bb8e-6bd6-f68435073a4e,16,4728279,4728279,4730197,4729935,1918,1918,0,0,0,0
4731067,516bbc7b-7c96-cc00-1903-0a15376d65f7,8,4729679,4729737,4731067,4730907,1330,1388,58,0,0,0
4731387,bc1af663-a096-ea2f-bc58-196e2064774f,8,4729624,4729677,4731387,4731493,1710,1763,53,0,0,0
4731660,0d1d5dbc-7500-56ea-3657-e50a469b4fde,8,4729655,4729677,4731660,4731133,1983,2005,22,0,0,0
4731824,13b8fad4-1ed7-cc8a-a0f1-963a0269b71b,8,4729617,4729617,4731824,4731441,2207,2207,0,0,0,0
4731874,99adf607-c26e-3dbd-9acb-0045a449aefa,8,4729672,4729677,4731874,4731535,2197,2202,5,0,0,0
4731942,944af6a6-83c1-4496-199a-2509203201a2,8,4729641,4729677,4731942,4731064,2265,2301,36,0,0,0
4731924,fb81519b-ddc9-69b0-689e-77e54f304094,8,4729647,4729677,4731924,4732880,2247,2277,30,0,0,0
4732011,0daba507-1fc7-737c-b94e-b6f89d506e83,8,4729682,4729737,4732011,4732834,2274,2329,55,0,0,0
4732333,5ebbb87b-afba-5ddc-c81c-597a9ba1cbe2,8,4729660,4729677,4732333,4733018,2656,2673,17,0,0,0
4732515,6cdb930c-dc87-885e-8f6e-1e3025d6ad40,8,4729667,4729677,4732515,4733123,2838,2848,10,0,0,0
4735675,b85acaf0-d7fd-6197-f750-6c46ddd0bcc0,8,4734005,4734038,4735675,4735926,1637,1670,33,0,0,0
4735690,020359c1-941e-22e9-f492-12e96cc1bd55,8,4734005,4734038,4735690,4735870,1652,1685,33,0,0,0
4735748,36a7581e-4f17-1a4e-e2d9-79705115898b,8,4734025,4734038,4735748,4735034,1710,1723,13,0,0,0
4735848,8b5b73df-d701-8ade-04a0-c5990fab3b92,8,4733995,4734038,4735848,4735645,1810,1853,43,0,0,0
4736025,efef1246-16d4-f2f7-3b6b-c3b774309740,8,4733984,4734038,4736025,4736339,1987,2041,54,0,0,0
4736154,f83f136d-d768-4211-6aed-5760d75b6911,8,4734192,4734218,4736154,4735860,1936,1962,26,0,0,0
4736263,5ef75904-b1d9-4480-0caf-014434b51e65,8,4733978,4733978,4736263,4737229,2285,2285,0,0,0,0
4736279,e245ed74-e9d5-6e55-fee6-6950e1b340ee,8,4734042,4734098,4736279,4735174,2181,2237,56,0,0,0
4736361,7609c580-2fd4-6a8e-e5d0-6bcf596d88dc,8,4734127,4734158,4736361,4737069,2203,2234,31,0,0,0
4736524,7453c9c3-8ebc-02b1-3866-5e813ff1254b,8,4734007,4734038,4736524,4736328,2486,2517,31,0,0,0
4739004,03305744-9ae4-16ba-0228-62c4b7ab7799,8,4710021,4710021,4739004,4743688,28983,28983,0,0,0,0
4739902,c6991c22-be14-6c81-833b-b2f3e9972938,8,4738072,4738072,4739902,4740730,1830,1830,0,0,0,0
4740003,445f1ad1-b801-2d83-faea-50545fb56c40,8,4738139,4738139,4740003,4740703,1864,1864,0,0,0,0
4740059,2b36b6f5-a2b3-ee1b-d1aa-0c74f9449817,8,4738157,4738199,4740059,4739994,1860,1902,42,0,0,0
4740055,72a4bac6-9288-88f6-4c38-f15a66a247b7,8,4738166,4738199,4740055,4739924,1856,1889,33,0,0,0
4740015,7ef86974-ffb0-f027-1ca3-d15acad743d3,8,4738189,4738199,4740015,4740699,1816,1826,10,0,0,0
4740048,b04dee79-4ff6-308a-9135-6bfe6193dc3d,8,4738237,4738259,4740048,4739913,1789,1811,22,0,0,0
4740268,a9e7bb4f-a0b8-bebf-b82b-2b9310404bf3,8,4738292,4738319,4740268,4740861,1949,1976,27,0,0,0
4740296,3ad782dc-8dc8-ad97-699e-5dc9cae33dbb,8,4738355,4738379,4740296,4739682,1917,1941,24,0,0,0
4740434,b99eec19-ac0f-a13a-8332-d1b9f42d157f,8,4738239,4738259,4740434,4739905,2175,2195,20,0,0,0
4740463,d9f0fa1f-c2a1-ea12-89ce-ab51a79a80da,8,4738238,4738259,4740463,4739529,2204,2225,21,0,0,0
4743566,cf92bd95-9b48-d302-7d2b-87148de0b52a,8,4730588,4730588,4743566,4744344,12978,12978,0,0,0,0
4744362,ff2c37dc-6bfc-abd7-9831-3d758b719ba7,16,4739475,4739475,4744362,4743247,4887,4887,0,0,0,0
4744818,b64a46f5-eb6d-b35f-2950-94bbf3c8e316,8,4683679,4683693,4744818,4760307,61125,61139,14,0,0,0
4745438,477ab887-4ae3-ba94-3020-366c7a7634b5,32,4713966,4713966,4745438,4746677,31472,31472,0,0,0,0
4754836,cd766247-e4ac-da19-6413-93ca3c87b498,8,4743928,4743928,4754836,4751160,10908,10908,0,0,0,0
4755782,05bcde63-f667-a91a-71c7-ebf1f9dbe07e,8,4731255,4731255,4755782,4754254,24527,24527,0,0,0,0
4762807,6025cf7c-4966-055e-98a8-a428266ecb23,8,4762024,4762024,4762807,4762814,783,783,0,0,0,0
4763217,cfea3a8f-7b8d-b32f-39f7-113dba9bb777,8,4762493,4762493,4763217,4762865,724,724,0,0,0,0
4763369,a15c6648-d355-441e-3e3f-9b1ec29295fd,8,4752135,4752135,4763369,4758917,11234,11234,0,0,0,0
4763883,0a9c4b09-7e1d-890f-7bac-9b448af0744c,8,4751989,4752040,4763883,4768935,11843,11894,51,0,0,0
4764017,e90c961c-c172-64d8-a6a2-1998afad738e,8,4763188,4763236,4764017,4763774,781,829,48,0,0,0
4764444,4b662fe0-c789-3c91-0ea5-102b2a14eafd,8,4763730,4763730,4764444,4764362,714,714,0,0,0,0
4766313,2d598b9d-b3e3-f68f-afce-09490dd1db5f,8,4751984,4752040,4766313,4761733,14273,14329,56,0,0,0
4768124,2e095630-d7b4-2669-d42c-ef0517fc87fd,8,4669989,4669989,4768124,4766617,98135,98135,0,0,0,0
4768215,2700b560-9bd8-9990-b786-834b39c1801b,1,4759437,4759437,4768215,4766704,8778,8778,0,0,0,0
4769495,30794bd3-4ba4-08a8-d15d-4c4315678e9b,8,4752138,4752195,4769495,4765614,17300,17357,57,0,0,0
4770408,92fcbafc-4501-a390-b249-c3c8a18e1a64,1,4758864,4758864,4770408,4775232,11544,11544,0,0,0,0
4771746,ecea934f-263d-979a-03ba-c96e3c8f5a90,8,4770968,4770968,4771746,4771477,778,778,0,0,0,0
4772158,13131048-93b3-f363-d307-32958326c2dd,8,4771433,4771435,4772158,4772289,723,725,2,0,0,0
4773218,275ac9d6-0b9f-97a5-5510-f78642004a56,8,4751982,4752040,4773218,4767153,21178,21236,58,0,0,0
4773712,1cd6cf0d-e228-d8e4-e964-f172a9a9bd76,8,4745228,4745228,4773712,4763069,28484,28484,0,0,0,0
4778956,dad2e66e-8da4-ced1-1423-040dfa4fa66c,8,4763784,4763790,4778956,4786361,15166,15172,6,0,0,0
4780515,5bf99857-c8cd-a671-c91d-bf0780e2811b,8,4752138,4752195,4780515,4781070,28320,28377,57,0,0,0
4780611,e4cfb2f3-9fc6-ea49-444a-bb9a251356e1,8,4752138,4752195,4780611,4775591,28416,28473,57,0,0,0
4782851,b9175922-18c6-a4ff-e3eb-ebd71e65ca50,8,4768179,4768184,4782851,4783444,14667,14672,5,0,0,0
4784542,685a9a7c-b83f-34ca-79a0-d586369db2ef,1,4777743,4777759,4784542,4782978,6783,6799,16,0,0,0
4784795,af826da0-5a18-f557-8f24-73da4141c9c5,8,4752135,4752135,4784795,4777696,32660,32660,0,0,0,0
4789798,d094805e-1668-e9f8-820f-46424e6cebb2,8,4751980,4751980,4789798,4790847,37818,37818,0,0,0,0
4790068,83c7f1d9-a3d7-ad9b-a9b2-97702aaa9394,8,4751992,4752040,4790068,4780176,38028,38076,48,0,0,0
4790385,2046eeb5-9888-d27b-b1e5-2a9006506312,1,4788279,4788332,4790385,4789442,2053,2106,53,0,0,0
4790427,6595fa90-4584-b215-0e30-20b68815251c,8,4751985,4752040,4790427,4771751,38387,38442,55,0,0,0
4790505,1fac6d85-c433-c4f0-1683-541bd1801014,8,4751986,4752040,4790505,4785702,38465,38519,54,0,0,0
4790940,725d71f1-836a-2e1d-38f5-3fd1a711fd90,1,4787683,4787683,4790940,4790999,3257,3257,0,0,0,0
4791113,7e35cb46-7b76-9a50-e549-84aef3e205de,8,4751993,4752040,4791113,4772692,39073,39120,47,0,0,0
4791811,f3762c9c-7a03-0894-5cac-d5a685fad950,8,4648805,4648805,4791811,4848312,143006,143006,0,0,0,0
4792116,613c9847-19ec-4e51-1d9d-dee1e09189f1,8,4752135,4752135,4792116,4803972,39981,39981,0,0,0,0
4792413,b7017485-7b18-c0a5-ad3e-8705cd525f9f,1,4786068,4786074,4792413,4790990,6339,6345,6,0,0,0
4792433,fcce4fb6-fd97-a595-26be-21e57ac20f0f,1,4786014,4786014,4792433,4792133,6419,6419,0,0,0,0
4792463,dc29aca7-2061-2cdd-2146-de313a6b65aa,1,4786101,4786134,4792463,4790289,6329,6362,33,0,0,0
4792424,d74d930e-0e0f-6619-6926-61f516ca331c,1,4786134,4786134,4792424,4792721,6290,6290,0,0,0,0
4792453,433fca8a-f72a-1b7a-ea78-b0884c9b9009,1,4786167,4786194,4792453,4790694,6259,6286,27,0,0,0
4792431,2ddcc829-0d24-c21d-97a3-5108d7b3c866,1,4786232,4786254,4792431,4792741,6177,6199,22,0,0,0
4792465,c3e8212d-744f-eff8-8257-7dd19d193891,1,4786264,4786314,4792465,4793249,6151,6201,50,0,0,0
4792481,74ed53ce-ef0e-bfd3-3398-39aa7e95b992,1,4786198,4786254,4792481,4792463,6227,6283,56,0,0,0
4793487,be3ff70d-b552-f386-5a96-ef37ee45a744,1,4788245,4788272,4793487,4795216,5215,5242,27,0,0,0
4794537,6fd8440a-5283-889c-c31f-37eb2c981221,1,4788512,4788512,4794537,4795223,6025,6025,0,0,0,0
4794563,23e96b81-004e-0721-0cc8-fa21b601e5b2,8,4751987,4752040,4794563,4809902,42523,42576,53,0,0,0
4794668,430679d8-b058-4c0b-2931-e8032ec9e5f6,1,4786297,4786314,4794668,4794215,8354,8371,17,0,0,0
4794865,2b0d5b1c-027d-8e84-db0e-09ffb6e3f5d3,1,4786331,4786374,4794865,4793319,8491,8534,43,0,0,0
4794959,1dd19a42-cb8b-e57b-115c-13dec14df98e,1,4786785,4786785,4794959,4791812,8174,8174,0,0,0,0
4794989,244226d7-271b-b0ac-fb83-4299b0dba7b4,1,4786821,4786845,4794989,4792268,8144,8168,24,0,0,0
4795011,5dda5439-d5af-e4fe-ca97-8dfacb3f99af,1,4786854,4786905,4795011,4795714,8106,8157,51,0,0,0
4794974,424c330b-9e02-0261-cae5-7ceaefd5d562,1,4786890,4786905,4794974,4797124,8069,8084,15,0,0,0
4794980,1dadd807-16d8-3599-ac66-69e6befb3cb8,1,4786951,4786965,4794980,4798283,8015,8029,14,0,0,0
4795005,9f6e292a-bd6a-6ee8-191c-2be69e2189db,1,4786983,4787025,4795005,4791551,7980,8022,42,0,0,0
4795538,088c436b-e5c0-13c2-aed5-d608b7c92e13,1,4787133,4787133,4795538,4793483,8405,8405,0,0,0,0
4795714,65173bc6-ceb8-9364-8e24-2b1dc5736b1c,1,4777622,4777639,4795714,4802135,18075,18092,17,0,0,0
4795692,c8b1ef8c-12a5-9eaf-f0d4-ad0c23a29fe4,1,4777666,4777699,4795692,4792877,17993,18026,33,0,0,0
4795914,0067eaa6-483d-c53a-fc9d-b77e398c31c0,1,4787541,4787541,4795914,4797763,8373,8373,0,0,0,0
4796097,072a5087-67d9-d83b-7fdf-c5c0876cacdd,8,4795308,4795308,4796097,4795990,789,789,0,0,0,0
4796419,9f999133-6e11-edc4-3c37-531544bd8fcd,1,4777719,4777759,4796419,4791945,18660,18700,40,0,0,0
4796565,2b105a3d-7f07-a2ad-c4c1-d18113e8b22b,8,4795839,4795839,4796565,4796446,726,726,0,0,0,0
4796720,97ad6a67-299f-3047-eefa-dcfa60ff9567,1,4788212,4788212,4796720,4799437,8508,8508,0,0,0,0
4796809,696932ac-9349-c66a-0588-15b3ed335d5f,1,4788311,4788332,4796809,4793162,8477,8498,21,0,0,0
4796853,d7deaa33-738d-21e8-c0a0-07018acfbadc,8,4751982,4752040,4796853,4809831,44813,44871,58,0,0,0
4796889,f4dea863-71d0-f4fd-9b50-9cd77793231f,1,4788345,4788392,4796889,4794137,8497,8544,47,0,0,0
4796899,2d17534a-4834-19b1-c8f5-d39ec3ad1a08,1,4788378,4788392,4796899,4795512,8507,8521,14,0,0,0
4796960,0029691e-0c18-2305-0341-f831ea4a742b,1,4788410,4788452,4796960,4800579,8508,8550,42,0,0,0
4797293,52c2526e-737e-68ed-8b04-09e4fb65c3d3,8,4751980,4751980,4797293,4777254,45313,45313,0,0,0,0
4797355,5b345ede-d26b-6c21-87e4-7dbaf0ad73fb,8,4751982,4752040,4797355,4801469,45315,45373,58,0,0,0
4797442,c27eb09a-77f0-5674-988c-a047e6acb189,8,4751990,4752040,4797442,4810893,45402,45452,50,0,0,0
4797480,4a298783-099c-4929-5705-9671b031a179,8,4751988,4752040,4797480,4801421,45440,45492,52,0,0,0
4797480,24d4dba9-8cf7-fbd8-8d9a-58d83c7c5372,8,4751991,4752040,4797480,4804298,45440,45489,49,0,0,0
4797649,8d9f42bc-b0e0-d156-cef8-8a52e4cda3b9,8,4751984,4752040,4797649,4793873,45609,45665,56,0,0,0
4798076,66d78e18-a347-3f18-6341-6840f5b3029a,1,4777553,4777579,4798076,4807996,20497,20523,26,0,0,0
4798847,523c0ed4-acd3-cc0b-b65d-95c2522c12e1,1,4777519,4777519,4798847,4795099,21328,21328,0,0,0,0
4798849,b26d6078-5d5b-7adb-ee77-f590ea1581f6,8,4751980,4751980,4798849,4782881,46869,46869,0,0,0,0
4799048,c04f4bd0-bcfe-4408-9ac7-25a740b60c17,1,4777540,4777579,4799048,4789626,21469,21508,39,0,0,0
4801861,9c18e0ba-3eea-3cf0-93ff-d1ea14f872f6,1,4777754,4777759,4801861,4809032,24102,24107,5,0,0,0
4802017,dac5169d-f15b-854e-150b-1760f371c77e,1,4777781,4777819,4802017,4796812,24198,24236,38,0,0,0
4802410,f431f8f1-87db-9211-f84f-e7ef5c726f34,1,4777627,4777639,4802410,4805220,24771,24783,12,0,0,0
4804008,ee34827a-8958-92ee-d0ff-a971910fff44,1,4800577,4800577,4804008,4803682,3431,3431,0,0,0,0
4804078,488bd31f-4019-175a-98e4-18359b7215f8,1,4800607,4800637,4804078,4805611,3441,3471,30,0,0,0
4804137,8d72441d-0709-9bf8-6d3f-9e041b14a2aa,1,4800640,4800697,4804137,4803055,3440,3497,57,0,0,0
4804138,50e5b83b-c388-fb0e-2263-e16c66b768bd,1,4800675,4800697,4804138,4803336,3441,3463,22,0,0,0
4804664,0f92b3fb-081d-f5b6-e224-81801d4ac6f9,1,4780772,4780831,4804664,4805969,23833,23892,59,0,0,0
4804806,31ea2821-3034-7270-681f-f52852ec03ca,1,4780771,4780771,4804806,4808228,24035,24035,0,0,0,0
4805465,65d8350a-63fd-b07a-5c7f-9aef3403bfdf,8,4766975,4767022,4805465,4799152,38443,38490,47,0,0,0
4805557,56d07ef3-f58a-7328-75db-9c81073fdf7f,1,4780805,4780831,4805557,4810027,24726,24752,26,0,0,0
4805803,adc4b86d-a180-ee9b-1767-370097e3ab40,1,4777702,4777759,4805803,4818145,28044,28101,57,0,0,0
4806246,c068a64c-d5d6-4a82-7500-d6ef0453ab6d,1,4780803,4780831,4806246,4805563,25415,25443,28,0,0,0
4806593,59430636-b0b1-69f7-378f-78da14308e24,1,4777663,4777699,4806593,4794050,28894,28930,36,0,0,0
4806605,a3cd07bb-94f6-86bf-19b1-af6923bb1f64,1,4777586,4777639,4806605,4805307,28966,29019,53,0,0,0
4806853,636ba8a3-e50e-f872-a892-f46778494ae5,8,4766962,4766962,4806853,4788149,39891,39891,558,1,0,0
4806951,18323765-d145-2528-f91b-ad400b022156,8,4805939,4805983,4806951,4806857,968,1012,44,0,0,0
4807029,0fa38669-b33a-82a9-7a73-42fc741d6857,8,4805949,4805983,4807029,4807022,1046,1080,94,1,0,0
4807019,bcf7bbc2-8e38-440e-6cf9-8cc8a20c9fea,1,4777582,4777639,4807019,4805684,29380,29437,57,0,0,0
4807587,f0a968a6-aea2-d49e-7dc2-c940fa26897a,1,4799657,4799657,4807587,4808873,7930,7930,0,0,0,0
4807697,d554fadf-7633-9d1d-6694-940dddc5c146,1,4799740,4799777,4807697,4811252,7920,7957,37,0,0,0
4807759,a893b7e0-4bd3-63b4-37bb-f1542119e1c1,1,4799698,4799717,4807759,4806365,8042,8061,19,0,0,0
4808147,c395428a-024f-f385-a2ef-2b77a0d69a59,1,4782427,4782427,4808147,4812344,25720,25720,0,0,0,0
4808151,fa32126e-995d-1d59-efd9-b5e10ded1b4d,8,4805936,4805983,4808151,4807108,2168,2215,1152,1,0,0
4808196,b2ea6850-94bf-e660-4e87-9c6249fa555e,8,4805949,4805983,4808196,4806469,2213,2247,1259,1,0,0
4809818,1d3c9859-2ccb-87cb-668e-d827cd101511,8,4300605,4300605,4809818,4621467,509213,509213,0,0,0,0
4811949,50cca99f-5ed2-f65d-0c07-cdc393bc506c,8,4739410,4739410,4811949,4822844,72539,72539,0,0,0,0
4827759,be66de49-ca6d-6803-f75e-a48f6f747d68,32,3801660,3801660,4827759,5190773,1026099,1026099,1199,1,0,0
4827770,833d19ff-3168-89f2-595f-0d20f3966a62,8,4805941,4805983,4827770,4820965,21787,21829,1147,1,0,0
4827816,4dbb5559-8c12-d6ef-31fa-b84d80dd8005,8,4805958,4805983,4827816,4807210,21833,21858,20862,1,0,0
4827908,83bccfa8-f019-19d0-bc72-873246e53c29,8,4805914,4805923,4827908,4832771,21985,21994,1183,2,0,0
4828888,112458e5-e7ae-468b-83a1-dcf0495efe40,8,4805957,4805983,4828888,4807883,22905,22931,20863,1,0,0
4832194,b506aa35-cfa8-5cc8-0dab-44287303f483,8,4766595,4766595,4832194,4850115,65599,65599,558,1,0,0
4832337,97affdcd-26a1-ff29-285c-ecb9ed6d216d,8,4805839,4805863,4832337,4820631,26474,26498,1069,1,0,0
4832351,501da458-e2b9-10f0-a035-d5955653cc44,8,4805951,4805983,4832351,4830132,26368,26400,2702,2,0,0
4832736,0ae689d6-003e-ea09-ac78-dec5d639d8aa,8,4795591,4795598,4832736,4826171,37138,37145,877,1,0,0
4833523,ae0343a9-4dff-80fc-3450-4da66a2a6ffe,8,4805839,4805863,4833523,4831096,27660,27684,1069,1,0,0
4833817,ad735097-a0c4-e637-565e-a7b89514e86e,32,4741487,4741487,4833817,4808095,92330,92330,1357,2,0,0
4835347,60e565b6-39b3-742d-becf-bc0b5ea62cb9,8,4805840,4805863,4835347,4832855,29484,29507,1068,1,0,0
4837790,5d06fdc3-fe64-41f0-7ec2-eadebf88f749,8,4761849,4761849,4837790,4866173,75941,75941,558,1,0,0
4838731,fe389c35-e28c-259c-8124-14079870fafa,1,4837995,4837995,4838731,4838730,736,736,0,0,0,0
4838779,c766dd63-683e-1858-dbbe-b0d9802ccb52,1,4811894,4811894,4838779,4821766,26885,26885,18892,1,0,0
4841660,386bf5fc-9b52-ba4d-851e-4fe83a6570b5,1,4840943,4840943,4841660,4841388,717,717,0,0,0,0
4842407,d66cbda1-20be-8394-8cbb-ca011cacfd9f,8,4806541,4806541,4842407,4819385,35866,35866,20256,1,0,0
4843740,205cf4ec-8518-1eb4-c115-761359393a5d,8,4805930,4805983,4843740,4856608,37757,37810,1158,1,0,0
4848184,503ef9cb-1006-37c7-af2c-65fa50e363d5,8,4805940,4805983,4848184,4830653,42201,42244,1148,1,0,0
4850374,25e591c8-2fff-7405-6e83-766e4639e799,8,4805925,4805983,4850374,4870112,44391,44449,1163,1,0,0
4853558,20a145c8-8962-31dc-4b67-563a9d7362f2,8,4805952,4805983,4853558,4830278,47575,47606,4067,2,0,0
4856255,138664e3-c838-6cbc-2c42-e58bd42e937c,8,4805953,4805983,4856255,4873117,50272,50302,4292,3,0,0
4856975,26994648-2b42-023a-25fa-d4573c10cbcf,8,4805948,4805983,4856975,4841336,50992,51027,1561,2,0,0
4858690,b5356bf3-b5f4-149f-5054-b5baa6b02299,8,4805921,4805923,4858690,4876899,52767,52769,1176,2,0,0
4858725,a1592b44-d781-27e8-cb33-94d7aa8d6f81,8,4807011,4807042,4858725,4849386,51683,51714,19792,1,0,0
4859131,c7d012b0-de9c-cb51-6038-e284ceddadec,8,4805941,4805983,4859131,4846905,53148,53190,1147,1,0,0
4862075,c69eb431-cf34-4c15-e9b3-589ccf2109f1,8,4805929,4805983,4862075,4861643,56092,56146,1159,1,0,0
4862558,5e065732-03d9-f317-9d7c-24ce85d5bed9,8,4805915,4805923,4862558,4840419,56635,56643,1182,2,0,0
4862856,ca44724a-4502-0c28-d824-a59edb33ce63,8,4807019,4807042,4862856,4836698,55814,55837,27424,4,0,0
4863583,9e9a3e83-9a4e-f6fc-79a0-e72710e29558,8,4807011,4807042,4863583,4848825,56541,56572,19703,1,0,0
4863807,a12a8971-8239-e5a8-da61-4a73aaf39dd5,8,4862996,4862996,4863807,4863931,811,811,0,0,0,0
4863942,37b5ba07-eb21-0c92-c4ec-df3a1f9850b1,8,4863091,4863091,4863942,4863666,851,851,0,0,0,0
4864158,dd50f7e7-d8fd-8386-4748-3ec122d1b5fa,8,4807014,4807042,4864158,4829943,57116,57144,24617,1,0,0
4864228,50d8929c-5157-cf3e-9766-cd4326d18922,8,4807011,4807042,4864228,4850399,57186,57217,20772,1,0,0
4864328,48f8672b-d601-12bd-7a2a-b3001116bead,8,4805917,4805923,4864328,4838775,58405,58411,1180,2,0,0
4865614,a3c595c8-fd54-44ec-afe4-fdbb4d6fc7e3,8,4807013,4807042,4865614,4849762,58572,58601,24279,1,0,0
4866057,279e04e7-6100-3856-22bb-0c8d7bdc80ac,8,4805946,4805983,4866057,4870016,60074,60111,1563,2,0,0
4866395,478d365f-c209-cac4-44be-71b901dfe84a,8,4807012,4807042,4866395,4835305,59353,59383,24220,1,0,0
4866732,cfd51f1e-01da-a440-21db-f7f76d3fcc72,8,4805942,4805983,4866732,4859184,60749,60790,1146,1,0,0
4867505,69e83561-4557-bdcb-715e-ae421461f0d8,8,4807016,4807042,4867505,4837487,60463,60489,25696,1,0,0
4867818,0e03622c-110a-156d-72d9-32a41583367e,8,4805923,4805923,4867818,4854655,61895,61895,1174,2,0,0
4867932,7508e10c-1035-ddda-2cf0-c77d7801792b,8,4805950,4805983,4867932,4856013,61949,61982,2296,2,0,0
4867960,8e05cadd-a6f8-a5ac-c30d-afb577756059,8,4805931,4805983,4867960,4896898,61977,62029,1157,1,0,0
4868296,669f5e4f-eddb-2d45-e702-d3cb8f021e9c,8,4805936,4805983,4868296,4876990,62313,62360,1152,1,0,0
4868678,293572d3-fb63-33cb-0c35-bf2dec4fa141,8,4805936,4805983,4868678,4876613,62695,62742,1152,1,0,0
4868822,a18abfa8-1ced-7991-07fe-b08e08f07b8a,8,4805937,4805983,4868822,4838765,62839,62885,1151,1,0,0
4869994,79d81ee9-1d4b-c914-0bdf-a5f0c653705e,8,4805914,4805923,4869994,4899343,64071,64080,1183,2,0,0
4870090,960a035c-0786-a459-cf89-321cff4ca29e,8,4805934,4805983,4870090,4899964,64107,64156,1154,1,0,0
4871165,90c9e728-c66c-2104-5bd9-d3c948434dec,8,4805913,4805923,4871165,4878069,65242,65252,1184,2,0,0
4872105,75a8457d-74f8-94e2-70a1-e5ddd403653e,8,4691564,4691564,4872105,4900108,180541,180541,0,0,0,0
4872861,9b828fab-c0c3-6528-3e9d-547a96ce7d17,8,4807019,4807042,4872861,4844348,65819,65842,26562,3,0,0
4878670,fa4f169a-9de9-294d-b71d-2e0faf09c66e,8,4805944,4805983,4878670,4856460,72687,72726,1144,1,0,0
4879001,6e06f176-d140-f967-0d53-48d15b15674d,8,4805922,4805923,4879001,4887571,73078,73079,1175,2,0,0
4881079,5578126e-a06a-e93d-01d2-3fc9b44df4b5,8,4807026,4807042,4881079,4822025,74037,74053,45427,1,0,0
4883570,ebd7fd91-5d5a-43aa-de09-b6685422d954,8,4808669,4808674,4883570,4813709,74896,74901,71432,1,0,0
4884924,e8d7ea29-3694-d78c-aed1-95c9a8c62c4d,8,4807022,4807042,4884924,4850375,77882,77902,35839,2,0,0
4885434,d057358d-c03b-3a8e-58ed-77989c266a1b,8,4807034,4807042,4885434,4847225,78392,78400,50992,1,0,0
4886344,b28935e7-8e5b-ef68-3dcf-3be05e4d9d2f,8,4808670,4808674,4886344,4813394,77670,77674,73922,1,0,0
4886570,2d799705-9e83-0948-89eb-14e833671e1c,8,4821461,4821461,4886570,4825472,65109,65109,62097,1,0,0
4886967,11269f9e-03c0-ca01-ce98-6e40723182d4,8,4821476,4821521,4886967,4824914,65446,65491,62652,1,0,0
4887041,fe4d58c1-6794-16cd-e17e-e03a8a5db90b,8,4807015,4807042,4887041,4872872,79999,80026,25403,1,0,0
4888040,3347216c-7a7d-6d78-670c-ada1c783870a,8,4822827,4822827,4888040,4827021,65213,65213,62171,1,0,0
4888131,0c5332b3-10d5-d5b8-d448-a70dc04147f5,8,4821493,4821521,4888131,4825716,66610,66638,63545,1,0,0
4888193,c96e517f-e49e-6f6e-6c56-1f785e5a590a,8,4807011,4807042,4888193,4882209,81151,81182,19703,1,0,0
4889425,bda91c8a-abb6-2c94-eecb-343b28569821,8,4807020,4807042,4889425,4849264,82383,82405,30660,3,0,0
4889529,0c44c0fd-e13c-e64d-723e-860e0ae35494,8,4805956,4805983,4889529,4846839,83546,83573,20864,1,0,0
4892670,ac672695-a54b-b06c-b1a3-3f6de3dbe202,8,4807011,4807042,4892670,4890801,85628,85659,24078,1,0,0
4893158,72811822-fd26-ce31-8a00-c9be55c5e74b,8,4837913,4837913,4893158,4846770,55245,55245,48889,1,0,0
4895079,dc2f952c-2583-eb38-cebf-3ea4c7a69982,8,4807040,4807042,4895079,4845660,88037,88039,56013,1,0,0
4897131,7400c7a1-0de8-25b2-5246-cc34bcdbe579,8,4807037,4807042,4897131,4832159,90089,90094,55665,1,0,0
4897292,c2fdb44a-7a8e-854f-dc44-91791d7a0bd0,8,4807021,4807042,4897292,4868279,90250,90271,32543,2,0,0
4897961,0e832587-315e-b39f-82e9-dd36bc23db22,8,4807039,4807042,4897961,4847372,90919,90922,55798,1,0,0
4898836,24a7dce4-a3dd-1a45-c75f-7f94ec529f2b,8,4807047,4807102,4898836,4837592,91734,91789,59900,1,0,0
4899084,2212b446-f39e-ab73-a24a-7b893f22cd74,8,4807051,4807102,4899084,4835987,91982,92033,60357,2,0,0
4899411,404f04e4-44b0-c797-5fe1-271fda3c3beb,8,4807052,4807102,4899411,4828667,92309,92359,61132,2,0,0
4899791,1b69000c-0670-70e0-f765-8613d34172ff,8,4807046,4807102,4899791,4852134,92689,92745,59727,1,0,0
4900336,93de2da0-40ff-5822-dd8d-074742d361aa,8,4807025,4807042,4900336,4838619,93294,93311,41626,2,0,0
4900699,d99472c6-e6b8-7bf5-2454-a9f6a87dd098,8,4807052,4807102,4900699,4847830,93597,93647,61897,1,0,0
4900953,eb5c4ed8-5ef6-840e-9ef8-b5a9b792ff65,8,4852008,4852008,4900953,4859588,48945,48945,43499,1,0,0
4901642,d5411860-8583-d0bb-32fb-59fd0c00f8ff,8,4807049,4807102,4901642,4825267,94540,94593,60202,1,0,0
4902430,aaaa7602-2886-115f-f9f4-fbcd6f41bc23,8,4807017,4807042,4902430,4857056,95388,95413,26444,3,0,0
4903048,f35c02fd-d88b-4a71-ba53-d4ca79d1acbd,8,4900689,4900689,4903048,4901728,2359,2359,788,1,0,0
4904272,68a522b9-ff6f-26ca-e245-932771224f95,8,4807046,4807102,4904272,4827609,97170,97226,59841,1,0,0
4905530,87b31442-3a6f-f66b-fa8c-178b4e90b61e,8,4807065,4807102,4905530,4844899,98428,98465,66323,2,0,0
4908581,ca9d0590-b36a-7314-7893-aa696790b027,16,4725513,4725513,4908581,4890769,183068,183068,0,0,0,0
4908992,2872edca-b362-03ce-7646-c493209186d6,8,4805945,4805983,4908992,4864113,103009,103047,1143,1,0,0
4909129,8bef5d54-c0c5-2495-92bf-804e89ca1b26,8,4838354,4838403,4909129,4870369,70726,70775,48290,1,0,0
4909232,6b6348f4-d14a-3950-36e7-5939e2d76077,8,4805934,4805983,4909232,4939618,103249,103298,1154,1,0,0
4910071,c75861c1-c0ac-b3e0-3083-807316e7d97b,8,4805924,4805983,4910071,4907449,104088,104147,1164,1,0,0
4910233,2018ed3f-9a8e-d6e8-5bae-b471236bc49c,8,4799692,4799717,4910233,4865665,110516,110541,895,1,0,0
4910820,2e3c7679-6dc2-d7db-9763-7e6ccd87a06a,8,4805929,4805983,4910820,4952983,104837,104891,1159,1,0,0
4911623,4808884b-6413-7c20-213a-839cdecc87f2,8,4807059,4807102,4911623,4867018,104521,104564,64001,1,0,0
4913748,fa7cf893-24f2-95fc-e4d2-48572d7e085d,8,4838343,4838343,4913748,4875638,75405,75405,48179,1,0,0
4914945,2a329b37-5fcd-39c7-eaa2-c166d1893aba,8,4807040,4807042,4914945,4842993,107903,107905,56183,1,0,0
4916507,8a02711e-02f3-e4d0-eeb8-c6eb700affff,8,4844566,4844566,4916507,4871191,71941,71941,44812,2,0,0
4917133,00ef3377-08ed-3047-1900-1fc9ca445a6b,8,4807023,4807042,4917133,4906022,110091,110110,38570,3,0,0
4917165,91eca6b7-2d7b-3702-6365-798bcb6bb8fe,8,4807027,4807042,4917165,4866050,110123,110138,48123,1,0,0
4917739,907e5f2d-7f13-387a-f4e3-057067d17836,8,4844581,4844626,4917739,4865905,73113,73158,46211,2,0,0
4918265,65c7fb93-e46a-c676-ddc4-5dd4aa620cd9,8,4807055,4807102,4918265,4835002,111163,111210,61990,1,0,0
4922223,4c6694ab-57b5-3de2-31ae-84bec7be05c6,8,4848259,4848259,4922223,4888134,73964,73964,45248,1,0,0
4925524,3800da79-fcd1-c3b7-6b41-168370972046,8,4807028,4807042,4925524,4893493,118482,118496,48842,1,0,0
4925970,d3f9dab2-57ba-9b4c-e450-9dd3d4bf4f30,8,4807041,4807042,4925970,4883305,118928,118929,57911,1,0,0
4926946,d51878a7-c962-8855-9f4e-f5d61b1a5a06,8,4875158,4875158,4926946,4910740,51788,51788,22354,1,0,0
4927929,df9a7704-adc2-5f16-64b3-0768fdfd984e,8,4807040,4807042,4927929,4875927,120887,120889,56083,1,0,0
4928141,e1772a38-96aa-a3ca-baf6-e89f14e0a8d3,8,4807032,4807042,4928141,4888826,121099,121109,50613,1,0,0
4928324,05c95f58-9df5-4a21-6036-3d282e27c83f,8,4807025,4807042,4928324,4896223,121282,121299,43794,2,0,0
4928557,8947494f-96c8-4002-d215-2070e4eea1bc,8,4807030,4807042,4928557,4910754,121515,121527,50555,1,0,0
4928691,b8c52ae1-0d09-a714-fd99-8da8c0524da3,8,4807055,4807102,4928691,4840992,121589,121636,63065,1,0,0
4929289,41659d74-a93b-ea35-8332-b29b80994da1,8,4807042,4807042,4929289,4898587,122247,122247,58248,1,0,0
4929467,e97c0337-28f6-f012-2ba5-a631cb776246,8,4927636,4927636,4929467,4928619,1831,1831,0,0,0,0
4929629,4667b057-7387-de41-3d79-f8b612d0ff7d,8,4807043,4807102,4929629,4885290,122527,122586,59026,2,0,0
4929990,cebe11c8-16e7-350e-1486-cd280cabf18c,8,4807054,4807102,4929990,4897959,122888,122936,61895,1,0,0
4930118,57232faa-b578-8525-af0a-c5d6ee5e1fb5,8,4807040,4807042,4930118,4867453,123076,123078,57469,1,0,0
4930137,6cd6b9e1-0765-6c22-9bcd-e988ce25d281,1,4915374,4915374,4930137,4928198,14763,14763,0,0,0,0
4930731,341583df-5cee-cd7b-1183-8d860314f10f,8,4807036,4807042,4930731,4862785,123689,123695,54391,3,0,0
4932015,ba80c88b-9da3-e777-598c-1a48e187ab6d,8,4807036,4807042,4932015,4897747,124973,124979,55302,2,0,0
4932879,099c3693-fe59-189f-3035-fa61437478bd,1,4889848,4889848,4932879,4917966,43031,43031,2734,1,0,0
4936914,d6c480da-2fd3-5f16-34b8-0226640876fb,8,4803372,4803372,4936914,4976488,133542,133542,1771,3,0,0
4938867,2a24cab7-eb65-c70d-1c64-72c8bafe90d2,8,4805934,4805983,4938867,4885699,132884,132933,1154,1,0,0
4940446,2f17a43f-6f4e-b891-8e0a-c6f5d3c40794,8,4805930,4805983,4940446,4980577,134463,134516,1158,1,0,0
4940435,51a2427a-dff9-2d8f-a33c-e56fc7b7383e,8,4805930,4805983,4940435,4927112,134452,134505,1158,1,0,0
4940791,2e26d622-e17c-e345-407f-eda6c2aec132,8,4805949,4805983,4940791,4994458,134808,134842,1680,2,0,0
4942072,ce972144-4d17-094c-9288-cbf5a6bd63a4,8,4766972,4767022,4942072,4908112,175050,175100,920,1,0,0
4942821,d56e0949-1de5-8d73-0e1e-5ebdff99fe31,8,4846845,4846845,4942821,4878337,95976,95976,44983,1,0,0
4944199,844e21a8-873a-6a3c-1094-f482b959170a,8,4803450,4803450,4944199,4938149,140749,140749,1915,2,0,0
4945283,8b160a4d-7adb-f90e-2c91-0cd0cb5e0dab,8,4805919,4805923,4945283,4985467,139360,139364,1178,2,0,0
4945453,aa10ce87-efbf-b921-e9f2-e2babb8999fa,8,4805914,4805923,4945453,4940439,139530,139539,1183,2,0,0
4947252,e8c80d96-3e5e-9986-c002-cd6bc28d1433,8,4805944,4805983,4947252,5005610,141269,141308,1144,1,0,0
4947710,d961cea0-8a62-6b5c-ac4b-7dbd1961da1f,8,4805913,4805923,4947710,4974724,141787,141797,1124,2,0,0
4948258,4b2a2bb4-097a-575d-36ce-8d27bacc5ea6,8,4808181,4808207,4948258,4862050,140051,140077,69796,1,0,0
4952014,33ca11ee-8c59-1d00-6b70-d4d56e0db295,8,4807611,4807647,4952014,4874003,144367,144403,70092,1,0,0
4953943,c3aa59ef-e5bb-ffb9-e2c0-7b0fbc374a1e,8,4943889,4943889,4953943,4952952,10054,10054,0,0,0,0
4958249,3b8846e6-1823-9790-4046-0d07d4539094,8,4803450,4803450,4958249,4927416,154799,154799,1915,2,0,0
4958634,6cddab56-8c30-6073-e8e4-c8deddd98c67,8,4862515,4862515,4958634,4942859,96119,96119,33643,1,0,0
4961213,f8dc2c64-c4e4-3753-8a0d-9af8322c519f,8,4930416,4930416,4961213,4947042,30797,30797,0,0,0,0
4961262,36b86a13-8d1b-6ecb-2d79-4edf0dd14338,8,4869030,4869030,4961262,4947966,92232,92232,28842,1,0,0
4962595,9e929f50-995c-712f-2a96-08bd0f706894,8,4948227,4948227,4962595,4958137,14368,14368,0,0,0,0
4965218,a5c3a0a9-a29c-9dbe-ee8f-0a8837280c98,8,4803450,4803450,4965218,4923196,161768,161768,1915,2,0,0
4966101,fe835c51-7e70-b309-3237-1f1493a971f4,1,4928599,4928617,4966101,4980891,37484,37502,18,0,0,0
4966418,3b1f38f0-0be2-9694-652e-89572ae06f26,8,4804626,4804626,4966418,5016381,161792,161792,1915,2,0,0
4967587,4e33db37-3142-5d81-0912-fddc0d36d15b,8,4936891,4936891,4967587,4956342,30696,30696,0,0,0,0
4968635,004fe610-299a-7d68-7a0d-bbe1c105ab46,8,4868521,4868521,4968635,4924956,100114,100114,28524,1,0,0
4968955,6f98e008-f9c2-0003-7958-2b950e0d7608,8,4950039,4950039,4968955,4971861,18916,18916,0,0,0,0
4972881,f3da143e-4962-394f-7c26-09e1375e5c72,8,4926669,4926669,4972881,4984234,46212,46212,0,0,0,0
4974802,6f35fae2-c082-1f39-577a-e5a180b6068f,8,4867123,4867123,4974802,4936907,107679,107679,28996,1,0,0
4978416,ef0abbd0-dbae-a49d-9527-b10285bb0541,8,4967988,4967988,4978416,4977562,10428,10428,0,0,0,0
4984698,035bd879-eca0-a912-861c-53de98e1e160,8,4805954,4805983,4984698,5019252,178715,178744,15148,2,0,0
4989495,5f786318-3e63-131e-1a6d-a2e5e0351e44,8,4939444,4939444,4989495,4973861,50051,50051,0,0,0,0
4990726,aa2bcaa7-d90d-a48d-ce0f-3a5342809061,8,4956397,4956397,4990726,4998377,34329,34329,0,0,0,0
5001695,9c174363-bc44-cb36-d89c-568d5674e177,8,4934913,4934913,5001695,4992663,66782,66782,0,0,0,0
5005609,242bba10-c7d0-b0d1-4b5f-df7039185b72,8,4974034,4974034,5005609,5020472,31575,31575,0,0,0,0
5011540,5905fd87-84c1-2470-da04-23dfe634727d,8,5009404,5009404,5011540,5010997,2136,2136,0,0,0,0
5017659,227cc456-193a-fe2a-f8da-93c8c0b4283a,8,5009894,5009894,5017659,5020106,7765,7765,0,0,0,0
5020403,ce5e137f-8772-3818-65e3-1112c35826a5,32,4836265,4836265,5020403,4918385,184138,184138,71895,1,0,0
5024268,f5dab6fe-1ea4-b89d-9898-2e99fa9fdbb3,8,4946657,4946657,5024268,5004755,77611,77611,0,0,0,0
5028751,f5662788-2993-71cf-87ce-f9a29b75459c,32,4916109,4916109,5028751,4972540,112642,112642,0,0,0,0
5046336,5183c54f-ab3f-631b-d60c-e979c4d0388b,8,5043815,5043815,5046336,5045715,2521,2521,0,0,0,0
5047038,156c992b-cc97-7171-f926-393cf1974022,8,4937072,4937072,5047038,4997831,109966,109966,0,0,0,0
5048084,498e6ba4-005d-55a8-2c9f-57059ba0e399,8,4890371,4890371,5048084,5070762,157713,157713,7468,1,0,0
5052864,e470dab0-e520-b332-a4a5-8bd60a328c88,8,4940007,4940007,5052864,5038857,112857,112857,0,0,0,0
5055009,119bd998-f1c3-020d-37e9-1ea49c0723c4,32,4809231,4809231,5055009,4933425,245778,245778,91990,1,0,0
5055623,7f37c8f7-5dfe-c77c-dea0-f4f1d8355a00,8,4837731,4837731,5055623,4938160,217892,217892,48310,1,0,0
5056465,15f3f9e1-2170-ef53-9137-8b3ed8abc155,8,4960990,4961016,5056465,5050884,95449,95475,26,0,0,0
5057001,3bcb4f32-e3b5-2c1d-1a0a-1af2999f64e9,8,4835193,4835193,5057001,5022932,221808,221808,50702,1,0,0
5057480,80ef2ccf-8999-b812-d616-76fcbb1ffaf4,8,4960956,4960956,5057480,5087679,96524,96524,0,0,0,0
5057997,a86e45c6-a279-21f6-6d58-f5e065b2e4c5,8,5044880,5044880,5057997,5061968,13117,13117,0,0,0,0
5058115,17430eff-0431-d773-c544-3fb6ead24b3d,8,4961117,4961117,5058115,5016117,96998,96998,0,0,0,0
5063297,bfb5ab4e-ea57-353c-1dc6-1cb849a7102d,8,5056114,5056114,5063297,5064870,7183,7183,0,0,0,0
5063961,c2e8a700-3548-7cd7-e0ef-27f80061a789,8,4956790,4956790,5063961,5104368,107171,107171,0,0,0,0
5064789,4e8d2654-cd37-10e6-27eb-e3a50af9da16,8,5044880,5044880,5064789,5064450,19909,19909,0,0,0,0
5064841,5edce3b7-c9ce-362d-7273-b748f5cb2af8,8,5044880,5044880,5064841,5072354,19961,19961,0,0,0,0
5065567,3946ad23-c098-e2b4-7a79-8ed42a0bfd9f,8,5058496,5058496,5065567,5064896,7071,7071,0,0,0,0
5069437,faca2c41-5377-0d9d-c911-7c2732878723,8,4972628,4972628,5069437,5052935,96809,96809,0,0,0,0
5072773,c524a1be-a6bb-b51c-85d8-acf312a7186c,8,5044880,5044880,5072773,5085321,27893,27893,0,0,0,0
5076952,5487452b-226a-cb48-0428-6ad922e40b50,8,5044882,5044940,5076952,5073339,32012,32070,58,0,0,0
5077019,cc40d3a5-94be-a0bd-75d2-4173ee56aea4,8,5044880,5044880,5077019,5070964,32139,32139,0,0,0,0
5088590,876080e1-4c9a-f99a-233d-9eb3d1eba173,8,4940729,4940729,5088590,5059666,147861,147861,0,0,0,0
5088655,99474e78-77cd-ab25-c786-140f2339df60,8,5082307,5082307,5088655,5086734,6348,6348,0,0,0,0
5090583,10ab9db1-a5e5-178a-3943-23c3a38dbe8c,8,4931766,4931766,5090583,5165407,158817,158817,0,0,0,0
5093201,ac7625b8-0fc0-6f77-b27b-14fdd4edc9d8,1,5091859,5091887,5093201,5093230,1314,1342,28,0,0,0
5093284,f12c2046-1cdb-06cb-e9c3-d3719f688611,1,5091838,5091887,5093284,5093198,1397,1446,49,0,0,0
5093860,605a79a3-279e-a501-4274-f88a5cbe6bb3,8,5091540,5091540,5093860,5093540,2320,2320,0,0,0,0
5094276,9631be62-13b4-98db-d9bc-e2196fb398f4,1,5093354,5093404,5094276,5094445,872,922,50,0,0,0
5095056,9241e029-082d-c372-c996-a54bbcbb0658,1,5091830,5091887,5095056,5093836,3169,3226,57,0,0,0
5095121,c65e23c7-9865-6bba-2ea8-16ef624949a0,1,5091911,5091947,5095121,5095683,3174,3210,36,0,0,0
5095125,c62d7b34-ddbd-67b1-4279-c1cc67b80414,1,5091905,5091947,5095125,5094015,3178,3220,42,0,0,0
5095839,96944fa8-afb7-7dcd-afb6-f3c9a798deba,1,5093369,5093404,5095839,5096479,2435,2470,35,0,0,0
5095923,8fae987e-1ed8-d9a2-345e-2b3707995fbc,8,5082494,5082494,5095923,5091859,13429,13429,0,0,0,0
5095983,246f5c1d-04e3-83eb-afca-225afc7cdc3e,8,5082545,5082554,5095983,5092800,13429,13438,9,0,0,0
5096052,ddebaa54-9f6c-807f-1234-f67203d11260,1,5093325,5093344,5096052,5095670,2708,2727,19,0,0,0
5096116,d85a4e1a-66ed-b71c-6a98-979991354949,1,5093311,5093344,5096116,5094876,2772,2805,33,0,0,0
5096202,a550a4d1-8e27-e044-9aa8-33b4a982d88e,1,5093355,5093404,5096202,5095227,2798,2847,49,0,0,0
5096561,76fc61e3-d5fe-a180-1333-f00ec2f6b14d,1,5093370,5093404,5096561,5097079,3157,3191,34,0,0,0
5096740,57b6b27c-bf18-d74a-c743-d9f12d08413f,1,5091833,5091887,5096740,5097720,4853,4907,54,0,0,0
5096741,e2073d92-c1c6-5bbb-2b02-38ae67de3fca,1,5091864,5091887,5096741,5094546,4854,4877,23,0,0,0
5096736,f0c3dc02-c4f8-c5ce-92ca-910d738cf3da,1,5091904,5091947,5096736,5095344,4789,4832,43,0,0,0
5096761,60b97459-09e2-f56e-f0a3-be304d06b31c,1,5091910,5091947,5096761,5095792,4814,4851,37,0,0,0
5096747,60562765-9c1d-7a65-d5c8-3c5d48754ef8,1,5091914,5091947,5096747,5097817,4800,4833,33,0,0,0
5096814,5d03e927-3c76-cf5b-f9ee-56874a411b06,1,5091866,5091887,5096814,5094514,4927,4948,21,0,0,0
5096831,0be4a2fb-9853-5a5f-2bf8-4a05d82d6078,1,5091892,5091947,5096831,5098992,4884,4939,55,0,0,0
5096882,150f1ad2-476a-4f1d-bfef-bd38a8112386,1,5091923,5091947,5096882,5098376,4935,4959,24,0,0,0
5096894,c85336db-4754-c20a-902d-f7cf28efd75b,1,5093310,5093344,5096894,5096312,3550,3584,34,0,0,0
5096906,96a805bb-b7a7-d1ba-c6e4-34945e317e80,1,5093315,5093344,5096906,5098608,3562,3591,29,0,0,0
5096938,7f14d81c-6f6d-18c6-c334-33e0aa566d79,1,5093384,5093404,5096938,5096736,3534,3554,20,0,0,0
5097014,6bd95a4f-37bf-fcbd-87a4-53041ff3a9f8,1,5093328,5093344,5097014,5098141,3670,3686,16,0,0,0
5097026,bd95c7f5-dbaa-1aa2-ab9c-405dfd8a2b0a,1,5093420,5093464,5097026,5096064,3562,3606,44,0,0,0
5097070,a10cf398-835f-9963-07f5-5f28341e4895,1,5093373,5093404,5097070,5098665,3666,3697,31,0,0,0
5097101,da0eb3c3-f8f0-01ae-e924-e01a5f5cc473,1,5093395,5093404,5097101,5097168,3697,3706,9,0,0,0
5097076,feb3a855-48e6-1273-4680-13786e607c2f,1,5093442,5093464,5097076,5095252,3612,3634,22,0,0,0
5097144,288d6c65-daf2-571c-0736-591d74f9bd90,1,5091835,5091887,5097144,5096966,5257,5309,52,0,0,0
5097144,49058e12-0277-f141-3240-ab1579a7e05a,1,5091857,5091887,5097144,5096210,5257,5287,30,0,0,0
5097104,6b4c2dac-df93-b659-a30c-e666d36e7cca,1,5091880,5091887,5097104,5098516,5217,5224,7,0,0,0
5097102,9daeceaa-b306-0396-3a12-2631715463ee,1,5093393,5093404,5097102,5098699,3698,3709,11,0,0,0
5097203,0cad2d63-8cfd-980c-984f-541976b4c117,1,5091870,5091887,5097203,5099163,5316,5333,17,0,0,0
5097261,602596fb-d206-7a87-62c6-0435dc5bb24f,1,5093475,5093524,5097261,5098025,3737,3786,49,0,0,0
5097273,50d8ae13-5a66-3824-a021-6b00a43ccdd5,1,5093478,5093524,5097273,5097174,3749,3795,46,0,0,0
5097481,e7f1ec14-f8bf-491d-4311-fb266e153de8,1,5093430,5093464,5097481,5099226,4017,4051,34,0,0,0
5097514,b7584252-fd9c-ed09-0442-46cfacf14cbe,1,5093339,5093344,5097514,5098153,4170,4175,5,0,0,0
5097534,92ccadb2-8bce-0c24-7ee9-58ac77bd00de,1,5093410,5093464,5097534,5098463,4070,4124,54,0,0,0
5097609,941eddf9-6460-f660-c08d-551fb9e89990,1,5093358,5093404,5097609,5096189,4205,4251,46,0,0,0
5097669,cb697bf9-384e-40c1-71ae-b0b964804241,1,5093417,5093464,5097669,5098647,4205,4252,47,0,0,0
5097629,c9bbdda4-3080-e036-502f-4df3dffd1d40,1,5093432,5093464,5097629,5097788,4165,4197,32,0,0,0
5097695,517e71e0-47e5-df56-8e96-551aeeba6ad9,1,5093317,5093344,5097695,5096421,4351,4378,27,0,0,0
5097683,bada092a-5e4c-dce6-1453-9cdb1ec88633,1,5093341,5093344,5097683,5099549,4339,4342,3,0,0,0
5097692,01278844-06c5-6863-3a83-795dc4363bea,1,5093448,5093464,5097692,5096784,4228,4244,16,0,0,0
5097744,1c05a85b-ca8d-3149-8a29-d1fbee88891c,1,5093338,5093344,5097744,5096362,4400,4406,6,0,0,0
5097785,2056dff5-1f58-ceca-3b01-7c93a525e50b,1,5093361,5093404,5097785,5098522,4381,4424,43,0,0,0
5097782,c1886c58-5208-72d3-9c21-592004007c5d,1,5093474,5093524,5097782,5095957,4258,4308,50,0,0,0
5097769,6de72534-9c9f-2ec0-ef80-a18943cbfd06,1,5093478,5093524,5097769,5099679,4245,4291,46,0,0,0
5097827,a589c017-16f4-a6b5-a760-a7dfce01fa3f,1,5093455,5093464,5097827,5097339,4363,4372,9,0,0,0
5097870,e55b116e-680c-40c1-0d57-9ea09b7d5a08,1,5093467,5093524,5097870,5099108,4346,4403,57,0,0,0
5098020,1bb868d5-88c0-23d7-786c-014f65fae4a1,1,5093421,5093464,5098020,5095752,4556,4599,43,0,0,0
5098072,f45045ad-2454-9c98-1510-71bcc15d3abb,1,5093443,5093464,5098072,5097303,4608,4629,21,0,0,0
5098244,e16874df-5639-3a74-a768-b119fd9077b6,1,5093442,5093464,5098244,5098069,4780,4802,22,0,0,0
5098283,1e26bc3d-f514-083e-f8b5-3c1650798aac,1,5093329,5093344,5098283,5098878,4939,4954,15,0,0,0
5098301,c1cb8d69-8fa7-bdec-e5a6-1a06a8422325,1,5093394,5093404,5098301,5098824,4897,4907,10,0,0,0
5098283,4eab6bdd-7fb8-2b3e-4234-e83e0786bad1,1,5093416,5093464,5098283,5096213,4819,4867,48,0,0,0
5098338,051852dc-8caf-7d2a-bc40-47fa1c6386f7,1,5093365,5093404,5098338,5098269,4934,4973,39,0,0,0
5098335,b521d095-94b2-2af0-9080-9121fe41bb81,1,5093412,5093464,5098335,5097181,4871,4923,52,0,0,0
5098367,5630899b-5edb-f93e-69ad-2a79c8cc684d,1,5093359,5093404,5098367,5100605,4963,5008,45,0,0,0
5098397,fd43754e-39eb-005a-bab9-0085e27e12e4,1,5093483,5093524,5098397,5100272,4873,4914,41,0,0,0
5098449,bb84711f-267c-b754-91c6-485467a9cca9,1,5093305,5093344,5098449,5096189,5105,5144,39,0,0,0
5098477,19848c74-6b51-bda0-2c21-d6c536c7b748,1,5093420,5093464,5098477,5097812,5013,5057,44,0,0,0
5098431,66c64e18-fdce-9d79-7fdf-76ae89293c77,1,5093463,5093464,5098431,5100694,4967,4968,1,0,0,0
5098536,4998ef25-e794-00ee-4a5e-d28785a63296,1,5093457,5093464,5098536,5100393,5072,5079,7,0,0,0
5098591,b39844f4-e194-fb21-6e7e-2fbc21f8b225,1,5093343,5093344,5098591,5099961,5247,5248,1,0,0,0
5098704,28a625e1-4133-6ed1-5821-8c7556c8c3c7,1,5093306,5093344,5098704,5100177,5360,5398,38,0,0,0
5098742,00f899de-fca3-39e8-73fb-f31264ecfbeb,1,5093349,5093404,5098742,5098739,5338,5393,55,0,0,0
5098763,c1f6afec-a15e-0655-e276-db301adecee4,1,5093376,5093404,5098763,5096253,5359,5387,28,0,0,0
5098715,13189bf2-cf3a-b554-cf32-cd1499c69fcf,1,5093380,5093404,5098715,5100440,5311,5335,24,0,0,0
5098731,adc77c49-c280-6fd5-63ef-c4d9b85f4790,1,5093482,5093524,5098731,5098782,5207,5249,42,0,0,0
5098848,aa47bfc8-164b-a766-b4c7-573a84c84c23,1,5093491,5093524,5098848,5101262,5324,5357,33,0,0,0
5099195,9bb718a5-cd7f-9010-318b-eb4e8251afd9,1,5093345,5093404,5099195,5099421,5791,5850,59,0,0,0
5099749,030b23db-bfbe-9ca3-f610-350b76f53b65,1,5093417,5093464,5099749,5101835,6285,6332,47,0,0,0
5099750,2e7cdb3f-4404-97f9-1e60-ba33fcbfa2ca,8,5075694,5075694,5099750,5100005,24056,24056,0,0,0,0
5099892,2f33d653-4421-d249-e3f6-b904fab34b7f,8,5080052,5080052,5099892,5096519,19840,19840,0,0,0,0
5099985,c89a10a3-17ef-71fc-441b-1a37a931f647,1,5093480,5093524,5099985,5100988,6461,6505,44,0,0,0
5100271,55957cd1-a691-c0e6-1600-b3cf3f0e3075,1,5093317,5093344,5100271,5102340,6927,6954,27,0,0,0
5100363,8abefd88-626c-ea12-7e12-9751883e153f,1,5093403,5093404,5100363,5098356,6959,6960,1,0,0,0
5100407,4221ad1e-17be-360d-996a-d4754efac302,1,5093400,5093404,5100407,5101030,7003,7007,4,0,0,0
5100398,93350c77-c599-1a45-a3a8-68d786a56845,1,5093436,5093464,5100398,5097885,6934,6962,28,0,0,0
5100448,53ce202b-f97c-4b6a-a1ad-0addc94b12db,1,5093422,5093464,5100448,5100348,6984,7026,42,0,0,0
5100539,e3fe266b-a23b-3ed7-70ad-f7ed4277171c,1,5093371,5093404,5100539,5099927,7135,7168,33,0,0,0
5100787,58d687f6-9bb5-a052-9a88-d62a55812914,1,5093494,5093524,5100787,5104091,7263,7293,30,0,0,0
5100795,bb2c23cb-361f-c924-a7a3-2e37475ce39f,1,5093395,5093404,5100795,5098441,7391,7400,9,0,0,0
5100882,f66037cf-f737-b4aa-b85c-c2c8224c6031,1,5093416,5093464,5100882,5097674,7418,7466,48,0,0,0
5100879,e61219b5-73ac-a6e1-dc21-0944e84511a2,1,5093461,5093464,5100879,5104374,7415,7418,3,0,0,0
5100995,8bf54fa8-8ae9-1f31-4674-a2f56818f77e,1,5093320,5093344,5100995,5104127,7651,7675,24,0,0,0
5101019,a7f3cf5c-9818-13c7-0657-894f0c953522,1,5091834,5091887,5101019,5103116,9132,9185,53,0,0,0
5101038,f840596b-357c-e81a-3754-85e6ea9ed202,1,5091852,5091887,5101038,5097100,9151,9186,35,0,0,0
5101046,e3e32e42-29ac-92f0-66f6-290a592b4112,1,5091910,5091947,5101046,5099451,9099,9136,37,0,0,0
5101109,b71a72c1-582c-d97f-0eb4-762ed32b3c0d,1,5091827,5091827,5101109,5099790,9282,9282,0,0,0,0
5101074,db1df2c3-2713-9873-f3e4-613a6672cf51,1,5091885,5091887,5101074,5103826,9187,9189,2,0,0,0
5101068,947ab584-5b06-b98e-eef4-74a3fb31a55f,1,5093368,5093404,5101068,5097708,7664,7700,36,0,0,0
5101144,e2c94a44-2248-fe75-5885-dca5cac5ebc7,1,5093425,5093464,5101144,5103811,7680,7719,39,0,0,0
5101147,74b565f8-d8cf-7b88-5a37-a5048d2e304b,1,5093442,5093464,5101147,5098937,7683,7705,22,0,0,0
5101141,f65a5aa3-6314-0fcc-c8b6-b9a29b5358d4,1,5093461,5093464,5101141,5103035,7677,7680,3,0,0,0
5101202,709b5f65-ea3e-442f-23cd-ec8466ed34e2,1,5091831,5091887,5101202,5100819,9315,9371,56,0,0,0
5101217,b9a1f8c5-929c-c513-5e6f-46b9a77465af,1,5091857,5091887,5101217,5103221,9330,9360,30,0,0,0
5101189,13a5893a-6b13-ad0a-5673-28bc55cf185a,1,5093440,5093464,5101189,5098525,7725,7749,24,0,0,0
5101396,541d0136-17d8-ea64-82d1-0a80a76fc07b,1,5091872,5091887,5101396,5098299,9509,9524,15,0,0,0
5101459,5708d618-9def-23a1-1042-26f62dfc60b7,1,5091875,5091887,5101459,5098120,9572,9584,12,0,0,0
5101963,615a443c-6e73-699b-3144-0c359266facc,1,5093352,5093404,5101963,5106023,8559,8611,52,0,0,0
5101977,3c9ea73a-2f45-a112-5b7c-398883ab6df5,1,5093469,5093524,5101977,5102721,8453,8508,55,0,0,0
5102128,1131f87f-3748-5145-dbab-23419a977a80,1,5093443,5093464,5102128,5099714,8664,8685,21,0,0,0
5102161,507409da-0242-fb7e-c6c9-77ec41e327ee,1,5093327,5093344,5102161,5098808,8817,8834,17,0,0,0
5102183,bb5452fd-26a3-761b-a21f-56b20c650576,1,5093352,5093404,5102183,5103187,8779,8831,52,0,0,0
5102201,2e3a9584-adf5-38fc-995f-2694b8edffe8,1,5091832,5091887,5102201,5103355,10314,10369,55,0,0,0
5102243,69ac030e-0958-06df-03d9-f8c35c922fa4,1,5091843,5091887,5102243,5098768,10356,10400,44,0,0,0
5102214,9ad0afdc-e280-1ef0-0b90-1a34a3d6f33a,1,5093335,5093344,5102214,5106021,8870,8879,9,0,0,0
5102211,7c53ccb0-96a8-df54-726a-18440cf2a69a,1,5093454,5093464,5102211,5101580,8747,8757,10,0,0,0
5102257,e54dce58-044e-2d9b-4526-aeed47a0fcda,1,5091899,5091947,5102257,5104959,10310,10358,48,0,0,0
5102310,1e7c30a0-7614-17f3-d817-3ad5ca1ac0b5,1,5093480,5093524,5102310,5106400,8786,8830,44,0,0,0
5102411,8612944f-977b-ee96-b232-398b1f3c4a38,1,5093387,5093404,5102411,5106366,9007,9024,17,0,0,0
5102399,c086789e-eb28-7ab1-e4f0-8e676b93c06b,1,5093465,5093524,5102399,5099202,8875,8934,59,0,0,0
5102443,2c5fd1ca-b0f7-32d8-0fab-0fb8210bf60a,1,5093475,5093524,5102443,5106223,8919,8968,49,0,0,0
5102528,16a3ce4e-ca5c-4c4a-e79b-d4394236fb0e,1,5093331,5093344,5102528,5106699,9184,9197,13,0,0,0
5102600,81db9a62-10a4-37d5-e6b1-7ece85d0cf83,1,5091887,5091887,5102600,5104936,10713,10713,0,0,0,0
5102635,150b8146-856f-fc5c-2d55-b7414b842799,1,5091827,5091827,5102635,5097324,10808,10808,0,0,0,0
5102618,c59ac867-b844-81e9-35ba-f0bd455a14d6,1,5091861,5091887,5102618,5103614,10731,10757,26,0,0,0
5102644,8e86f9b2-d4e6-75f7-3427-fb9ee7912673,1,5093366,5093404,5102644,5102228,9240,9278,38,0,0,0
5102679,6c27ca62-141f-8b4c-7977-93611204a9d9,1,5091849,5091887,5102679,5097895,10792,10830,38,0,0,0
5102718,09a3e57e-2c5b-2eb0-303d-a2528c486219,1,5091861,5091887,5102718,5102281,10831,10857,26,0,0,0
5102782,63ce0666-4b78-9b1f-a68a-84572b924e09,1,5091901,5091947,5102782,5105871,10835,10881,46,0,0,0
5102776,ec9f1803-64f3-d80f-88f5-1390a32e6cb4,1,5091905,5091947,5102776,5102469,10829,10871,42,0,0,0
5102787,8bd0d625-2639-2221-0312-615379927753,1,5093484,5093524,5102787,5099013,9263,9303,40,0,0,0
5102837,bc9742d3-e955-f593-ce5c-5b2006d23bde,1,5093319,5093344,5102837,5101706,9493,9518,25,0,0,0
5103186,64ff3d41-eb4b-3bd8-2f49-056a9f5f4623,1,5093311,5093344,5103186,5099247,9842,9875,33,0,0,0
5103330,43799d48-ce35-d5ea-625f-c9245c9557ea,1,5093397,5093404,5103330,5098772,9926,9933,7,0,0,0
5103366,c28fcc52-80fe-11cd-9734-aeb43550d3f7,1,5093444,5093464,5103366,5102177,9902,9922,20,0,0,0
5103420,080bf99f-f00c-4cc5-2045-3d2d59244739,1,5093312,5093344,5103420,5106878,10076,10108,32,0,0,0
5103394,cf97b941-af62-a976-520c-7748addb47c3,1,5093441,5093464,5103394,5108022,9930,9953,23,0,0,0
5103456,f31fbee0-358a-e854-49b4-af175e6bed7a,1,5093409,5093464,5103456,5107731,9992,10047,55,0,0,0
5103513,dca4b19e-5ffd-f1cf-fc8e-920df692f963,1,5093424,5093464,5103513,5103925,10049,10089,40,0,0,0
5103653,367d9053-bec2-e40d-f0b8-1b2952044e75,1,5093491,5093524,5103653,5099019,10129,10162,33,0,0,0
5103703,7c115895-db1f-3973-a194-3347b9ebce1f,1,5091892,5091947,5103703,5103146,11756,11811,55,0,0,0
5103696,d220f704-0da1-24c5-70ca-6f70cb3ffc4f,1,5093321,5093344,5103696,5104933,10352,10375,23,0,0,0
5103751,9c2f3381-7736-fb28-225e-75c8f8f431f9,1,5091843,5091887,5103751,5101930,11864,11908,44,0,0,0
5103739,49b04036-6486-0c75-fb89-85bc027d3094,1,5091845,5091887,5103739,5104206,11852,11894,42,0,0,0
5103736,153e09ba-f7b6-e34b-1e60-5b15e915a8f9,1,5091872,5091887,5103736,5100533,11849,11864,15,0,0,0
5103753,1e767433-fe95-6f4a-ed56-c7c7ae455311,1,5091890,5091947,5103753,5101538,11806,11863,57,0,0,0
5103721,e312e7dd-a6b8-3e23-5ef9-5050d4838cd3,1,5091906,5091947,5103721,5106071,11774,11815,41,0,0,0
5103837,b90914d8-ac79-fd55-03d2-15148c0a268b,1,5091841,5091887,5103837,5099415,11950,11996,46,0,0,0
5103851,6852c038-be54-cdf1-4782-05fdc6026414,1,5091879,5091887,5103851,5105944,11964,11972,8,0,0,0
5103919,c41e63d4-9cb1-1b59-1245-6606596fb6ce,1,5093382,5093404,5103919,5103259,10515,10537,22,0,0,0
5104055,1182d657-f6e3-c5f3-fe28-cbd9cec84000,1,5093434,5093464,5104055,5105305,10591,10621,30,0,0,0
5104069,2adfedf8-786f-186a-f90a-3610b0b55ce7,1,5093424,5093464,5104069,5102743,10605,10645,40,0,0,0
5104069,b166681c-b2c2-b691-ea74-b216e66d8edc,1,5093455,5093464,5104069,5099928,10605,10614,9,0,0,0
5104119,d4d8c52e-d4c6-c7db-3cb4-8481b4f82d12,1,5091881,5091887,5104119,5107164,12232,12238,6,0,0,0
5104173,f43c67ba-75e3-a0a3-64ac-70a3e84c1940,1,5091915,5091947,5104173,5098430,12226,12258,32,0,0,0
5104175,ef30681c-e61b-4afc-a282-84df019b2b5d,1,5091925,5091947,5104175,5099144,12228,12250,22,0,0,0
5104163,ed7bd78d-bc67-7747-2e2a-485c97382a4d,1,5093347,5093404,5104163,5102730,10759,10816,57,0,0,0
5104181,54ea3718-46af-357c-8252-0d78cdbfaa37,1,5093398,5093404,5104181,5099926,10777,10783,6,0,0,0
5104262,ec0389c1-23ff-18b2-865a-5dcda016d50a,1,5093465,5093524,5104262,5104297,10738,10797,59,0,0,0
5104351,985d94c0-21aa-50dd-5838-9bc769810678,1,5093402,5093404,5104351,5105825,10947,10949,2,0,0,0
5104329,047032f6-33b5-f51d-0a5a-2180c4c0eaf1,1,5093435,5093464,5104329,5102903,10865,10894,29,0,0,0
5104337,63d2b7c6-ab1f-0327-e59a-5f4ef8f218d0,1,5093441,5093464,5104337,5099801,10873,10896,23,0,0,0
5104392,54a3e5ae-db9f-658f-41c6-444b08a575c4,1,5093305,5093344,5104392,5105533,11048,11087,39,0,0,0
5104396,bc7d0e39-c3a6-23ce-f019-eca2b54fae0b,1,5093457,5093464,5104396,5106580,10932,10939,7,0,0,0
5104434,13e76434-c3cc-b51e-b33d-9b53c3d6a993,1,5093379,5093404,5104434,5102942,11030,11055,25,0,0,0
5104752,270a4855-d0b6-eada-5b6b-8e34b344a147,1,5091844,5091887,5104752,5099576,12865,12908,43,0,0,0
5105026,ee519882-93ef-f8c4-29b1-2582c3545cd8,1,5093458,5093464,5105026,5106830,11562,11568,6,0,0,0
5105125,5a94ca8a-1013-4e94-1b1b-eaa3b484befe,1,5091869,5091887,5105125,5104029,13238,13256,18,0,0,0
5105139,4ad07831-8a0a-eef0-1bdd-fef5496e186a,1,5091851,5091887,5105139,5110365,13252,13288,36,0,0,0
5105183,007d3d37-b5b4-6dcd-8cc1-e0363c253eb3,1,5093444,5093464,5105183,5105224,11719,11739,20,0,0,0
5105224,f1668e89-59f7-771a-c94b-08d20f1536da,1,5091855,5091887,5105224,5103660,13337,13369,32,0,0,0
5105206,a754251d-04fe-52e3-e98a-470cb894550a,1,5093396,5093404,5105206,5103472,11802,11810,8,0,0,0
5105211,cdbbbc7a-a48a-8be5-e0d0-dacc6a1917c8,1,5093404,5093404,5105211,5107946,11807,11807,0,0,0,0
5105191,92989be4-348b-03d8-c05d-b5447881a492,1,5093458,5093464,5105191,5107278,11727,11733,6,0,0,0
5105317,4a3e7903-43e5-87b9-0728-04aa88a0d69a,1,5091875,5091887,5105317,5107622,13430,13442,12,0,0,0
5105332,62a5aa21-2b3f-de5d-d8b4-d672212552fa,1,5093453,5093464,5105332,5101884,11868,11879,11,0,0,0
5105389,2a545726-ca9d-569a-4539-fd8297266ab2,1,5093457,5093464,5105389,5099483,11925,11932,7,0,0,0
5105805,9a0f7242-eeb7-591f-b304-08fa90bf747e,1,5093470,5093524,5105805,5100048,12281,12335,54,0,0,0
5105919,7f2487bc-8c10-2bc1-736b-8385522fb6b0,1,5093426,5093464,5105919,5103658,12455,12493,38,0,0,0
5105964,ecb3a74d-8daf-1352-6775-34893bdcf115,1,5093308,5093344,5105964,5108897,12620,12656,36,0,0,0
5105945,37b71c72-b9e2-f6e0-2ea6-4fad153f7fee,1,5093319,5093344,5105945,5105559,12601,12626,25,0,0,0
5105986,fdbf4aa4-e211-cc10-d368-c594e09b6f17,1,5093423,5093464,5105986,5104016,12522,12563,41,0,0,0
5106073,13e10a19-889c-0299-7a19-c2f3386a76b1,1,5093331,5093344,5106073,5103659,12729,12742,13,0,0,0
5106093,44a912f7-49f8-a292-1d30-6afa5f380b5b,1,5093337,5093344,5106093,5105251,12749,12756,7,0,0,0
5106080,6cf4d2fd-d37f-6059-71d7-64ba1712df48,1,5093341,5093344,5106080,5105383,12736,12739,3,0,0,0
5106207,0f9d7819-53e6-c977-488d-5d8d0aef77ed,1,5093348,5093404,5106207,5101419,12803,12859,56,0,0,0
5106279,2fc3bb1c-577b-8d97-001b-d08ee4fa2e93,1,5093457,5093464,5106279,5103895,12815,12822,7,0,0,0
5106436,1f473751-b579-0849-e22b-c2f850a8ad59,1,5093353,5093404,5106436,5110085,13032,13083,51,0,0,0
5106687,fc411721-3667-7c4a-7e44-56d712a82af1,1,5093382,5093404,5106687,5109114,13283,13305,22,0,0,0
5106798,c87df059-b2e3-e64b-ee8f-d6ca59e0890f,1,5093374,5093404,5106798,5110251,13394,13424,30,0,0,0
5107917,ee1db5ee-f480-4b7b-51d5-d62b1c45cd81,1,5093480,5093524,5107917,5105242,14393,14437,44,0,0,0
5107918,bf96abad-e60d-9941-3fc6-8e1450b034fd,1,5093313,5093344,5107918,5111421,14574,14605,31,0,0,0
5107957,266bb932-4f1d-a23b-ce0b-08abf67d8488,1,5093384,5093404,5107957,5110522,14553,14573,20,0,0,0
5107957,e9f410c9-1cfa-78a2-d517-fa40ed233795,1,5093386,5093404,5107957,5102484,14553,14571,18,0,0,0
5107984,90fdbb3e-6173-e67d-d020-91168a608ef3,1,5093362,5093404,5107984,5106369,14580,14622,42,0,0,0
5108008,44b2e5aa-f334-bf9b-fadd-e398c09eb13e,1,5093398,5093404,5108008,5102991,14604,14610,6,0,0,0
5108010,9a36e49e-a99c-706e-ab8e-b99553663145,1,5093486,5093524,5108010,5109594,14486,14524,38,0,0,0
5108065,0c4d862e-5ef8-fa9b-8cfc-a54b8ac31e08,1,5093407,5093464,5108065,5103288,14601,14658,57,0,0,0
5108140,630915e1-8bf6-d88b-12dd-332d0f0cd977,1,5093346,5093404,5108140,5112629,14736,14794,58,0,0,0
5108157,b7e1cb21-2e80-c748-de78-c6038ca3c793,1,5093492,5093524,5108157,5101135,14633,14665,32,0,0,0
5108161,baabf7ec-2eca-29b7-9087-ba7334bbc278,1,5093325,5093344,5108161,5101372,14817,14836,19,0,0,0
5108196,779bfee4-a6f7-0a50-4903-528a5e0fb618,1,5093395,5093404,5108196,5105960,14792,14801,9,0,0,0
5108243,c88994e7-49ef-1088-8ab7-2eb99be4e2ac,1,5093453,5093464,5108243,5105429,14779,14790,11,0,0,0
5108410,1c751ad4-bdec-fa9d-84b0-249af208deed,1,5093493,5093524,5108410,5101685,14886,14917,31,0,0,0
5108477,8ad09042-ef18-0725-f10c-88c063b55bfb,8,5017182,5017182,5108477,5079491,91295,91295,0,0,0,0
5108808,becfa316-c66b-0a01-4f90-1410bfba290b,1,5093491,5093524,5108808,5113033,15284,15317,33,0,0,0
5109210,934b45a8-4716-5e93-9ceb-5b43fa0d3875,1,5093379,5093404,5109210,5109016,15806,15831,25,0,0,0
5111193,4d1f3b9a-04ca-9bf5-1b97-9060a7f12456,1,5091854,5091887,5111193,5101421,19306,19339,33,0,0,0
5111299,ffab82a0-36e6-5004-12e8-089e4cc639c9,8,4946378,4946378,5111299,5057057,164921,164921,0,0,0,0
5111322,0cbe735d-bbfc-3897-f027-1efc049fb2fd,1,5093342,5093344,5111322,5117693,17978,17980,2,0,0,0
5111519,f28dacb1-2701-16e4-8c35-00bd60df109a,1,5093305,5093344,5111519,5110707,18175,18214,39,0,0,0
5111686,a01989d1-b998-d301-7df9-e116df58c65f,1,5093322,5093344,5111686,5108089,18342,18364,22,0,0,0
5111955,1ccc575e-6c6b-fd66-94ba-c2b5ca4514d1,1,5093364,5093404,5111955,5109305,18551,18591,40,0,0,0
5112082,33a83451-f0d8-51ad-12c3-3d134eb71327,1,5093333,5093344,5112082,5112263,18738,18749,11,0,0,0
5112284,07fb3bdd-9559-3433-8b30-0329f55c12c6,1,5093493,5093524,5112284,5120581,18760,18791,31,0,0,0
5112312,2c33acb9-1a1e-3904-7e76-3e5b1c011cb5,1,5093383,5093404,5112312,5109475,18908,18929,21,0,0,0
5112297,f04084d0-4739-669a-dbb2-bf95c376caa7,1,5093422,5093464,5112297,5114327,18833,18875,42,0,0,0
5112594,65ea60d8-737b-6961-0f44-a6f10ffc93bf,1,5093483,5093524,5112594,5113151,19070,19111,41,0,0,0
5113242,935b67b4-2fbd-9d23-a516-8cda99d6bf85,1,5091864,5091887,5113242,5111226,21355,21378,23,0,0,0
5113290,c77ae3b1-20d1-eef1-5861-919d98a0be4c,1,5091847,5091887,5113290,5119934,21403,21443,40,0,0,0
5113262,f3be0191-8b42-acfc-46ec-9b9cc02ac918,1,5091869,5091887,5113262,5112313,21375,21393,18,0,0,0
5113277,88755363-2fc5-2298-53ef-fcdfea7ec9ac,1,5091903,5091947,5113277,5118571,21330,21374,44,0,0,0
5113349,4169de84-0ad3-f8b9-2c10-180ec8d2382a,1,5091846,5091887,5113349,5120961,21462,21503,41,0,0,0
5113349,681a035f-e1e3-d66c-0a09-bdc139c8a117,1,5091848,5091887,5113349,5121917,21462,21501,39,0,0,0
5113425,2e49a904-21e7-8734-9601-44c01908b1b2,1,5091828,5091887,5113425,5111656,21538,21597,59,0,0,0
5113458,3ea0dd43-cc7a-1886-dd4f-6de87a91e144,1,5091888,5091947,5113458,5104525,21511,21570,59,0,0,0
5113453,41797153-fba3-8051-63c8-4474be919354,1,5091912,5091947,5113453,5120346,21506,21541,35,0,0,0
5114782,817ed3f4-a9f0-5ec4-27b1-85f6309b7234,1,5093387,5093404,5114782,5121710,21378,21395,17,0,0,0
5114871,cf048f3a-6fa5-79d0-ee1f-18acb701001e,1,5093406,5093464,5114871,5107460,21407,21465,58,0,0,0
5114991,d72dd24f-d4b9-5d82-6b01-15cabf94abfa,1,5091827,5091827,5114991,5109164,23164,23164,0,0,0,0
5115020,23bf1f71-a901-bdb8-c0ae-50f37770014d,1,5091831,5091887,5115020,5113327,23133,23189,56,0,0,0
5115495,39120821-db7d-e40b-2588-7022a8b680fb,1,5091901,5091947,5115495,5126101,23548,23594,46,0,0,0
5115603,198640a1-45a9-17a0-b443-7813d6bfe645,1,5091868,5091887,5115603,5115984,23716,23735,19,0,0,0
5115742,edced19f-f47e-2c3e-dd5c-0525ec8f3b62,1,5091858,5091887,5115742,5121638,23855,23884,29,0,0,0
5115925,506f6bc0-ee6f-5a9c-f446-023621f66088,1,5091878,5091887,5115925,5113487,24038,24047,9,0,0,0
5115943,0c9ef5aa-a8ef-a3a9-cdb7-5f5750452f2b,1,5091837,5091887,5115943,5120344,24056,24106,50,0,0,0
5116001,1b705635-54fe-f8cf-b383-1f178d399ec4,1,5091873,5091887,5116001,5112780,24114,24128,14,0,0,0
5116046,21e5259f-cc0c-b19c-a973-6b1829d5039a,1,5091887,5091887,5116046,5108369,24159,24159,0,0,0,0
5116112,2dc3e080-ce69-1f9d-80b0-4e3ddd2f1be8,1,5091911,5091947,5116112,5107450,24165,24201,36,0,0,0
5116372,c743eed3-ad54-5be9-9712-4b5a715c2507,1,5091876,5091887,5116372,5104926,24485,24496,11,0,0,0
5117051,ca33dd84-58c2-77f1-5b68-d4ee2f9997c3,1,5093352,5093404,5117051,5122001,23647,23699,52,0,0,0
5117135,fb1eaa6e-d19b-1b23-d602-3639047ad506,1,5093495,5093524,5117135,5107145,23611,23640,29,0,0,0
5117198,2b125551-f51a-797b-b34e-fd5b6e737276,1,5093356,5093404,5117198,5127405,23794,23842,48,0,0,0
5117214,a5ca5367-b598-655f-f9d2-3cfd692981b1,1,5093333,5093344,5117214,5110880,23870,23881,11,0,0,0
5117472,e2293661-e153-4d2b-f261-b0827387d450,1,5093314,5093344,5117472,5109255,24128,24158,30,0,0,0
5117608,5bf0e042-bf56-7386-a6e2-e3f47174bbc8,1,5093455,5093464,5117608,5113032,24144,24153,9,0,0,0
5117620,af80ccb1-6cc3-5925-5b32-92fd1b7d405e,1,5093360,5093404,5117620,5125326,24216,24260,44,0,0,0
5117866,d77dd689-a98d-61ec-3ad4-1c9abac97a02,1,5093484,5093524,5117866,5127405,24342,24382,40,0,0,0
5118222,23763f57-852c-62ce-f337-7b9ee60587ef,1,5091915,5091947,5118222,5113344,26275,26307,32,0,0,0
5118247,ae8e8200-c5c7-34b4-88c5-3b179733b490,1,5091902,5091947,5118247,5120061,26300,26345,45,0,0,0
5118329,dca21033-16ec-34b5-cf6a-d43f09536c4a,1,5091839,5091887,5118329,5115141,26442,26490,48,0,0,0
5118612,c6573806-3841-a305-125d-5ccda8f5314f,1,5093431,5093464,5118612,5129483,25148,25181,33,0,0,0
5118635,6557ecee-40e3-200c-683b-81bc0c0a7983,1,5093335,5093344,5118635,5122542,25291,25300,9,0,0,0
5118660,eb26cc82-4324-887e-0010-2b4d660438cc,1,5093473,5093524,5118660,5110306,25136,25187,51,0,0,0
5118772,932e02cc-159b-61c3-c2a0-4830bcc14124,1,5091885,5091887,5118772,5106410,26885,26887,2,0,0,0
5118933,ab37ff0a-a574-625f-06ed-eb1183ade32f,1,5091889,5091947,5118933,5111849,26986,27044,58,0,0,0
5119082,b309887d-ceec-79d5-c3fd-913088f45162,1,5091916,5091947,5119082,5120044,27135,27166,31,0,0,0
5119127,405d861c-5184-0088-5c8d-5e9d0b874724,1,5091828,5091887,5119127,5107748,27240,27299,59,0,0,0
5119162,6577aba9-9e65-79a5-92f7-d82a70186dce,1,5091902,5091947,5119162,5112256,27215,27260,45,0,0,0
5119231,b3338169-dcfc-2b72-ebbb-ae74db9b4d43,1,5093371,5093404,5119231,5130982,25827,25860,33,0,0,0
5119292,ab00fba9-a5e0-2e86-c3bd-7384176cc975,1,5091895,5091947,5119292,5125921,27345,27397,52,0,0,0
5119264,b5b2872b-a15b-293e-497d-1e5c3155dc87,1,5091895,5091947,5119264,5129662,27317,27369,52,0,0,0
5119586,3e8e9f65-6f96-9845-3b8b-1bf766f8197e,1,5093324,5093344,5119586,5112888,26242,26262,20,0,0,0
5119587,b6961feb-8695-b07e-b56e-1e9637e85154,1,5093403,5093404,5119587,5115070,26183,26184,1,0,0,0
5119667,d55c41b2-7c71-7adb-5f72-fe574b2c8bff,1,5093397,5093404,5119667,5129408,26263,26270,7,0,0,0
5119759,de2bdf8c-a75c-77c0-46f5-8ae67a5c28ca,1,5093463,5093464,5119759,5115639,26295,26296,1,0,0,0
5119841,cff716ad-b85f-20e5-ab1a-a0c576990442,1,5093445,5093464,5119841,5110436,26377,26396,19,0,0,0
5119891,29788933-78db-d04e-87e3-c9551e49e6e1,1,5093407,5093464,5119891,5122244,26427,26484,57,0,0,0
5119956,e6d7e558-9a11-7c5a-8d89-57fb4a357184,1,5093405,5093464,5119956,5109471,26492,26551,59,0,0,0
5120029,ae570403-58bb-8712-8db5-975fd2c447bd,1,5093391,5093404,5120029,5121102,26625,26638,13,0,0,0
5120142,6ae1a31f-a7b6-3925-b3c1-20c39b0108d2,1,5093460,5093464,5120142,5122044,26678,26682,4,0,0,0
5120316,df4b4c19-6faa-039b-98ec-5b6a9c7cf745,1,5093305,5093344,5120316,5131802,26972,27011,39,0,0,0
5120601,b54ec323-1e53-a5da-0780-b3eedcfa02a9,1,5093432,5093464,5120601,5108095,27137,27169,32,0,0,0
5120875,76bd0773-d805-ee6a-2d91-6caf9c446194,1,5093305,5093344,5120875,5127161,27531,27570,39,0,0,0
5121139,70c92b33-ceef-5d5c-dcef-3d321cf63fae,8,5031243,5031243,5121139,5130818,89896,89896,0,0,0,0
5121392,a6e7e684-e7e6-fa6d-5fce-2980cf41205c,1,5091841,5091887,5121392,5112247,29505,29551,46,0,0,0
5121991,dce6ea64-2d5c-4588-c60e-35b66864fe6b,1,5091829,5091887,5121991,5129824,30104,30162,58,0,0,0
5122071,facc2e35-35b6-c692-2528-759d218acc31,1,5091878,5091887,5122071,5118273,30184,30193,9,0,0,0
5122189,b6d62dfd-7365-2790-a9cd-17503b63be00,1,5091841,5091887,5122189,5111294,30302,30348,46,0,0,0
5124842,4377be10-c719-f5ea-c4e4-992911196b23,1,5093422,5093464,5124842,5119558,31378,31420,42,0,0,0
5124995,f889c78a-6e24-7a6b-f09e-a0d08e2d33d0,1,5093481,5093524,5124995,5114799,31471,31514,43,0,0,0
5125071,1bb1ca48-b844-5438-de51-993207cdabeb,1,5093359,5093404,5125071,5125086,31667,31712,45,0,0,0
5125292,247803a1-fb4a-0283-1e28-7c97a9e0917f,1,5093336,5093344,5125292,5117507,31948,31956,8,0,0,0
5125344,8a5abc61-9924-c5ee-fc8a-fb1dba99267e,8,5113650,5113650,5125344,5129464,11694,11694,0,0,0,0
5125336,095863f4-e640-bc25-5663-d6d508842230,1,5093347,5093404,5125336,5113811,31932,31989,57,0,0,0
5125316,2e52635d-2bc4-a319-5321-1cf18ddc5f0e,1,5093415,5093464,5125316,5137415,31852,31901,49,0,0,0
5125437,f3b20598-a303-d14f-6254-4d22944baabb,1,5093442,5093464,5125437,5112653,31973,31995,22,0,0,0
5125568,d455b87e-9322-9023-5a99-5017deb04c83,1,5093327,5093344,5125568,5109513,32224,32241,17,0,0,0
5125607,fa6a2e9f-d86c-3321-48ee-e6b2a5e441cd,1,5093365,5093404,5125607,5136946,32203,32242,39,0,0,0
5126140,f49eaaa3-0ef1-47f7-6a84-6c2c6d9b5aa8,1,5093307,5093344,5126140,5140991,32796,32833,37,0,0,0
5128290,b9866767-81d3-7bca-ea34-23ed41357db8,8,5124675,5124675,5128290,5129855,3615,3615,0,0,0,0
5133268,4279dcd6-86e7-6c6c-c800-69fbd4c7ca67,8,4960355,4960355,5133268,5143980,172913,172913,0,0,0,0
5134014,0b39c366-3319-9ce0-22db-a98191cb87c7,1,5093382,5093404,5134014,5125787,40610,40632,22,0,0,0
5135077,0c586c0a-1cb6-e17b-0974-52d8b082a958,8,4962587,4962587,5135077,5164884,172490,172490,0,0,0,0
5135865,bb77e34a-38f2-22b9-8310-6b55f638900a,8,4981040,4981040,5135865,5174014,154825,154825,0,0,0,0
5136397,4d7f6dfb-03c2-e3e5-6150-e2162fd049b1,8,5065428,5065428,5136397,5144446,70969,70969,0,0,0,0
5140911,745d8729-5bc7-1822-fcfe-06e3c395899e,8,5138244,5138244,5140911,5141903,2667,2667,0,0,0,0
5141733,a99e7d01-e5ae-81f3-a90b-98109bf4b57d,8,5139534,5139536,5141733,5141273,2197,2199,2,0,0,0
5142459,879d19c3-57e4-267e-38e6-b704b1d12755,8,5139026,5139069,5142459,5141264,3390,3433,43,0,0,0
5144086,f02a1b37-9865-f96f-99f8-d29021abbbf2,8,5082663,5082663,5144086,5155614,61423,61423,0,0,0,0
5145096,f6fa5eb6-51a5-8b4e-c49c-00424efb4227,8,5135468,5135468,5145096,5141604,9628,9628,0,0,0,0
5146521,53ab7473-f527-fa92-3cc6-985fc565ad41,1,5091883,5091887,5146521,5127454,54634,54638,4,0,0,0
5146541,ede652f5-1167-c1d8-de71-a4acee367214,1,5091903,5091947,5146541,5138280,54594,54638,44,0,0,0
5146527,6a3eed4f-c754-7e4d-55a7-97311b53b124,1,5091914,5091947,5146527,5140421,54580,54613,33,0,0,0
5146655,9e9a1e40-ba49-ccd5-6185-3b1a63e12924,1,5091867,5091887,5146655,5151229,54768,54788,20,0,0,0
5146656,15534416-bf3a-5509-e66e-cec56852833e,1,5091851,5091887,5146656,5127152,54769,54805,36,0,0,0
5146681,feb1e270-69c8-0b17-bf33-5ada2e20766f,1,5091907,5091947,5146681,5159976,54734,54774,40,0,0,0
5147016,b34e32fc-5243-14c8-ace7-6617cc42d8ff,1,5091853,5091887,5147016,5121239,55129,55163,34,0,0,0
5147042,e1ea7e7a-40aa-3ee9-d9d5-815da6869a68,1,5091864,5091887,5147042,5157114,55155,55178,23,0,0,0
5149582,636f1e3d-28c8-40b1-67be-e26e9f30418c,8,5087504,5087504,5149582,5145930,62078,62078,0,0,0,0
5149863,ce74ec56-db42-2295-95a2-b7e4351399ed,1,5091832,5091887,5149863,5138179,57976,58031,55,0,0,0
5151849,8e31ea45-2b34-b52b-644c-5b7d95ea0734,8,5143757,5143757,5151849,5155482,8092,8092,0,0,0,0
5152484,0a524e33-3a08-07d8-d666-7ba856bebe18,8,5143893,5143893,5152484,5149792,8591,8591,0,0,0,0
5159068,236603b4-53ae-322e-d147-b235e537cd52,8,5151195,5151195,5159068,5162331,7873,7873,0,0,0,0
5164599,312997af-d7e3-05d5-407e-85061ec4816d,8,5150948,5150980,5164599,5165566,13619,13651,32,0,0,0
5165016,3d7d9e1e-c7e1-66e3-ff71-d4015f09058e,8,5150930,5150980,5165016,5170596,14036,14086,50,0,0,0
5165634,710dcbb7-6e93-c789-6788-32d0dcfca748,8,4986730,4986730,5165634,5219510,178904,178904,0,0,0,0
5165977,379f0075-ba72-186e-b79a-0c86c986b3e4,8,5150932,5150980,5165977,5164783,14997,15045,48,0,0,0
5166235,deafd27f-2548-cb37-bd61-676d56aa814e,8,5150931,5150980,5166235,5169604,15255,15304,49,0,0,0
5166254,61e5cdd9-741d-60f6-bded-3f17ab76faa9,8,5150920,5150920,5166254,5158956,15334,15334,0,0,0,0
5166355,93c16428-c5f9-3dca-f1f0-2b90882cbb08,8,5150942,5150980,5166355,5169512,15375,15413,38,0,0,0
5166383,6e19f773-3a5c-a1bc-5797-29e87a8d8320,8,5150920,5150920,5166383,5168748,15463,15463,0,0,0,0
5166547,cbd4b8db-541c-8f78-489f-3f1a566fe0df,8,5150944,5150980,5166547,5162479,15567,15603,36,0,0,0
5167147,f1f58294-a66c-93f2-87f2-b5814809c026,8,4993703,4993703,5167147,5115699,173444,173444,0,0,0,0
5168360,68f06068-e087-e259-4507-1307e183cfa3,8,5150921,5150980,5168360,5168833,17380,17439,59,0,0,0
5168548,3933c2ed-9c66-75cd-b939-8e8e25fc57c7,8,5150921,5150980,5168548,5163366,17568,17627,59,0,0,0
5168565,421e0683-dc0a-1c8e-88bc-e600431b800a,8,5150921,5150980,5168565,5163664,17585,17644,59,0,0,0
5168596,975e1b27-ead5-d65a-7c30-761e710dc918,8,5150938,5150980,5168596,5170170,17616,17658,42,0,0,0
5169010,317ca102-1339-ff4a-2dd5-f00525139dd0,8,5150926,5150980,5169010,5175393,18030,18084,54,0,0,0
5169766,ffd8ca90-cc12-e44b-bdcc-5163cf3b5aa8,32,5055221,5055221,5169766,5131921,114545,114545,0,0,0,0
5170365,ec2c1148-d67d-a117-cc77-15050f95e5dc,8,5088982,5088982,5170365,5193407,81383,81383,0,0,0,0
5171921,0db1565d-6d70-799e-430b-105742fbacf1,8,5101013,5101055,5171921,5144950,70866,70908,42,0,0,0
5174359,5c4cbcb4-2f04-cf18-21ba-0416e70320bd,8,5169149,5169149,5174359,5175454,5210,5210,0,0,0,0
5178192,37c20000-f4d7-b8cd-e3c7-8964b776cbf6,8,5150929,5150980,5178192,5189199,27212,27263,51,0,0,0
5179089,dd7c5485-6c70-7048-5093-4c874f8ccb0b,8,5175336,5175336,5179089,5179338,3753,3753,0,0,0,0
5180862,6c426e1a-88ad-3de9-018e-2f1dec0bcb99,8,5161281,5161281,5180862,5176427,19581,19581,0,0,0,0
5181590,32455848-cbcf-3687-55d2-5c83c7e9607b,8,5150927,5150980,5181590,5170068,30610,30663,53,0,0,0
5181756,e6b31a27-703a-382b-7364-5c1b15b9d469,8,5150920,5150920,5181756,5172325,30836,30836,0,0,0,0
5181978,6399c513-ae96-0e3e-71f7-a87cf1430eea,8,5150930,5150980,5181978,5169284,30998,31048,50,0,0,0
5182004,1be52474-bb14-6720-39d2-6141c5a435cb,8,5150937,5150980,5182004,5193077,31024,31067,43,0,0,0
